,TAG_Champ_1_Blue,TAG_Champ_2_blue,TAG_Champ_1_Red,TAG_Champ_2_red,bResult,rResult,Partidas_x
2,Marksman,"Support, Tank",Marksman,"Tank, Support",50,45,95
753,Marksman,"Support, Mage",Marksman,"Support, Mage",47,45,92
195,Marksman,"Support, Tank",Marksman,"Support, Mage",41,44,85
9,Marksman,"Tank, Support",Marksman,"Support, Tank",47,35,82
515,Marksman,"Support, Mage",Marksman,"Support, Fighter",38,41,79
15,Marksman,"Support, Fighter",Marksman,"Tank, Support",43,34,77
20,Marksman,"Support, Tank",Marksman,"Support, Fighter",35,39,74
235,Marksman,"Support, Fighter",Marksman,"Support, Mage",44,30,74
191,Marksman,"Mage, Support",Marksman,"Support, Mage",37,35,72
126,Marksman,"Support, Mage",Marksman,"Tank, Support",36,36,72
221,Marksman,"Tank, Support",Marksman,"Support, Mage",37,34,71
224,Marksman,"Support, Mage",Marksman,"Support, Tank",35,36,71
706,Marksman,"Support, Mage",Marksman,"Mage, Support",38,26,64
38,Marksman,"Tank, Support",Marksman,"Support, Fighter",28,27,55
414,Marksman,"Support, Fighter",Marksman,"Support, Tank",32,18,50
154,Marksman,"Support, Mage","Marksman, Mage","Support, Mage",30,19,49
252,"Marksman, Mage","Support, Mage",Marksman,"Mage, Support",23,24,47
388,Marksman,"Support, Mage","Marksman, Mage","Mage, Support",25,21,46
118,"Marksman, Assassin","Support, Tank",Marksman,"Support, Fighter",25,19,44
104,Marksman,"Support, Fighter","Marksman, Mage","Support, Tank",25,18,43
190,Marksman,"Fighter, Tank",Marksman,"Tank, Support",25,17,42
125,Marksman,"Mage, Support",Marksman,"Support, Fighter",25,16,41
98,"Marksman, Mage","Support, Tank",Marksman,"Support, Fighter",22,19,41
45,"Marksman, Mage","Support, Mage","Marksman, Support","Mage, Support",23,17,40
744,"Marksman, Mage","Support, Mage",Marksman,"Support, Mage",21,19,40
92,Marksman,"Support, Tank","Marksman, Assassin","Support, Fighter",21,18,39
63,Marksman,"Mage, Support",Marksman,"Support, Tank",18,20,38
805,"Marksman, Mage","Support, Mage",Marksman,"Support, Tank",23,14,37
709,Marksman,"Support, Mage","Marksman, Assassin","Support, Mage",20,17,37
151,Marksman,"Support, Tank",Marksman,"Mage, Support",19,17,36
684,Marksman,"Tank, Fighter",Marksman,"Support, Fighter",13,22,35
96,"Marksman, Assassin","Support, Fighter",Marksman,"Support, Tank",19,15,34
167,"Assassin, Fighter","Mage, Support","Fighter, Assassin","Mage, Support",23,11,34
48,Marksman,"Mage, Support","Assassin, Fighter","Support, Mage",16,17,33
208,Marksman,"Support, Fighter",Marksman,Mage,20,13,33
64,"Assassin, Fighter","Support, Mage",Marksman,"Mage, Support",22,11,33
181,Marksman,"Support, Tank","Marksman, Mage","Support, Mage",17,16,33
148,"Marksman, Mage","Support, Tank",Marksman,"Mage, Support",17,16,33
91,Marksman,"Support, Mage","Marksman, Support","Mage, Support",18,14,32
582,Marksman,"Support, Fighter","Marksman, Assassin","Support, Tank",14,18,32
328,Marksman,Mage,Marksman,"Tank, Support",18,14,32
338,Marksman,"Support, Mage",Marksman,Mage,14,18,32
1335,Marksman,"Tank, Support",Marksman,"Mage, Support",15,17,32
58,Marksman,"Support, Mage","Assassin, Fighter","Mage, Support",13,19,32
1073,"Marksman, Assassin","Mage, Support",Marksman,"Support, Mage",19,13,32
482,"Marksman, Mage","Mage, Support",Marksman,"Support, Mage",20,11,31
138,Marksman,"Support, Tank",Marksman,"Fighter, Tank",16,15,31
145,"Marksman, Support","Mage, Support","Marksman, Mage","Support, Mage",16,15,31
267,Marksman,"Support, Fighter",Marksman,"Tank, Fighter",15,15,30
107,"Marksman, Mage","Support, Tank",Marksman,"Support, Mage",13,17,30
72,"Fighter, Assassin","Mage, Support","Assassin, Fighter","Mage, Support",19,11,30
340,Marksman,"Support, Tank","Marksman, Assassin","Tank, Support",15,14,29
390,"Marksman, Mage","Mage, Support",Marksman,"Support, Tank",12,17,29
324,Marksman,"Mage, Support",Marksman,"Tank, Support",19,10,29
247,Marksman,"Tank, Fighter",Marksman,"Tank, Support",12,17,29
114,"Marksman, Mage","Support, Fighter",Marksman,"Support, Tank",16,12,28
326,"Marksman, Assassin","Mage, Support","Marksman, Mage","Support, Mage",18,10,28
215,Marksman,"Mage, Support","Marksman, Mage","Support, Mage",15,13,28
135,"Marksman, Assassin","Support, Mage",Marksman,"Mage, Support",12,16,28
311,"Marksman, Assassin","Support, Tank",Marksman,"Support, Mage",9,19,28
1301,Marksman,"Support, Fighter",Marksman,"Mage, Support",14,14,28
169,"Assassin, Fighter","Mage, Support",Marksman,"Support, Mage",17,11,28
366,"Fighter, Tank",Fighter,"Fighter, Tank","Fighter, Mage",13,15,28
1030,Marksman,"Support, Mage","Marksman, Assassin","Support, Tank",15,12,27
44,Marksman,"Support, Tank","Marksman, Mage","Support, Fighter",20,7,27
130,Marksman,"Support, Tank","Marksman, Mage","Tank, Support",11,16,27
485,"Tank, Fighter","Mage, Support","Fighter, Mage","Mage, Support",16,11,27
604,"Marksman, Assassin","Tank, Support",Marksman,"Support, Tank",20,7,27
295,"Marksman, Mage","Support, Mage","Marksman, Assassin","Support, Mage",17,10,27
309,Marksman,"Support, Fighter","Marksman, Support","Support, Tank",19,7,26
0,"Marksman, Mage","Mage, Support","Marksman, Support","Mage, Support",12,14,26
17,"Marksman, Mage","Tank, Support",Marksman,"Support, Tank",14,12,26
393,Marksman,"Support, Mage","Marksman, Assassin","Mage, Support",12,14,26
1126,Marksman,"Tank, Support",Marksman,Mage,11,14,25
296,Marksman,"Support, Tank","Marksman, Assassin","Support, Mage",13,12,25
128,"Marksman, Mage","Support, Tank",Marksman,"Tank, Support",15,10,25
1577,Marksman,Mage,Marksman,"Support, Mage",16,9,25
689,Marksman,"Support, Mage",Marksman,"Tank, Fighter",13,12,25
60,"Marksman, Support","Support, Mage","Marksman, Mage","Mage, Support",10,14,24
1197,"Marksman, Assassin","Support, Tank",Marksman,"Tank, Support",14,10,24
967,Marksman,Mage,Marksman,"Support, Fighter",15,9,24
244,"Fighter, Mage",Mage,Fighter,Mage,12,12,24
222,"Tank, Fighter","Mage, Support","Fighter, Mage",Marksman,15,9,24
34,"Marksman, Assassin","Tank, Support",Marksman,"Support, Fighter",14,10,24
1559,Marksman,"Support, Fighter","Marksman, Assassin","Support, Mage",15,9,24
248,"Marksman, Mage","Mage, Support","Marksman, Support","Support, Mage",13,11,24
445,"Tank, Mage","Tank, Fighter","Fighter, Tank","Fighter, Mage",10,14,24
99,"Tank, Fighter","Support, Mage","Fighter, Assassin","Support, Mage",14,9,23
186,"Fighter, Tank","Fighter, Mage","Tank, Mage","Tank, Fighter",15,8,23
28,"Fighter, Tank","Mage, Fighter","Fighter, Tank",Fighter,11,12,23
600,Marksman,"Mage, Support","Marksman, Mage","Support, Tank",18,5,23
697,"Marksman, Assassin","Support, Fighter",Marksman,"Tank, Support",12,11,23
378,Marksman,"Fighter, Tank",Marksman,"Support, Tank",16,7,23
71,"Marksman, Mage","Support, Mage","Marksman, Assassin","Mage, Support",10,13,23
432,"Marksman, Mage","Mage, Support","Marksman, Assassin","Support, Mage",8,15,23
277,Marksman,"Tank, Support",Marksman,"Fighter, Tank",12,11,23
1668,Marksman,"Mage, Support","Marksman, Assassin","Support, Mage",15,8,23
376,Marksman,"Support, Mage","Marksman, Mage","Support, Tank",13,10,23
290,Marksman,"Tank, Support","Marksman, Mage","Support, Tank",11,12,23
56,"Marksman, Mage","Mage, Support","Marksman, Assassin","Mage, Support",12,11,23
87,Marksman,"Support, Fighter","Marksman, Assassin","Tank, Support",13,10,23
254,"Marksman, Mage","Support, Mage",Marksman,"Tank, Support",10,13,23
423,Marksman,"Tank, Support","Marksman, Assassin","Support, Fighter",14,8,22
643,"Marksman, Assassin","Support, Mage","Marksman, Mage","Mage, Support",14,8,22
230,"Assassin, Fighter","Mage, Support",Marksman,"Mage, Support",13,9,22
5,"Fighter, Mage","Mage, Support",Fighter,"Support, Tank",9,12,21
75,"Fighter, Assassin","Support, Mage","Tank, Fighter","Support, Mage",12,9,21
76,"Marksman, Support","Support, Mage","Marksman, Assassin","Mage, Support",9,12,21
965,Marksman,"Support, Fighter","Marksman, Mage","Support, Mage",13,8,21
51,"Marksman, Assassin","Mage, Support","Marksman, Support","Support, Mage",10,11,21
361,"Assassin, Fighter","Support, Mage","Fighter, Assassin","Mage, Support",14,7,21
214,"Mage, Fighter","Mage, Support",Fighter,"Mage, Support",4,17,21
351,"Marksman, Support","Support, Mage",Marksman,"Mage, Support",13,8,21
478,"Assassin, Fighter","Mage, Support","Assassin, Fighter","Mage, Support",14,7,21
493,"Assassin, Fighter","Mage, Support",Fighter,"Mage, Support",12,8,20
203,Marksman,"Tank, Support",Marksman,"Tank, Fighter",13,7,20
143,"Marksman, Mage","Support, Mage","Marksman, Support","Support, Mage",11,9,20
37,Fighter,"Support, Mage","Mage, Fighter","Mage, Support",10,10,20
153,Marksman,"Support, Tank","Marksman, Mage","Mage, Support",9,11,20
115,Fighter,Mage,"Fighter, Mage",Mage,12,8,20
1925,"Fighter, Tank","Tank, Fighter","Fighter, Tank","Fighter, Mage",4,16,20
24,"Assassin, Fighter","Mage, Support",Fighter,Marksman,14,6,20
280,"Marksman, Assassin","Support, Fighter","Marksman, Mage","Support, Tank",11,9,20
877,"Marksman, Mage","Support, Mage",Marksman,"Support, Fighter",12,7,19
800,Marksman,"Mage, Support","Marksman, Assassin","Support, Tank",11,8,19
320,"Marksman, Support","Mage, Support",Marksman,"Support, Mage",10,9,19
133,"Marksman, Mage","Tank, Support",Marksman,"Support, Mage",10,9,19
377,"Assassin, Fighter","Support, Mage","Assassin, Fighter","Mage, Support",12,7,19
132,"Fighter, Mage","Mage, Support",Fighter,"Mage, Support",11,8,19
673,Marksman,"Mage, Support","Assassin, Fighter","Mage, Support",12,7,19
73,"Fighter, Tank","Fighter, Mage","Fighter, Assassin",Fighter,10,9,19
305,"Fighter, Assassin","Mage, Support","Mage, Fighter","Mage, Support",7,11,18
4398,"Marksman, Assassin","Support, Mage",Marksman,"Support, Mage",12,6,18
682,"Marksman, Assassin","Support, Mage",Marksman,"Tank, Support",8,10,18
142,Marksman,"Support, Tank",Marksman,Support,10,8,18
294,"Assassin, Fighter","Support, Mage","Mage, Fighter","Mage, Support",10,8,18
106,"Marksman, Assassin","Support, Fighter",Marksman,Support,9,9,18
797,"Mage, Fighter","Mage, Support","Fighter, Assassin","Mage, Support",9,9,18
332,"Assassin, Fighter","Mage, Support","Fighter, Assassin","Support, Mage",14,3,17
1027,"Fighter, Tank","Mage, Fighter","Fighter, Tank","Fighter, Mage",11,6,17
1578,Marksman,"Support, Tank","Marksman, Assassin","Mage, Support",5,12,17
1106,"Marksman, Assassin","Support, Mage",Marksman,"Support, Fighter",12,5,17
1444,"Assassin, Fighter","Mage, Support","Fighter, Assassin",Mage,12,5,17
170,"Assassin, Fighter","Mage, Support","Assassin, Fighter","Support, Mage",11,6,17
521,"Fighter, Assassin","Support, Mage","Assassin, Fighter","Support, Mage",11,6,17
4427,"Marksman, Assassin","Support, Mage",Marksman,"Support, Tank",12,5,17
39,"Fighter, Mage","Support, Mage",Fighter,"Mage, Support",7,10,17
782,"Fighter, Tank","Fighter, Mage","Fighter, Tank",Fighter,11,6,17
1683,"Marksman, Assassin","Mage, Support",Marksman,"Support, Tank",6,11,17
227,"Fighter, Assassin","Fighter, Mage","Fighter, Tank",Fighter,9,8,17
134,"Tank, Mage",Fighter,"Fighter, Tank","Fighter, Mage",9,8,17
1296,"Marksman, Mage","Mage, Support",Marksman,"Support, Fighter",6,11,17
1180,"Fighter, Tank","Tank, Fighter","Fighter, Tank","Tank, Fighter",10,7,17
667,"Marksman, Mage","Support, Tank",Marksman,"Support, Tank",7,10,17
258,"Marksman, Support","Tank, Support",Marksman,"Support, Tank",12,5,17
183,"Fighter, Tank","Mage, Fighter","Fighter, Assassin",Fighter,5,11,16
731,Marksman,"Support, Fighter","Marksman, Mage","Mage, Support",9,7,16
266,Marksman,Support,Marksman,"Support, Tank",8,8,16
516,"Mage, Fighter","Mage, Support","Fighter, Mage","Mage, Support",7,9,16
364,"Marksman, Mage","Support, Fighter","Marksman, Assassin","Support, Tank",8,8,16
223,"Marksman, Mage","Support, Fighter",Marksman,"Mage, Support",7,9,16
911,"Marksman, Assassin","Support, Mage","Marksman, Mage","Support, Mage",6,10,16
462,"Mage, Fighter","Support, Mage",Fighter,"Mage, Support",10,6,16
157,Fighter,"Support, Mage","Fighter, Mage","Mage, Support",7,9,16
93,"Marksman, Support","Mage, Support","Marksman, Mage","Mage, Support",11,5,16
380,Marksman,"Mage, Support","Marksman, Assassin","Support, Fighter",6,10,16
249,"Fighter, Assassin",Fighter,"Fighter, Tank","Fighter, Mage",4,12,16
444,"Assassin, Fighter","Mage, Support","Fighter, Assassin","Assassin, Fighter",11,5,16
787,"Tank, Fighter","Mage, Support","Tank, Fighter","Mage, Support",11,5,16
18,Fighter,"Support, Tank","Fighter, Mage","Mage, Support",4,12,16
457,Marksman,"Support, Fighter",Marksman,"Fighter, Tank",7,9,16
469,"Fighter, Assassin","Mage, Assassin","Assassin, Fighter","Mage, Support",8,8,16
4,"Mage, Fighter","Support, Tank","Fighter, Mage","Support, Fighter",7,9,16
78,"Marksman, Support","Mage, Assassin","Marksman, Mage","Mage, Support",7,8,15
804,"Marksman, Mage","Tank, Support",Marksman,"Support, Fighter",5,10,15
21,"Tank, Fighter","Fighter, Assassin","Tank, Mage","Assassin, Fighter",7,8,15
79,Tank,"Fighter, Mage","Fighter, Tank",Fighter,7,8,15
237,Marksman,Support,"Marksman, Mage","Support, Tank",9,6,15
289,"Fighter, Tank","Fighter, Mage","Tank, Mage",Fighter,9,6,15
438,Marksman,"Mage, Support","Fighter, Assassin","Mage, Support",7,8,15
583,"Assassin, Fighter","Support, Mage",Fighter,"Mage, Support",8,7,15
849,Marksman,"Support, Mage","Marksman, Assassin","Tank, Support",10,5,15
211,"Tank, Fighter","Mage, Fighter","Fighter, Tank","Fighter, Mage",8,7,15
89,"Tank, Fighter",Marksman,"Tank, Mage","Assassin, Fighter",8,7,15
2018,"Marksman, Assassin","Support, Tank",Marksman,"Mage, Support",11,4,15
837,"Fighter, Mage","Mage, Support",Fighter,Mage,8,7,15
4429,Marksman,"Mage, Support",Marksman,"Mage, Support",6,9,15
129,"Mage, Fighter","Support, Mage",Fighter,"Support, Tank",9,6,15
555,"Marksman, Support","Mage, Support",Marksman,"Support, Tank",4,11,15
990,"Tank, Fighter","Tank, Fighter","Fighter, Tank","Tank, Fighter",8,7,15
674,Marksman,"Mage, Support","Marksman, Mage","Support, Fighter",5,10,15
442,"Marksman, Assassin","Mage, Support","Marksman, Mage","Mage, Support",8,7,15
434,Marksman,"Mage, Assassin","Assassin, Fighter","Mage, Support",13,2,15
150,"Marksman, Support","Support, Tank",Marksman,"Mage, Support",6,9,15
163,"Marksman, Mage","Mage, Support","Marksman, Assassin","Support, Fighter",6,9,15
1013,"Fighter, Mage","Tank, Fighter","Fighter, Tank","Fighter, Mage",7,8,15
160,Marksman,"Mage, Support","Marksman, Mage","Mage, Support",8,7,15
985,"Marksman, Assassin","Support, Mage","Marksman, Mage","Support, Tank",11,4,15
535,"Marksman, Support","Mage, Support","Marksman, Assassin","Support, Mage",10,5,15
1626,"Marksman, Assassin","Tank, Support",Marksman,"Support, Mage",9,6,15
389,"Mage, Fighter","Support, Mage","Fighter, Assassin","Mage, Support",6,8,14
313,"Marksman, Mage","Support, Mage","Marksman, Assassin","Support, Tank",7,7,14
542,"Mage, Fighter","Support, Mage","Assassin, Fighter","Mage, Support",10,4,14
599,"Tank, Fighter","Support, Mage","Fighter, Mage","Support, Mage",9,5,14
427,Marksman,"Tank, Support","Marksman, Mage","Support, Fighter",8,6,14
1127,Marksman,"Mage, Support","Assassin, Fighter",Mage,8,6,14
1438,"Assassin, Fighter","Mage, Support","Mage, Fighter","Mage, Support",9,5,14
566,"Fighter, Tank",Fighter,"Fighter, Assassin","Mage, Fighter",5,9,14
241,"Marksman, Assassin","Support, Fighter","Marksman, Mage","Mage, Support",9,5,14
470,Marksman,"Support, Fighter","Marksman, Mage","Tank, Support",7,7,14
850,"Tank, Fighter","Support, Mage","Tank, Fighter","Support, Mage",8,6,14
670,Marksman,"Support, Tank","Marksman, Mage","Support, Tank",6,8,14
250,"Marksman, Mage","Fighter, Tank",Marksman,"Support, Tank",7,7,14
50,"Tank, Fighter","Assassin, Fighter","Tank, Mage","Fighter, Assassin",9,5,14
1071,Marksman,"Support, Tank","Assassin, Fighter","Support, Mage",7,7,14
306,Fighter,Mage,"Mage, Fighter",Mage,8,6,14
498,"Tank, Fighter",Marksman,"Fighter, Mage","Assassin, Fighter",9,5,14
832,"Tank, Fighter","Tank, Fighter","Fighter, Tank","Fighter, Mage",11,3,14
1026,"Marksman, Mage","Support, Tank","Marksman, Assassin","Support, Tank",10,4,14
798,"Tank, Mage","Fighter, Mage","Fighter, Tank","Tank, Fighter",10,4,14
1595,"Marksman, Mage","Mage, Support","Marksman, Mage","Support, Mage",7,7,14
1494,"Marksman, Mage","Mage, Support",Marksman,"Mage, Support",10,4,14
437,"Mage, Fighter","Mage, Support","Assassin, Fighter","Mage, Support",7,7,14
2354,Marksman,"Tank, Support","Marksman, Assassin","Support, Tank",5,9,14
119,"Mage, Fighter","Mage, Support",Fighter,"Support, Mage",6,8,14
172,"Marksman, Assassin","Support, Tank",Marksman,Support,6,8,14
615,Marksman,"Support, Tank","Marksman, Support","Support, Fighter",6,8,14
737,"Fighter, Assassin","Mage, Support","Assassin, Fighter","Support, Mage",8,6,14
8,"Mage, Fighter","Support, Fighter","Fighter, Mage","Support, Tank",7,7,14
639,Marksman,"Support, Tank","Marksman, Support","Support, Tank",8,6,14
184,"Marksman, Assassin","Support, Mage","Marksman, Support","Mage, Support",5,9,14
613,Marksman,"Support, Tank","Marksman, Support","Mage, Support",8,6,14
726,Marksman,"Support, Fighter","Marksman, Assassin","Tank, Fighter",6,8,14
146,"Assassin, Fighter","Mage, Support","Assassin, Fighter","Mage, Assassin",7,7,14
666,"Fighter, Tank","Tank, Fighter","Tank, Mage","Tank, Fighter",8,6,14
791,"Marksman, Support","Support, Mage",Marksman,"Support, Tank",7,7,14
679,Marksman,"Tank, Support","Marksman, Assassin","Support, Mage",6,8,14
3,"Mage, Fighter","Support, Tank","Fighter, Mage","Tank, Support",9,5,14
1759,"Marksman, Assassin","Support, Tank","Marksman, Mage","Support, Fighter",8,5,13
2494,"Tank, Mage","Tank, Fighter","Fighter, Tank",Fighter,8,5,13
645,"Marksman, Mage","Mage, Support","Marksman, Assassin","Support, Tank",5,8,13
81,"Fighter, Mage","Support, Tank",Fighter,"Support, Fighter",9,4,13
1864,"Assassin, Fighter","Mage, Support","Mage, Fighter","Support, Mage",8,5,13
65,"Fighter, Mage",Fighter,"Fighter, Tank","Fighter, Mage",4,9,13
986,"Assassin, Fighter",Mage,"Fighter, Assassin","Mage, Support",9,4,13
973,"Fighter, Tank","Tank, Fighter","Tank, Mage","Fighter, Assassin",6,7,13
300,"Marksman, Assassin","Support, Tank","Marksman, Mage","Mage, Support",8,5,13
331,"Fighter, Tank","Mage, Fighter","Fighter, Tank","Fighter, Assassin",6,7,13
748,Marksman,"Support, Tank","Marksman, Support","Support, Mage",7,6,13
943,"Tank, Mage","Assassin, Fighter","Fighter, Tank",Fighter,8,5,13
168,"Tank, Fighter","Assassin, Fighter","Tank, Mage",Marksman,10,3,13
1,"Mage, Fighter","Tank, Support",Fighter,"Support, Fighter",7,6,13
1810,"Fighter, Tank","Tank, Fighter","Tank, Mage","Fighter, Mage",7,6,13
755,"Mage, Fighter","Mage, Support","Assassin, Fighter","Mage, Assassin",7,6,13
4450,Marksman,"Mage, Support",Marksman,Mage,9,4,13
513,"Fighter, Tank","Assassin, Fighter","Tank, Fighter",Marksman,9,4,13
113,"Tank, Fighter","Fighter, Mage","Tank, Fighter",Marksman,6,7,13
441,Marksman,Support,"Marksman, Assassin","Support, Fighter",10,3,13
453,"Fighter, Assassin","Mage, Support",Marksman,"Mage, Support",8,5,13
1138,Marksman,"Support, Mage","Marksman, Mage","Tank, Support",6,7,13
1133,Marksman,"Tank, Support","Marksman, Mage","Support, Mage",8,5,13
6,Fighter,"Tank, Support","Fighter, Mage","Support, Tank",9,4,13
149,"Marksman, Assassin","Mage, Support","Marksman, Support","Mage, Support",6,7,13
660,Fighter,"Mage, Support","Fighter, Mage","Mage, Support",4,9,13
473,"Fighter, Mage","Support, Mage","Tank, Fighter","Support, Mage",7,6,13
49,Fighter,"Support, Mage","Fighter, Mage","Support, Tank",6,7,13
55,"Tank, Fighter","Support, Mage","Fighter, Assassin","Support, Fighter",8,5,13
385,Marksman,"Mage, Support","Marksman, Support","Support, Tank",8,5,13
1493,"Fighter, Tank","Mage, Fighter","Tank, Fighter","Assassin, Fighter",8,5,13
158,"Marksman, Mage","Support, Fighter","Marksman, Support","Mage, Support",5,8,13
30,Fighter,"Support, Tank","Fighter, Mage","Support, Fighter",5,8,13
374,"Mage, Fighter",Mage,Fighter,Mage,6,7,13
159,"Marksman, Assassin","Mage, Assassin","Marksman, Mage","Support, Mage",9,4,13
276,Fighter,Mage,"Fighter, Mage","Mage, Support",9,4,13
1054,"Mage, Fighter","Support, Mage",Marksman,"Mage, Support",7,6,13
724,"Marksman, Assassin","Support, Tank","Marksman, Mage","Support, Tank",8,5,13
857,"Fighter, Assassin","Mage, Fighter","Fighter, Tank","Fighter, Mage",7,6,13
201,Marksman,"Tank, Support","Marksman, Mage","Fighter, Tank",6,7,13
13,"Mage, Fighter","Support, Fighter","Fighter, Assassin","Support, Tank",10,3,13
1967,Fighter,"Mage, Support","Mage, Fighter",Mage,8,5,13
88,"Fighter, Assassin","Fighter, Mage","Fighter, Tank","Mage, Fighter",8,5,13
85,"Marksman, Support","Mage, Support","Marksman, Assassin","Mage, Support",8,5,13
202,"Fighter, Tank","Fighter, Mage",Tank,Fighter,6,7,13
200,"Fighter, Assassin","Mage, Support",Fighter,"Mage, Support",8,5,13
263,"Marksman, Assassin","Support, Tank","Marksman, Support","Mage, Support",7,6,13
2282,"Fighter, Assassin","Support, Fighter","Assassin, Fighter","Support, Mage",8,5,13
4445,"Marksman, Assassin","Support, Fighter",Marksman,"Support, Mage",8,5,13
67,"Fighter, Mage","Support, Mage",Fighter,"Support, Tank",7,5,12
1113,"Assassin, Fighter","Mage, Support","Fighter, Assassin","Mage, Assassin",6,6,12
23,Fighter,"Mage, Marksman","Fighter, Mage",Mage,7,5,12
574,"Fighter, Tank","Assassin, Fighter","Tank, Fighter","Fighter, Assassin",10,2,12
597,"Assassin, Fighter","Mage, Support",Marksman,"Mage, Assassin",6,6,12
233,"Fighter, Tank","Fighter, Mage","Fighter, Tank","Mage, Fighter",4,8,12
456,"Assassin, Fighter","Mage, Support","Mage, Fighter","Mage, Assassin",8,4,12
12,Fighter,"Support, Fighter","Fighter, Mage","Support, Tank",5,7,12
742,"Fighter, Tank","Mage, Fighter","Fighter, Mage","Fighter, Assassin",9,3,12
19,"Mage, Fighter","Support, Tank",Fighter,"Mage, Support",6,6,12
103,"Assassin, Fighter","Support, Tank","Fighter, Mage","Support, Mage",9,3,12
581,"Fighter, Assassin","Mage, Fighter","Fighter, Tank",Fighter,10,2,12
83,Fighter,"Support, Mage","Mage, Fighter","Tank, Support",6,6,12
32,"Fighter, Mage","Mage, Marksman",Fighter,Mage,7,5,12
7,"Fighter, Mage","Mage, Tank",Fighter,Mage,6,6,12
2048,"Tank, Fighter",Marksman,"Fighter, Tank","Assassin, Fighter",8,4,12
585,"Fighter, Assassin",Fighter,"Fighter, Tank","Mage, Fighter",5,7,12
2053,"Tank, Fighter","Support, Fighter","Fighter, Mage","Support, Mage",8,4,12
2264,"Fighter, Tank","Tank, Fighter","Fighter, Tank",Fighter,5,7,12
4391,Marksman,"Tank, Fighter",Marksman,"Support, Mage",3,9,12
1501,"Tank, Fighter","Mage, Fighter","Fighter, Tank",Fighter,7,5,12
823,"Fighter, Mage","Assassin, Fighter","Fighter, Tank","Fighter, Assassin",8,4,12
29,Fighter,"Support, Fighter","Fighter, Mage","Tank, Support",7,5,12
1687,Marksman,"Mage, Support","Marksman, Support","Support, Mage",6,6,12
209,"Fighter, Tank","Fighter, Mage","Fighter, Mage",Fighter,7,5,12
455,"Marksman, Support","Mage, Support",Marksman,"Support, Fighter",6,6,12
270,"Assassin, Fighter","Support, Tank","Fighter, Mage","Support, Fighter",11,1,12
1213,"Fighter, Mage",Mage,Fighter,"Mage, Support",9,3,12
35,"Fighter, Mage","Fighter, Tank",Fighter,"Support, Tank",5,7,12
795,"Fighter, Mage","Mage, Support","Tank, Fighter",Marksman,8,4,12
932,"Assassin, Fighter","Mage, Support","Fighter, Mage","Mage, Support",9,3,12
865,"Fighter, Mage",Marksman,"Tank, Fighter","Mage, Support",6,6,12
448,"Tank, Mage","Assassin, Fighter","Tank, Fighter",Marksman,7,5,12
1181,"Marksman, Assassin","Support, Fighter",Marksman,"Tank, Fighter",5,7,12
77,"Tank, Fighter","Assassin, Fighter","Tank, Mage","Assassin, Fighter",7,5,12
40,"Marksman, Support","Support, Tank","Marksman, Mage","Support, Fighter",9,3,12
843,Fighter,Mage,Marksman,Mage,5,7,12
576,Marksman,"Tank, Fighter","Marksman, Assassin","Support, Fighter",8,4,12
136,"Mage, Fighter","Support, Tank","Fighter, Mage","Mage, Support",8,4,12
2013,"Fighter, Tank","Assassin, Fighter","Fighter, Tank","Fighter, Mage",8,4,12
124,"Mage, Fighter","Support, Tank","Assassin, Fighter","Support, Fighter",5,7,12
416,"Tank, Mage","Assassin, Fighter","Tank, Fighter","Fighter, Assassin",11,1,12
141,"Assassin, Fighter","Support, Fighter","Fighter, Assassin","Support, Tank",8,4,12
2017,Marksman,"Support, Mage","Marksman, Mage","Support, Fighter",8,4,12
774,"Fighter, Mage","Support, Mage","Mage, Fighter","Support, Tank",7,5,12
1206,Marksman,"Mage, Support","Assassin, Fighter","Mage, Assassin",5,7,12
1778,"Fighter, Tank","Mage, Support","Mage, Fighter","Mage, Support",5,7,12
1176,Marksman,"Tank, Fighter",Marksman,"Mage, Support",8,4,12
1278,"Marksman, Mage","Support, Tank","Marksman, Support","Mage, Support",5,7,12
1095,"Tank, Fighter","Assassin, Fighter","Fighter, Tank","Fighter, Mage",7,4,11
371,"Assassin, Fighter",Fighter,"Fighter, Tank","Fighter, Mage",9,2,11
4389,Marksman,"Mage, Support","Marksman, Assassin","Tank, Support",6,5,11
813,"Marksman, Mage","Tank, Support",Marksman,"Mage, Support",6,5,11
588,Marksman,"Mage, Support","Fighter, Assassin","Support, Mage",7,4,11
589,"Marksman, Mage","Support, Fighter",Marksman,"Support, Mage",9,2,11
137,"Fighter, Mage","Support, Fighter",Fighter,"Support, Tank",7,4,11
489,"Tank, Fighter","Assassin, Fighter","Tank, Fighter",Marksman,7,4,11
708,"Marksman, Support","Support, Tank",Marksman,"Support, Mage",4,7,11
1077,"Fighter, Assassin","Support, Mage","Assassin, Fighter","Mage, Support",7,4,11
1189,"Fighter, Mage","Marksman, Mage",Fighter,Mage,6,5,11
430,Marksman,"Support, Tank","Marksman, Assassin","Support, Tank",9,2,11
14,"Fighter, Mage","Support, Tank","Mage, Fighter","Support, Fighter",4,7,11
41,Fighter,"Support, Fighter","Fighter, Mage","Tank, Fighter",5,6,11
411,"Assassin, Fighter","Support, Tank","Mage, Fighter","Support, Mage",6,5,11
43,Fighter,"Support, Tank","Mage, Fighter","Support, Fighter",4,7,11
86,"Fighter, Tank","Fighter, Mage","Assassin, Fighter",Fighter,5,6,11
612,"Fighter, Tank","Assassin, Fighter","Tank, Fighter","Mage, Fighter",8,3,11
4512,"Marksman, Mage","Support, Fighter","Marksman, Assassin","Mage, Support",6,5,11
238,"Assassin, Fighter","Support, Tank","Fighter, Assassin","Support, Fighter",6,5,11
386,"Fighter, Mage",Marksman,"Tank, Fighter","Assassin, Fighter",8,3,11
452,"Tank, Mage","Assassin, Fighter","Tank, Fighter","Mage, Fighter",3,8,11
595,"Tank, Fighter","Support, Fighter","Fighter, Mage","Support, Tank",5,6,11
140,Fighter,"Support, Tank","Mage, Fighter","Tank, Support",6,5,11
392,Fighter,"Support, Mage","Fighter, Mage","Tank, Support",5,6,11
101,"Mage, Fighter","Tank, Support",Marksman,"Support, Tank",7,4,11
2259,"Tank, Mage",Fighter,"Fighter, Tank","Tank, Fighter",8,3,11
1371,"Fighter, Tank","Fighter, Mage","Fighter, Assassin","Mage, Fighter",4,7,11
2480,"Assassin, Fighter","Support, Mage","Fighter, Assassin","Support, Mage",4,7,11
251,"Fighter, Tank","Mage, Fighter",Tank,Fighter,4,7,11
22,"Mage, Fighter","Tank, Support","Fighter, Mage","Support, Tank",3,8,11
767,Marksman,"Mage, Support","Assassin, Fighter","Support, Tank",7,4,11
764,"Marksman, Assassin","Mage, Support",Marksman,"Mage, Support",4,7,11
883,Marksman,"Mage, Support","Marksman, Mage","Tank, Support",6,5,11
1615,"Fighter, Mage","Mage, Support","Mage, Fighter","Support, Mage",8,3,11
94,"Marksman, Mage","Mage, Support","Marksman, Assassin","Mage, Assassin",5,6,11
972,"Marksman, Mage","Mage, Support",Marksman,"Tank, Support",9,2,11
1765,"Tank, Mage","Tank, Fighter","Fighter, Tank","Tank, Fighter",4,7,11
11,"Fighter, Mage","Tank, Support","Mage, Fighter","Support, Tank",5,6,11
68,"Mage, Fighter","Support, Tank",Fighter,"Support, Mage",3,8,11
1673,"Marksman, Assassin","Support, Fighter",Marksman,"Mage, Support",7,4,11
762,Marksman,"Mage, Support","Marksman, Assassin","Mage, Support",7,4,11
503,"Tank, Mage",Marksman,"Tank, Fighter","Mage, Fighter",5,6,11
556,"Marksman, Mage","Support, Mage","Marksman, Mage","Mage, Support",7,4,11
756,"Assassin, Fighter","Mage, Assassin",Marksman,"Mage, Support",8,3,11
552,"Marksman, Support","Support, Tank",Marksman,"Support, Fighter",4,7,11
919,"Mage, Fighter","Mage, Assassin","Assassin, Fighter","Mage, Support",6,5,11
938,Marksman,"Support, Tank",Fighter,"Support, Mage",4,7,11
315,"Marksman, Mage","Support, Tank","Marksman, Support","Support, Tank",8,3,11
826,Marksman,"Tank, Fighter",Marksman,"Support, Tank",6,5,11
2403,"Mage, Fighter",Mage,"Assassin, Fighter","Mage, Support",8,3,11
519,Fighter,"Mage, Support","Fighter, Mage","Mage, Tank",7,4,11
25,"Marksman, Support",Marksman,"Marksman, Mage","Mage, Support",6,5,11
279,"Marksman, Mage","Support, Tank","Marksman, Support","Support, Mage",5,6,11
26,"Fighter, Mage","Support, Tank","Mage, Fighter","Tank, Support",5,6,11
80,"Marksman, Support","Mage, Support","Marksman, Mage","Support, Fighter",6,5,11
1826,"Assassin, Fighter","Support, Tank","Fighter, Assassin","Support, Mage",6,5,11
2603,"Fighter, Tank","Mage, Fighter","Fighter, Tank","Assassin, Fighter",6,5,11
57,"Mage, Fighter","Support, Fighter",Fighter,"Support, Tank",6,5,11
287,"Marksman, Assassin","Support, Tank","Marksman, Support","Support, Fighter",5,6,11
3325,"Tank, Fighter","Support, Tank","Tank, Fighter","Support, Fighter",7,4,11
616,"Tank, Fighter","Fighter, Mage","Tank, Fighter","Mage, Fighter",7,4,11
1566,Fighter,"Support, Mage","Tank, Fighter",Mage,4,7,11
105,"Tank, Fighter","Assassin, Fighter","Fighter, Mage",Marksman,9,2,11
2378,"Mage, Fighter","Assassin, Fighter","Assassin, Fighter","Mage, Support",7,4,11
2590,"Marksman, Assassin","Support, Tank","Marksman, Mage","Support, Mage",6,5,11
1575,Marksman,"Support, Mage","Marksman, Assassin","Support, Fighter",5,6,11
568,Marksman,"Mage, Support","Mage, Fighter","Mage, Support",4,7,11
2381,"Fighter, Tank",Fighter,"Fighter, Tank","Mage, Fighter",5,6,11
895,Fighter,Mage,"Fighter, Mage","Marksman, Mage",2,8,10
603,"Tank, Fighter","Assassin, Fighter","Fighter, Mage","Fighter, Assassin",6,4,10
768,"Tank, Fighter","Mage, Support","Fighter, Mage","Assassin, Mage",6,4,10
936,"Fighter, Mage","Fighter, Assassin","Fighter, Tank","Mage, Fighter",8,2,10
802,"Marksman, Assassin","Support, Fighter","Marksman, Support","Support, Tank",8,2,10
467,"Fighter, Assassin","Mage, Support","Mage, Fighter","Support, Mage",5,5,10
635,"Tank, Fighter","Support, Fighter","Fighter, Mage","Tank, Support",4,6,10
1000,"Fighter, Tank","Tank, Fighter",Fighter,"Tank, Fighter",6,4,10
494,"Fighter, Tank",Fighter,"Fighter, Assassin","Fighter, Mage",4,6,10
769,"Fighter, Tank","Fighter, Assassin","Fighter, Tank","Mage, Fighter",3,7,10
1081,"Fighter, Assassin","Support, Mage","Mage, Fighter","Mage, Support",6,4,10
1087,"Tank, Fighter",Marksman,"Fighter, Mage","Mage, Support",3,7,10
1023,"Fighter, Tank","Assassin, Fighter","Fighter, Assassin",Fighter,6,4,10
512,"Fighter, Tank","Tank, Fighter","Tank, Mage",Fighter,6,4,10
1099,Fighter,"Support, Mage","Fighter, Mage","Support, Mage",5,5,10
652,"Mage, Fighter","Mage, Support",Marksman,"Mage, Support",10,0,10
483,"Marksman, Assassin","Mage, Support","Marksman, Mage","Support, Fighter",5,5,10
31,"Assassin, Fighter","Mage, Support","Fighter, Assassin","Support, Fighter",4,6,10
481,"Mage, Fighter","Support, Fighter","Assassin, Fighter","Support, Tank",6,4,10
10,Fighter,"Tank, Support","Fighter, Mage","Support, Fighter",9,1,10
944,"Mage, Fighter",Mage,Marksman,"Assassin, Mage",6,4,10
619,"Tank, Fighter",Marksman,"Tank, Fighter","Fighter, Mage",5,5,10
471,"Assassin, Fighter","Support, Mage",Marksman,"Support, Mage",7,3,10
701,"Fighter, Tank","Fighter, Assassin","Tank, Fighter","Assassin, Fighter",5,5,10
962,Marksman,Mage,"Mage, Fighter","Mage, Support",6,4,10
960,"Fighter, Mage","Mage, Support","Tank, Fighter",Mage,4,6,10
1134,"Assassin, Fighter","Support, Mage","Mage, Fighter","Support, Mage",7,3,10
950,"Mage, Fighter","Support, Mage","Assassin, Fighter","Support, Tank",4,6,10
1155,"Assassin, Fighter",Mage,Fighter,"Mage, Support",8,2,10
16,"Marksman, Support","Mage, Support","Marksman, Mage",Marksman,7,3,10
1161,"Assassin, Fighter","Support, Tank",Marksman,"Mage, Support",8,2,10
1175,Marksman,"Tank, Fighter","Marksman, Assassin","Tank, Support",4,6,10
508,"Mage, Fighter",Marksman,"Fighter, Mage","Mage, Support",3,7,10
1425,"Tank, Mage","Mage, Support","Fighter, Mage","Mage, Support",7,3,10
335,"Fighter, Mage","Support, Tank",Fighter,"Support, Mage",6,4,10
240,Marksman,"Support, Fighter","Assassin, Fighter","Mage, Support",7,3,10
46,"Fighter, Mage",Mage,Fighter,"Mage, Marksman",6,4,10
1474,Marksman,"Support, Mage","Marksman, Support","Support, Mage",7,3,10
47,"Fighter, Mage","Support, Mage",Fighter,"Tank, Support",5,5,10
207,Marksman,"Support, Tank","Marksman, Mage","Fighter, Tank",6,4,10
102,Marksman,"Support, Tank","Mage, Fighter","Support, Fighter",6,4,10
52,"Mage, Fighter","Support, Tank","Fighter, Assassin","Support, Fighter",7,3,10
1647,"Mage, Fighter",Mage,Fighter,"Mage, Support",5,5,10
370,"Mage, Fighter","Support, Tank",Fighter,"Support, Fighter",2,8,10
1511,"Marksman, Support","Support, Fighter","Marksman, Mage","Support, Tank",5,5,10
1518,"Tank, Mage","Mage, Support","Tank, Fighter","Mage, Support",5,5,10
95,Fighter,"Support, Fighter","Mage, Fighter","Support, Tank",5,5,10
231,"Tank, Fighter",Marksman,Tank,"Assassin, Fighter",4,6,10
2082,"Marksman, Mage","Support, Tank","Marksman, Mage","Support, Tank",4,6,10
239,Marksman,Support,Marksman,"Support, Fighter",8,2,10
246,"Fighter, Mage","Fighter, Mage","Fighter, Tank",Fighter,6,4,10
189,Marksman,"Mage, Support",Fighter,"Support, Mage",5,5,10
253,Fighter,"Mage, Tank","Fighter, Mage",Mage,5,5,10
255,Marksman,"Support, Fighter",Marksman,Support,5,5,10
259,Tank,"Mage, Fighter","Fighter, Tank","Fighter, Mage",7,3,10
260,"Assassin, Fighter","Support, Tank","Mage, Fighter","Support, Fighter",4,6,10
354,Tank,Fighter,"Fighter, Tank","Fighter, Mage",3,7,10
262,"Fighter, Tank",Fighter,Tank,"Fighter, Mage",3,7,10
264,Marksman,"Tank, Support","Mage, Fighter","Support, Tank",7,3,10
278,"Assassin, Fighter","Support, Mage",Marksman,"Mage, Assassin",6,4,10
293,"Assassin, Fighter","Support, Tank",Fighter,"Support, Mage",3,7,10
1690,Marksman,"Tank, Support","Marksman, Mage","Mage, Support",6,4,10
316,"Assassin, Fighter","Support, Mage","Assassin, Fighter","Support, Mage",5,5,10
319,"Mage, Fighter","Support, Tank",Marksman,"Support, Mage",6,4,10
333,"Mage, Fighter","Support, Mage",Marksman,"Support, Mage",7,3,10
4399,"Marksman, Assassin","Mage, Support",Marksman,"Support, Fighter",5,5,10
2362,"Assassin, Fighter","Support, Mage","Fighter, Assassin","Support, Tank",6,4,10
1642,"Marksman, Assassin","Tank, Support","Marksman, Mage","Support, Tank",7,3,10
415,Fighter,"Support, Fighter","Tank, Fighter","Tank, Support",5,5,10
144,"Tank, Mage",Marksman,"Assassin, Fighter",Marksman,4,6,10
405,Fighter,"Mage, Support","Mage, Fighter","Support, Mage",5,5,10
164,"Tank, Fighter","Assassin, Fighter","Assassin, Fighter",Marksman,5,5,10
1414,"Marksman, Assassin","Support, Tank",Marksman,"Fighter, Tank",5,5,10
2609,"Assassin, Fighter","Support, Mage","Fighter, Mage","Mage, Support",5,5,10
116,"Fighter, Mage","Support, Fighter","Mage, Fighter","Support, Tank",9,1,10
1422,"Mage, Fighter",Marksman,Fighter,"Mage, Support",8,2,10
1204,Fighter,Mage,"Mage, Fighter","Mage, Support",6,4,10
1281,"Marksman, Assassin","Support, Tank","Marksman, Assassin","Support, Fighter",3,7,10
3237,"Tank, Fighter","Mage, Support","Tank, Fighter",Marksman,7,3,10
1229,"Fighter, Tank","Mage, Fighter","Fighter, Mage","Assassin, Fighter",8,2,10
2010,Fighter,"Mage, Support","Fighter, Assassin","Support, Mage",6,3,9
292,Marksman,"Support, Tank",Fighter,"Tank, Support",3,6,9
2997,"Assassin, Fighter","Mage, Support","Tank, Fighter","Mage, Support",6,3,9
147,"Marksman, Assassin","Mage, Assassin","Marksman, Mage","Mage, Support",7,2,9
1818,"Mage, Fighter","Mage, Support","Assassin, Fighter","Support, Mage",4,5,9
570,"Fighter, Tank","Mage, Fighter",Tank,"Assassin, Fighter",3,6,9
291,"Assassin, Fighter","Mage, Fighter","Fighter, Assassin","Mage, Support",5,4,9
567,"Fighter, Mage","Support, Tank","Assassin, Fighter","Support, Fighter",6,3,9
906,"Tank, Fighter","Support, Mage","Assassin, Fighter","Support, Mage",5,4,9
698,"Fighter, Mage","Assassin, Fighter","Tank, Fighter",Marksman,7,2,9
440,"Assassin, Fighter",Marksman,"Mage, Fighter","Mage, Support",5,4,9
121,"Assassin, Fighter","Support, Tank","Mage, Fighter","Tank, Support",2,7,9
925,"Mage, Fighter","Mage, Support","Fighter, Tank","Mage, Support",5,4,9
928,"Tank, Fighter","Support, Mage",Fighter,"Support, Fighter",5,4,9
74,Tank,"Assassin, Fighter","Tank, Mage",Fighter,6,3,9
1688,Marksman,"Support, Tank","Mage, Fighter","Mage, Support",6,3,9
2825,"Tank, Fighter","Support, Mage",Fighter,"Support, Mage",7,2,9
2795,"Mage, Fighter",Mage,Marksman,"Mage, Support",6,3,9
69,Fighter,Fighter,"Fighter, Tank","Fighter, Mage",5,4,9
322,Marksman,"Support, Mage",Marksman,"Fighter, Tank",6,3,9
1656,"Marksman, Mage","Support, Tank","Marksman, Assassin","Support, Mage",6,3,9
127,Fighter,"Support, Tank","Fighter, Mage","Support, Mage",4,5,9
2029,"Marksman, Mage","Support, Tank","Marksman, Assassin","Support, Fighter",4,5,9
188,Fighter,"Support, Mage","Mage, Fighter","Support, Tank",6,3,9
703,"Marksman, Support","Support, Fighter","Marksman, Assassin","Support, Tank",4,5,9
2206,"Tank, Mage","Assassin, Fighter","Fighter, Tank","Fighter, Mage",8,1,9
626,"Assassin, Fighter","Mage, Support","Assassin, Fighter","Mage, Fighter",3,6,9
110,Fighter,"Fighter, Tank","Fighter, Mage","Support, Tank",4,5,9
637,"Tank, Mage","Tank, Fighter","Tank, Mage","Tank, Fighter",6,3,9
177,"Fighter, Mage","Tank, Support",Fighter,"Support, Mage",4,5,9
2315,"Tank, Fighter","Assassin, Fighter","Tank, Fighter","Fighter, Assassin",7,2,9
740,Marksman,"Support, Mage","Assassin, Fighter","Support, Mage",8,1,9
618,"Tank, Fighter","Fighter, Mage","Tank, Fighter","Assassin, Fighter",6,3,9
2313,"Tank, Mage","Assassin, Fighter","Tank, Fighter","Assassin, Fighter",6,3,9
641,Marksman,"Support, Fighter","Marksman, Support","Mage, Support",5,4,9
213,"Marksman, Mage","Tank, Support",Marksman,"Fighter, Tank",4,5,9
2496,"Fighter, Tank","Fighter, Mage","Fighter, Tank","Assassin, Fighter",7,2,9
219,"Marksman, Assassin",Marksman,"Marksman, Mage","Mage, Support",3,6,9
655,"Tank, Fighter","Tank, Support","Tank, Fighter","Support, Fighter",6,3,9
608,"Marksman, Mage","Support, Mage",Marksman,Mage,4,5,9
2542,"Marksman, Mage","Support, Mage","Marksman, Assassin","Support, Fighter",5,4,9
736,Marksman,"Tank, Support",Marksman,Support,4,5,9
2554,"Assassin, Fighter","Mage, Support",Fighter,Mage,6,3,9
2159,"Tank, Fighter",Fighter,"Fighter, Tank","Mage, Fighter",2,7,9
228,Marksman,"Mage, Support","Marksman, Support","Mage, Support",7,2,9
727,"Fighter, Mage","Support, Mage","Mage, Fighter","Mage, Support",5,4,9
810,Marksman,"Fighter, Tank","Marksman, Mage","Support, Tank",3,6,9
811,"Mage, Fighter","Support, Mage",Fighter,"Support, Mage",4,5,9
815,"Marksman, Support","Mage, Support",Marksman,"Mage, Support",6,3,9
2464,"Fighter, Tank",Fighter,"Tank, Mage","Assassin, Fighter",7,2,9
2230,"Fighter, Tank","Fighter, Mage","Tank, Fighter","Mage, Fighter",5,4,9
36,"Fighter, Mage","Support, Fighter",Fighter,"Tank, Support",6,3,9
966,"Fighter, Tank","Mage, Support",Fighter,"Support, Mage",4,5,9
1476,"Marksman, Mage","Mage, Support",Marksman,"Mage, Assassin",2,7,9
356,"Mage, Fighter","Support, Tank","Fighter, Assassin","Mage, Support",4,5,9
1543,"Tank, Fighter","Mage, Support",Fighter,Mage,6,3,9
1531,"Tank, Fighter","Mage, Support",Fighter,"Mage, Support",4,5,9
501,"Fighter, Assassin","Support, Mage","Tank, Fighter","Support, Fighter",3,6,9
500,"Fighter, Mage","Mage, Support",Fighter,"Assassin, Mage",7,2,9
499,"Marksman, Support","Support, Fighter","Marksman, Mage","Mage, Support",7,2,9
27,"Fighter, Mage","Support, Fighter",Fighter,Mage,5,4,9
1086,"Fighter, Mage","Mage, Support","Fighter, Assassin","Mage, Support",5,4,9
1506,"Mage, Fighter","Mage, Support",Fighter,Mage,4,5,9
1091,"Mage, Fighter",Mage,"Fighter, Assassin","Mage, Support",5,4,9
53,Fighter,Mage,"Fighter, Mage","Mage, Marksman",1,8,9
379,"Tank, Fighter","Mage, Fighter","Tank, Fighter",Marksman,5,4,9
1481,"Marksman, Mage","Support, Mage","Marksman, Mage","Support, Mage",7,2,9
474,Tank,"Fighter, Mage","Fighter, Tank","Mage, Fighter",6,3,9
1573,"Fighter, Tank","Tank, Fighter","Tank, Fighter","Tank, Fighter",6,3,9
33,"Fighter, Mage","Tank, Fighter",Fighter,"Support, Fighter",6,3,9
397,"Fighter, Mage","Tank, Support","Tank, Fighter","Support, Mage",4,5,9
1426,Marksman,"Support, Tank","Assassin, Fighter","Support, Fighter",3,6,9
1417,"Marksman, Assassin","Mage, Support",Marksman,"Tank, Support",8,1,9
1376,"Marksman, Assassin",Support,Marksman,"Support, Fighter",5,4,9
1166,Marksman,"Support, Tank","Mage, Fighter","Support, Mage",3,6,9
1374,Marksman,"Support, Tank","Assassin, Fighter","Mage, Support",3,6,9
1317,"Marksman, Support","Support, Tank","Marksman, Mage","Support, Mage",4,5,9
42,Fighter,"Tank, Support","Mage, Fighter","Support, Tank",6,3,9
1179,"Assassin, Fighter",Marksman,"Fighter, Assassin","Mage, Support",2,7,9
422,Marksman,"Mage, Assassin","Marksman, Mage","Mage, Support",5,4,9
447,Fighter,"Support, Mage","Tank, Fighter","Support, Mage",5,4,9
1216,"Tank, Fighter",Mage,"Fighter, Mage","Mage, Support",6,3,9
352,"Marksman, Mage","Support, Mage","Marksman, Assassin","Tank, Support",9,0,9
915,Fighter,"Support, Mage","Fighter, Tank","Mage, Support",2,7,9
339,"Marksman, Assassin","Support, Tank","Marksman, Support","Support, Tank",4,5,9
532,"Marksman, Support","Support, Fighter",Marksman,"Tank, Support",6,3,9
997,Marksman,"Support, Mage","Marksman, Support","Support, Tank",5,4,9
1579,"Mage, Fighter","Mage, Support","Fighter, Assassin","Support, Mage",5,4,9
974,Marksman,"Tank, Support","Marksman, Support","Support, Tank",4,5,9
531,"Marksman, Mage","Fighter, Tank",Marksman,"Tank, Support",5,4,9
1590,Marksman,"Support, Mage",Marksman,Support,5,4,9
336,"Fighter, Tank","Mage, Support",Fighter,"Support, Tank",6,3,9
987,"Assassin, Fighter",Mage,Fighter,Mage,5,4,9
2493,"Fighter, Tank",Fighter,"Tank, Mage","Tank, Fighter",0,8,8
1449,"Fighter, Mage","Mage, Support","Mage, Fighter","Mage, Support",3,5,8
993,"Fighter, Mage",Fighter,"Tank, Mage","Tank, Fighter",5,3,8
2468,"Fighter, Tank",Fighter,"Tank, Mage","Fighter, Assassin",4,4,8
8662,"Tank, Fighter","Mage, Support","Tank, Mage",Marksman,5,3,8
2465,"Assassin, Fighter","Support, Mage",Marksman,"Support, Tank",6,2,8
745,"Tank, Fighter","Fighter, Mage","Fighter, Tank","Mage, Fighter",2,6,8
1804,"Assassin, Fighter","Support, Tank",Marksman,"Support, Mage",5,3,8
2452,"Marksman, Mage","Mage, Support","Marksman, Assassin","Tank, Support",4,4,8
1411,"Mage, Fighter","Support, Fighter","Assassin, Fighter","Mage, Support",3,5,8
2451,Fighter,"Mage, Support",Marksman,"Mage, Support",4,4,8
1465,Fighter,"Mage, Assassin","Fighter, Mage","Mage, Support",5,3,8
763,Fighter,"Mage, Support","Fighter, Mage","Support, Tank",4,4,8
1701,Marksman,"Mage, Support","Assassin, Fighter","Assassin, Fighter",3,5,8
1122,"Tank, Fighter","Mage, Marksman","Tank, Fighter",Mage,4,4,8
5473,"Fighter, Mage","Tank, Fighter","Fighter, Tank","Tank, Fighter",4,4,8
1120,"Fighter, Assassin","Mage, Support","Fighter, Mage","Mage, Support",4,4,8
2357,Marksman,Mage,"Assassin, Fighter","Mage, Support",3,5,8
931,"Assassin, Fighter","Support, Tank",Fighter,"Mage, Support",5,3,8
5903,"Fighter, Assassin",Marksman,"Fighter, Tank","Mage, Fighter",4,4,8
1398,"Mage, Fighter","Mage, Support",Marksman,"Support, Tank",3,5,8
1156,Marksman,"Support, Tank",Marksman,"Tank, Fighter",6,2,8
1203,"Fighter, Tank","Fighter, Mage",Tank,"Mage, Fighter",5,3,8
1194,Marksman,Mage,"Marksman, Mage","Support, Mage",4,4,8
1207,Fighter,"Mage, Support","Fighter, Assassin",Mage,4,4,8
2684,"Fighter, Tank","Mage, Support","Fighter, Mage","Support, Mage",6,2,8
1241,Marksman,"Support, Tank","Marksman, Support","Tank, Support",5,3,8
1261,"Fighter, Tank","Tank, Fighter","Tank, Fighter","Fighter, Mage",5,3,8
4416,Marksman,"Support, Tank",Marksman,"Support, Tank",2,6,8
699,"Tank, Fighter",Marksman,"Tank, Mage",Marksman,3,5,8
2683,"Tank, Fighter",Marksman,"Tank, Fighter","Mage, Fighter",4,4,8
1262,"Marksman, Assassin","Support, Mage","Marksman, Assassin","Support, Mage",5,3,8
1271,"Fighter, Mage","Assassin, Fighter","Tank, Fighter","Fighter, Assassin",3,5,8
1621,"Fighter, Tank","Mage, Fighter","Tank, Mage",Marksman,5,3,8
2656,"Mage, Fighter",Mage,"Assassin, Fighter",Mage,6,2,8
2628,"Tank, Fighter","Assassin, Fighter","Tank, Fighter","Fighter, Mage",6,2,8
941,Fighter,Mage,"Fighter, Assassin","Mage, Support",3,5,8
2606,Fighter,"Mage, Support","Assassin, Fighter","Mage, Support",1,7,8
725,Tank,"Mage, Fighter","Fighter, Tank",Fighter,0,8,8
1685,"Marksman, Assassin","Fighter, Tank",Marksman,"Support, Tank",5,3,8
2338,"Fighter, Tank","Assassin, Fighter","Tank, Fighter","Assassin, Fighter",3,5,8
771,"Fighter, Mage","Fighter, Assassin","Tank, Fighter","Assassin, Fighter",4,4,8
1111,"Assassin, Fighter","Support, Tank",Marksman,"Support, Fighter",4,4,8
777,Marksman,"Support, Tank","Fighter, Mage","Tank, Support",5,3,8
892,Fighter,"Mage, Support","Fighter, Mage","Support, Mage",4,4,8
1529,"Fighter, Tank","Mage, Support",Fighter,"Mage, Support",3,5,8
2057,Fighter,"Support, Mage",Marksman,"Support, Tank",7,1,8
1007,"Fighter, Assassin",Mage,"Assassin, Fighter","Mage, Support",4,4,8
2050,Marksman,Support,"Marksman, Assassin","Support, Tank",4,4,8
1051,"Mage, Fighter","Mage, Support",Marksman,"Support, Mage",4,4,8
820,Marksman,"Tank, Fighter","Marksman, Mage","Support, Tank",4,4,8
1045,"Fighter, Tank","Assassin, Fighter","Fighter, Tank","Mage, Fighter",7,1,8
1541,"Fighter, Mage","Assassin, Fighter","Fighter, Tank",Marksman,7,1,8
2037,"Fighter, Mage",Marksman,"Fighter, Tank","Assassin, Fighter",5,3,8
871,"Fighter, Mage","Mage, Support","Mage, Fighter","Support, Tank",6,2,8
1544,"Tank, Fighter","Tank, Support","Tank, Fighter","Support, Tank",4,4,8
1015,"Mage, Fighter","Mage, Support","Fighter, Mage",Mage,6,2,8
833,"Mage, Fighter","Support, Mage",Marksman,"Support, Tank",6,2,8
1561,"Mage, Fighter","Mage, Support","Fighter, Mage",Marksman,7,1,8
1008,"Assassin, Fighter","Assassin, Fighter","Fighter, Assassin","Mage, Support",6,2,8
1998,Marksman,"Fighter, Tank",Marksman,"Support, Mage",2,6,8
1995,"Fighter, Mage",Mage,"Assassin, Fighter","Mage, Support",5,3,8
1963,Fighter,Mage,"Fighter, Mage","Assassin, Mage",7,1,8
1014,"Fighter, Mage","Mage, Support","Mage, Fighter","Assassin, Mage",5,3,8
853,"Marksman, Mage","Tank, Support","Marksman, Mage","Support, Tank",3,5,8
1565,Marksman,"Support, Fighter","Marksman, Assassin","Mage, Support",6,2,8
1776,"Assassin, Fighter","Mage, Assassin",Fighter,"Mage, Support",6,2,8
1745,"Marksman, Mage","Tank, Support",Marksman,"Tank, Fighter",3,5,8
4397,Marksman,"Mage, Support",Marksman,"Tank, Fighter",5,3,8
2071,"Tank, Fighter","Mage, Support","Fighter, Assassin","Mage, Support",3,5,8
917,"Mage, Fighter","Mage, Support",Fighter,Marksman,2,6,8
1480,"Tank, Fighter",Marksman,"Tank, Fighter","Mage, Support",7,1,8
1613,Marksman,Mage,Marksman,"Mage, Support",6,2,8
1709,"Marksman, Assassin","Support, Fighter","Marksman, Assassin","Support, Tank",5,3,8
1712,Marksman,"Mage, Support",Marksman,"Fighter, Tank",6,2,8
1718,"Marksman, Support","Support, Mage","Marksman, Mage","Support, Tank",5,3,8
909,"Mage, Fighter",Marksman,"Fighter, Assassin","Mage, Support",7,1,8
2191,"Mage, Fighter","Support, Tank","Assassin, Fighter","Support, Mage",5,3,8
793,"Fighter, Mage","Support, Mage","Tank, Fighter","Tank, Support",7,1,8
1509,"Marksman, Support","Mage, Support","Marksman, Assassin","Support, Tank",3,5,8
796,"Fighter, Tank","Mage, Fighter","Fighter, Mage",Marksman,5,3,8
2188,"Fighter, Tank","Mage, Fighter","Fighter, Tank","Fighter, Tank",4,4,8
1519,"Tank, Fighter","Support, Fighter","Assassin, Fighter","Support, Mage",4,4,8
905,"Fighter, Tank",Marksman,Tank,"Assassin, Fighter",5,3,8
1635,Marksman,"Mage, Support","Fighter, Mage","Support, Mage",4,4,8
1522,"Fighter, Assassin","Support, Mage","Assassin, Fighter","Support, Fighter",5,3,8
2105,"Tank, Fighter","Mage, Fighter","Tank, Fighter","Assassin, Fighter",6,2,8
1063,Fighter,"Mage, Support","Fighter, Mage",Mage,3,5,8
2091,Marksman,"Mage, Fighter","Assassin, Fighter","Mage, Support",6,2,8
803,Marksman,"Fighter, Tank","Marksman, Mage","Tank, Support",4,4,8
1524,"Fighter, Assassin","Mage, Support","Assassin, Fighter","Assassin, Fighter",3,5,8
2157,"Fighter, Tank","Mage, Fighter","Tank, Fighter","Fighter, Mage",3,5,8
2108,"Assassin, Fighter",Mage,Marksman,"Mage, Support",6,2,8
325,"Marksman, Support","Support, Fighter",Marksman,"Support, Tank",6,2,8
122,"Assassin, Fighter","Fighter, Mage","Tank, Mage",Fighter,6,2,8
152,"Tank, Mage",Marksman,"Assassin, Fighter","Mage, Fighter",5,3,8
466,"Fighter, Assassin","Mage, Support","Fighter, Tank","Mage, Support",3,5,8
395,"Assassin, Fighter","Mage, Assassin","Fighter, Assassin","Support, Mage",5,3,8
523,"Marksman, Mage","Support, Tank","Marksman, Support","Support, Fighter",6,2,8
644,Marksman,"Mage, Assassin","Fighter, Assassin","Mage, Support",2,6,8
61,Fighter,"Mage, Support","Mage, Fighter","Support, Tank",4,4,8
598,"Marksman, Assassin","Mage, Support","Marksman, Mage","Support, Tank",4,4,8
596,"Tank, Mage","Assassin, Fighter","Fighter, Mage","Fighter, Assassin",4,4,8
463,"Assassin, Fighter","Mage, Fighter",Marksman,Mage,5,3,8
460,"Fighter, Assassin","Mage, Support","Assassin, Fighter","Mage, Fighter",5,3,8
282,"Marksman, Mage","Support, Tank",Marksman,"Fighter, Tank",2,6,8
353,"Marksman, Support","Support, Mage","Marksman, Mage","Mage, Assassin",6,2,8
402,"Tank, Fighter","Tank, Support","Fighter, Mage","Support, Tank",5,3,8
350,Marksman,"Support, Tank","Mage, Fighter","Tank, Support",3,5,8
534,"Fighter, Tank",Marksman,"Fighter, Tank","Fighter, Mage",2,6,8
90,"Assassin, Fighter","Support, Tank",Fighter,"Tank, Support",4,4,8
212,"Marksman, Mage","Mage, Support","Marksman, Support","Support, Fighter",5,3,8
139,"Marksman, Support","Support, Tank","Marksman, Assassin","Tank, Support",5,3,8
472,"Tank, Fighter","Mage, Fighter","Tank, Fighter","Mage, Marksman",4,4,8
475,Fighter,"Support, Tank",Marksman,"Support, Mage",4,4,8
82,"Assassin, Fighter","Tank, Support","Mage, Fighter","Support, Tank",2,6,8
502,"Mage, Fighter","Support, Tank",Marksman,"Fighter, Tank",1,7,8
381,"Marksman, Mage","Mage, Assassin","Marksman, Assassin","Mage, Support",7,1,8
496,"Marksman, Support","Support, Tank",Marksman,"Tank, Support",5,3,8
70,"Marksman, Assassin","Mage, Support","Marksman, Mage",Marksman,4,4,8
614,"Marksman, Mage","Support, Fighter",Marksman,"Tank, Support",6,2,8
198,"Marksman, Support","Mage, Assassin","Marksman, Mage","Support, Mage",5,3,8
162,Fighter,"Support, Tank","Fighter, Mage","Tank, Support",6,2,8
490,"Tank, Fighter","Assassin, Fighter","Fighter, Tank","Mage, Fighter",2,6,8
633,"Assassin, Fighter","Mage, Fighter",Marksman,"Mage, Support",4,4,8
257,"Marksman, Mage","Mage, Support","Marksman, Support",Marksman,3,5,8
363,"Mage, Fighter","Support, Tank",Marksman,"Support, Fighter",3,5,8
486,"Fighter, Tank",Fighter,"Fighter, Mage","Fighter, Mage",5,3,8
256,"Assassin, Fighter","Tank, Support",Marksman,"Support, Tank",5,3,8
479,"Fighter, Tank","Mage, Fighter","Fighter, Mage",Fighter,3,5,8
477,"Tank, Fighter","Mage, Fighter","Fighter, Assassin",Fighter,5,3,8
520,"Assassin, Fighter","Mage, Support","Fighter, Assassin",Marksman,4,4,8
344,"Tank, Mage","Fighter, Mage",Tank,"Tank, Fighter",6,2,8
529,Marksman,"Mage, Support","Marksman, Assassin","Mage, Assassin",3,5,8
425,Marksman,"Tank, Fighter",Marksman,Mage,5,3,8
429,"Fighter, Tank","Fighter, Mage","Fighter, Mage","Tank, Fighter",6,2,8
321,"Marksman, Assassin","Mage, Support","Marksman, Mage","Mage, Assassin",2,6,8
185,Fighter,"Mage, Tank","Mage, Fighter",Mage,4,4,8
299,"Tank, Fighter","Support, Tank","Tank, Fighter","Support, Tank",4,4,8
112,Tank,"Fighter, Mage","Tank, Mage",Fighter,5,3,8
216,"Tank, Mage",Marksman,"Assassin, Fighter",Fighter,5,3,8
182,"Fighter, Tank","Assassin, Fighter","Fighter, Tank","Assassin, Fighter",5,3,8
180,"Fighter, Mage","Support, Tank",Fighter,"Tank, Support",6,2,8
220,"Mage, Fighter","Mage, Support",Fighter,"Support, Tank",3,5,8
327,"Fighter, Mage","Mage, Support",Fighter,"Support, Mage",5,3,8
545,"Marksman, Mage","Mage, Support",Marksman,"Tank, Fighter",5,3,8
54,Fighter,"Fighter, Tank","Mage, Fighter","Tank, Support",4,4,8
59,Fighter,"Support, Fighter","Mage, Fighter","Tank, Support",7,1,8
100,"Tank, Fighter",Marksman,"Assassin, Fighter",Marksman,5,2,7
369,"Assassin, Fighter",Marksman,"Tank, Mage",Marksman,3,4,7
2473,"Fighter, Tank",Fighter,"Fighter, Tank","Fighter, Assassin",3,4,7
517,"Tank, Fighter","Mage, Fighter","Tank, Mage",Marksman,4,3,7
1528,"Assassin, Fighter","Support, Fighter","Fighter, Assassin","Support, Mage",3,4,7
1526,"Marksman, Mage","Mage, Assassin","Marksman, Support","Mage, Support",6,1,7
2000,Marksman,Mage,"Fighter, Mage",Mage,2,5,7
562,"Fighter, Assassin","Support, Fighter","Assassin, Fighter","Support, Tank",3,4,7
889,"Tank, Fighter","Assassin, Fighter","Tank, Mage",Fighter,3,4,7
1034,Fighter,"Mage, Support","Mage, Fighter","Mage, Support",3,4,7
179,Marksman,"Tank, Support",Fighter,"Support, Fighter",3,4,7
6083,"Fighter, Tank",Marksman,"Tank, Fighter","Mage, Fighter",3,4,7
3515,"Assassin, Fighter","Mage, Support",Marksman,"Support, Tank",7,0,7
1037,Marksman,"Support, Mage","Mage, Fighter","Support, Tank",4,3,7
1640,"Tank, Fighter","Support, Tank","Tank, Fighter","Tank, Support",5,2,7
4528,"Marksman, Mage","Tank, Fighter",Marksman,"Support, Fighter",4,3,7
329,Fighter,Marksman,"Fighter, Mage",Mage,2,5,7
1024,"Assassin, Fighter","Mage, Support","Assassin, Fighter",Marksman,4,3,7
1025,"Fighter, Assassin",Mage,Fighter,"Mage, Support",3,4,7
1028,"Mage, Fighter","Mage, Support",Fighter,"Assassin, Mage",5,2,7
367,"Fighter, Assassin","Support, Mage",Marksman,"Mage, Support",6,1,7
897,Fighter,"Support, Tank","Fighter, Assassin","Mage, Support",7,0,7
946,"Tank, Mage",Marksman,"Tank, Fighter","Assassin, Fighter",3,4,7
902,"Tank, Fighter","Support, Fighter","Tank, Fighter",Support,2,5,7
2426,"Fighter, Mage","Assassin, Fighter","Fighter, Tank","Mage, Fighter",4,3,7
952,Marksman,"Mage, Tank","Assassin, Fighter","Mage, Support",4,3,7
348,Marksman,"Support, Mage","Fighter, Assassin","Mage, Support",1,6,7
959,"Mage, Fighter","Support, Tank","Fighter, Mage","Support, Mage",3,4,7
274,Fighter,"Support, Tank","Assassin, Fighter","Support, Mage",4,3,7
963,Tank,Marksman,"Tank, Fighter","Assassin, Fighter",6,1,7
1972,Marksman,Mage,Marksman,"Mage, Marksman",3,4,7
934,Marksman,"Mage, Support","Fighter, Assassin",Mage,3,4,7
505,"Tank, Fighter","Mage, Fighter","Fighter, Tank","Assassin, Fighter",2,5,7
1591,Marksman,Support,"Marksman, Mage","Support, Mage",4,3,7
5964,"Fighter, Tank","Tank, Fighter","Fighter, Mage","Tank, Fighter",4,3,7
2653,"Fighter, Tank","Tank, Fighter","Fighter, Mage","Fighter, Mage",6,1,7
342,"Fighter, Mage","Support, Tank",Fighter,"Support, Tank",4,3,7
2411,"Fighter, Tank","Assassin, Fighter","Fighter, Tank","Fighter, Assassin",3,4,7
2652,"Assassin, Fighter","Mage, Assassin","Assassin, Fighter","Mage, Support",4,3,7
984,"Assassin, Fighter","Mage, Support","Assassin, Fighter","Support, Fighter",2,5,7
920,Fighter,"Support, Mage","Tank, Fighter","Support, Fighter",3,4,7
553,"Marksman, Support","Support, Tank","Marksman, Assassin","Support, Fighter",3,4,7
2648,"Tank, Mage","Fighter, Assassin","Fighter, Mage","Tank, Fighter",2,5,7
528,"Marksman, Assassin","Support, Tank","Marksman, Support","Support, Mage",4,3,7
525,"Mage, Fighter","Assassin, Mage",Fighter,Marksman,3,4,7
358,"Fighter, Tank","Fighter, Mage",Tank,"Fighter, Tank",6,1,7
912,"Fighter, Tank","Mage, Fighter","Tank, Fighter",Marksman,5,2,7
1927,"Tank, Fighter","Support, Fighter","Fighter, Mage","Tank, Fighter",1,6,7
560,"Assassin, Fighter","Mage, Assassin","Fighter, Assassin","Mage, Support",6,1,7
1990,Fighter,"Support, Mage","Assassin, Fighter","Mage, Support",2,5,7
193,Fighter,"Support, Tank",Marksman,"Mage, Support",5,2,7
2572,"Fighter, Mage","Fighter, Assassin","Fighter, Tank","Assassin, Fighter",3,4,7
269,"Fighter, Mage","Support, Tank",Fighter,"Fighter, Tank",4,3,7
1240,"Fighter, Tank","Fighter, Assassin","Tank, Mage","Assassin, Fighter",1,6,7
2116,"Fighter, Tank","Assassin, Fighter","Tank, Fighter","Fighter, Mage",7,0,7
1381,Marksman,"Mage, Assassin","Mage, Fighter","Mage, Support",5,2,7
1221,Fighter,"Mage, Support","Fighter, Assassin","Mage, Support",4,3,7
1220,"Tank, Fighter","Mage, Support","Fighter, Mage",Mage,3,4,7
2107,"Fighter, Assassin","Mage, Fighter","Tank, Fighter",Marksman,4,3,7
1392,"Fighter, Mage",Mage,Fighter,"Assassin, Mage",4,3,7
2104,"Marksman, Support","Support, Mage",Marksman,"Support, Mage",2,5,7
1397,"Fighter, Mage","Support, Fighter",Fighter,"Support, Mage",3,4,7
3686,"Fighter, Assassin","Tank, Fighter","Fighter, Tank","Tank, Fighter",3,4,7
3876,Marksman,"Mage, Support","Mage, Fighter",Mage,5,2,7
435,"Fighter, Mage",Fighter,"Tank, Fighter","Mage, Fighter",3,4,7
232,"Marksman, Mage","Support, Fighter",Marksman,Support,3,4,7
2254,"Marksman, Mage","Support, Fighter","Marksman, Mage","Support, Tank",3,4,7
1195,"Marksman, Mage","Tank, Support","Marksman, Assassin","Support, Tank",6,1,7
2257,"Fighter, Mage","Tank, Fighter","Tank, Mage","Assassin, Fighter",5,2,7
2944,"Assassin, Fighter","Support, Mage","Support, Mage","Mage, Support",1,6,7
109,"Mage, Fighter","Support, Fighter",Fighter,"Tank, Support",2,5,7
2089,"Fighter, Tank","Mage, Fighter","Fighter, Assassin","Assassin, Fighter",4,3,7
1366,"Tank, Fighter","Support, Fighter","Tank, Fighter","Support, Mage",5,2,7
413,"Fighter, Mage","Support, Mage",Fighter,"Support, Fighter",4,3,7
1314,"Assassin, Fighter","Mage, Support",Fighter,"Mage, Fighter",5,2,7
8432,"Mage, Fighter",Marksman,"Assassin, Fighter","Mage, Support",3,4,7
1322,"Fighter, Mage",Mage,"Mage, Fighter","Support, Mage",3,4,7
5646,"Tank, Mage","Assassin, Fighter","Fighter, Tank","Fighter, Assassin",6,1,7
1280,"Marksman, Mage","Support, Tank",Marksman,Support,6,1,7
419,Marksman,Support,"Marksman, Mage","Support, Fighter",5,2,7
5663,"Fighter, Tank",Fighter,"Fighter, Tank","Tank, Fighter",4,3,7
226,Marksman,"Mage, Support","Marksman, Support",Marksman,4,3,7
410,"Fighter, Mage","Support, Fighter","Tank, Fighter","Tank, Support",3,4,7
3734,"Tank, Fighter","Support, Fighter","Tank, Fighter","Tank, Support",4,3,7
1345,"Tank, Fighter","Fighter, Assassin","Fighter, Tank","Mage, Fighter",3,4,7
8391,Fighter,Mage,"Fighter, Tank","Mage, Support",3,4,7
2904,"Fighter, Mage","Mage, Support","Tank, Fighter","Support, Mage",3,4,7
2856,Fighter,Mage,"Tank, Fighter",Mage,5,2,7
2261,Fighter,"Mage, Support","Fighter, Mage","Tank, Support",4,3,7
404,"Fighter, Mage",Marksman,Tank,"Assassin, Fighter",2,5,7
1505,"Tank, Fighter","Support, Fighter","Tank, Fighter","Mage, Support",4,3,7
8617,"Mage, Fighter","Mage, Support","Assassin, Fighter",Mage,5,2,7
242,"Fighter, Mage","Mage, Marksman","Mage, Fighter",Mage,6,1,7
5827,"Fighter, Tank","Assassin, Fighter","Fighter, Mage","Fighter, Assassin",4,3,7
2056,"Marksman, Assassin","Support, Tank","Marksman, Mage","Tank, Support",6,1,7
2049,"Marksman, Mage","Support, Tank","Marksman, Mage","Tank, Support",5,2,7
2342,"Assassin, Fighter","Mage, Support","Fighter, Mage","Support, Mage",2,5,7
131,"Mage, Fighter","Support, Tank",Fighter,"Tank, Support",3,4,7
1648,Marksman,"Tank, Fighter","Marksman, Mage","Support, Fighter",2,5,7
383,"Marksman, Mage","Mage, Support","Marksman, Assassin",Marksman,3,4,7
1080,"Fighter, Assassin","Mage, Support","Mage, Fighter",Mage,4,3,7
1079,Fighter,"Mage, Support","Mage, Fighter",Marksman,4,3,7
197,"Marksman, Mage","Mage, Assassin","Marksman, Support",Marksman,4,3,7
2036,"Mage, Fighter","Mage, Support","Fighter, Assassin","Assassin, Mage",7,0,7
196,"Marksman, Assassin","Tank, Support",Marksman,Support,3,4,7
2365,"Assassin, Fighter","Support, Mage","Fighter, Mage",Mage,4,3,7
1052,"Fighter, Assassin",Mage,"Mage, Fighter","Mage, Support",1,6,7
476,"Fighter, Assassin","Support, Mage","Mage, Fighter","Support, Mage",4,3,7
205,"Assassin, Fighter",Fighter,"Tank, Mage","Fighter, Mage",6,1,7
210,"Fighter, Assassin","Support, Mage","Mage, Fighter","Support, Fighter",1,6,7
1131,"Fighter, Tank","Tank, Fighter","Fighter, Mage",Fighter,4,3,7
5112,"Tank, Fighter","Mage, Support","Assassin, Fighter","Mage, Support",6,1,7
1412,Marksman,"Fighter, Tank","Marksman, Support","Support, Tank",5,2,7
451,Fighter,"Tank, Support","Fighter, Mage","Support, Mage",1,6,7
454,"Fighter, Assassin","Mage, Support","Mage, Fighter","Support, Fighter",4,3,7
2083,Marksman,"Fighter, Tank",Marksman,"Support, Fighter",3,4,7
400,"Marksman, Assassin","Tank, Support",Marksman,"Mage, Support",4,3,7
1163,"Tank, Fighter","Mage, Assassin","Fighter, Assassin","Assassin, Mage",4,3,7
123,"Fighter, Mage","Support, Fighter",Fighter,"Tank, Fighter",3,4,7
1430,"Fighter, Tank","Mage, Support","Assassin, Fighter","Mage, Support",5,2,7
1436,"Fighter, Assassin","Mage, Support","Mage, Fighter","Mage, Assassin",6,1,7
1440,"Mage, Fighter","Mage, Support","Fighter, Assassin","Mage, Assassin",4,3,7
1442,Fighter,"Mage, Support","Fighter, Tank",Mage,4,3,7
1443,"Fighter, Assassin","Mage, Support","Assassin, Fighter",Mage,3,4,7
2309,"Tank, Mage","Assassin, Fighter","Fighter, Mage",Fighter,4,3,7
464,"Tank, Fighter","Tank, Fighter",Fighter,"Support, Fighter",3,4,7
384,Marksman,"Support, Fighter","Marksman, Mage","Fighter, Tank",3,4,7
1307,"Assassin, Fighter","Mage, Support","Mage, Fighter",Marksman,5,2,7
1731,"Assassin, Fighter","Mage, Support","Support, Mage","Support, Mage",5,2,7
610,Marksman,"Mage, Support","Mage, Fighter","Assassin, Fighter",4,3,7
2550,"Marksman, Mage","Support, Tank","Marksman, Assassin","Mage, Support",3,4,7
2625,"Tank, Fighter","Mage, Fighter","Tank, Mage","Assassin, Fighter",4,3,7
1696,Fighter,"Mage, Support","Fighter, Tank","Mage, Support",5,2,7
1862,"Marksman, Assassin","Support, Tank",Marksman,"Support, Tank",3,4,7
690,"Tank, Mage","Tank, Fighter",Tank,"Fighter, Mage",5,2,7
713,"Marksman, Assassin","Fighter, Tank",Marksman,"Tank, Support",3,4,7
840,"Assassin, Fighter","Support, Mage","Fighter, Assassin","Support, Fighter",5,2,7
704,"Marksman, Support","Mage, Support","Marksman, Mage","Support, Tank",5,2,7
640,"Fighter, Tank","Fighter, Mage",Tank,"Tank, Fighter",4,3,7
601,"Marksman, Mage","Mage, Support","Marksman, Support","Mage, Assassin",5,2,7
822,Fighter,"Tank, Support",Marksman,"Support, Tank",4,3,7
751,"Fighter, Mage",Fighter,"Tank, Mage","Assassin, Fighter",2,5,7
1711,"Assassin, Fighter","Mage, Support",Marksman,Marksman,2,5,7
1697,"Tank, Fighter","Support, Tank","Fighter, Mage","Support, Fighter",3,4,7
4455,Marksman,Mage,Marksman,Mage,4,3,7
657,"Fighter, Mage","Tank, Fighter","Tank, Fighter","Support, Fighter",4,3,7
310,Marksman,"Fighter, Tank","Marksman, Support","Tank, Support",3,4,7
84,Fighter,"Support, Mage","Fighter, Mage","Tank, Fighter",5,2,7
4447,"Marksman, Support","Support, Fighter",Marksman,"Support, Mage",4,3,7
66,"Fighter, Mage","Fighter, Mage","Tank, Mage",Fighter,2,5,7
171,"Assassin, Fighter",Mage,Fighter,"Mage, Fighter",2,5,7
719,"Marksman, Assassin","Mage, Support",Marksman,"Mage, Assassin",1,6,7
1715,"Fighter, Tank","Mage, Fighter","Fighter, Assassin","Fighter, Assassin",3,4,7
661,Fighter,"Support, Mage","Fighter, Assassin","Mage, Support",3,4,7
659,"Marksman, Support","Tank, Support",Marksman,"Support, Fighter",2,5,7
2495,"Tank, Fighter","Assassin, Fighter","Fighter, Tank","Fighter, Assassin",2,5,7
175,"Fighter, Mage","Mage, Tank",Fighter,"Mage, Support",2,5,7
1888,"Fighter, Tank","Assassin, Fighter","Tank, Mage",Marksman,6,1,7
314,Tank,Fighter,"Fighter, Tank","Mage, Fighter",5,2,7
178,"Tank, Fighter","Tank, Support","Fighter, Mage",Support,6,1,7
2501,"Assassin, Fighter","Support, Tank","Fighter, Assassin","Mage, Support",5,2,7
621,"Tank, Fighter","Support, Mage","Fighter, Assassin",Mage,4,3,7
117,"Fighter, Mage","Mage, Marksman",Fighter,"Assassin, Mage",4,3,7
2543,"Fighter, Tank","Mage, Support","Assassin, Fighter","Mage, Assassin",2,5,7
1837,Tank,"Assassin, Fighter","Fighter, Tank","Mage, Fighter",5,2,7
1870,"Assassin, Fighter","Mage, Assassin","Fighter, Tank","Mage, Support",4,3,7
1829,"Tank, Fighter","Support, Fighter","Tank, Fighter","Support, Tank",6,1,7
746,"Mage, Fighter","Mage, Support","Assassin, Fighter","Support, Tank",3,4,7
710,"Fighter, Mage","Support, Mage","Assassin, Fighter","Tank, Support",6,1,7
1868,"Fighter, Mage","Mage, Support","Assassin, Fighter","Support, Mage",4,3,7
622,"Fighter, Assassin","Support, Fighter","Tank, Fighter","Support, Mage",5,2,7
584,"Tank, Fighter","Fighter, Mage","Fighter, Tank",Fighter,5,2,7
781,Marksman,"Support, Fighter","Mage, Fighter","Support, Tank",2,5,7
628,Marksman,"Mage, Support","Assassin, Fighter","Mage, Fighter",5,2,7
818,"Tank, Fighter",Marksman,"Tank, Mage","Mage, Fighter",3,4,7
734,"Mage, Fighter","Support, Tank","Assassin, Fighter","Mage, Support",5,2,7
683,"Marksman, Assassin","Mage, Support","Marksman, Support","Support, Tank",3,4,7
156,"Mage, Fighter",Mage,Fighter,"Mage, Marksman",1,6,7
624,"Assassin, Fighter","Support, Tank","Assassin, Fighter","Mage, Support",4,3,7
62,"Assassin, Fighter",Marksman,"Tank, Mage",Fighter,1,6,7
846,"Fighter, Mage",Mage,"Assassin, Fighter",Mage,5,2,7
2530,"Tank, Mage","Tank, Fighter","Tank, Mage","Fighter, Mage",3,4,7
845,"Fighter, Mage",Fighter,"Fighter, Tank","Tank, Fighter",5,2,7
2626,"Fighter, Mage","Assassin, Fighter","Fighter, Tank","Assassin, Fighter",3,4,7
3291,"Assassin, Fighter","Mage, Support",Marksman,Mage,5,2,7
627,"Tank, Fighter","Support, Mage",Fighter,"Tank, Support",3,4,7
1879,"Fighter, Tank","Mage, Fighter",Fighter,Mage,2,5,7
3207,"Fighter, Assassin","Support, Fighter","Tank, Fighter","Support, Tank",3,3,6
468,"Marksman, Assassin","Mage, Support","Marksman, Support","Mage, Assassin",6,0,6
204,Fighter,"Support, Tank","Mage, Fighter","Mage, Support",2,4,6
634,Marksman,"Mage, Support","Marksman, Support","Tank, Support",3,3,6
1132,Marksman,"Mage, Support","Assassin, Fighter",Marksman,3,3,6
465,"Fighter, Tank","Mage, Fighter","Assassin, Fighter",Marksman,4,2,6
1450,"Fighter, Mage","Mage, Support","Mage, Fighter",Marksman,3,3,6
741,"Fighter, Mage","Support, Tank",Marksman,"Tank, Support",4,2,6
739,Marksman,"Mage, Support","Mage, Fighter","Support, Mage",2,4,6
9026,"Assassin, Fighter",Mage,"Fighter, Mage","Mage, Support",4,2,6
396,"Marksman, Support","Support, Fighter","Marksman, Assassin","Mage, Support",2,4,6
173,"Tank, Mage","Assassin, Fighter","Assassin, Fighter",Marksman,3,3,6
3664,"Tank, Fighter","Support, Mage","Assassin, Fighter","Support, Tank",4,2,6
733,Marksman,Support,"Marksman, Assassin","Tank, Support",4,2,6
2295,"Marksman, Mage","Support, Mage",Marksman,"Mage, Assassin",1,5,6
1125,Marksman,Mage,"Assassin, Fighter",Marksman,2,4,6
480,Fighter,"Mage, Support","Mage, Fighter","Tank, Support",4,2,6
1123,"Marksman, Mage","Support, Tank",Marksman,"Tank, Fighter",1,5,6
261,"Fighter, Tank",Fighter,Fighter,"Fighter, Mage",3,3,6
2350,Marksman,"Support, Fighter",Marksman,"Support, Fighter",5,1,6
304,"Mage, Fighter","Support, Tank","Fighter, Assassin","Tank, Support",1,5,6
1707,"Marksman, Support","Support, Tank","Marksman, Assassin","Support, Mage",4,2,6
2358,Tank,"Assassin, Fighter","Fighter, Tank","Fighter, Assassin",4,2,6
1484,Fighter,"Mage, Support","Assassin, Fighter","Support, Mage",3,3,6
495,"Fighter, Marksman","Tank, Fighter",Marksman,"Support, Fighter",2,4,6
1844,"Mage, Fighter","Mage, Support","Fighter, Assassin","Support, Tank",3,3,6
1845,"Fighter, Assassin","Support, Tank","Assassin, Fighter","Support, Fighter",2,4,6
1479,"Tank, Mage","Mage, Support",Fighter,"Mage, Support",1,5,6
3041,"Tank, Fighter","Mage, Support","Tank, Fighter","Mage, Fighter",3,3,6
773,"Tank, Fighter",Marksman,"Fighter, Mage","Fighter, Assassin",2,4,6
1059,"Mage, Fighter","Assassin, Fighter","Fighter, Assassin","Mage, Support",1,5,6
1058,"Assassin, Fighter","Mage, Support","Mage, Fighter","Assassin, Fighter",4,2,6
2020,Fighter,Mage,"Mage, Fighter","Marksman, Mage",4,2,6
4680,"Marksman, Assassin","Tank, Fighter",Marksman,"Support, Fighter",3,3,6
1053,"Assassin, Fighter","Support, Mage","Mage, Fighter",Mage,4,2,6
760,"Mage, Fighter",Mage,Fighter,"Assassin, Mage",3,3,6
759,"Marksman, Assassin","Support, Fighter","Marksman, Support","Support, Mage",3,3,6
1839,"Tank, Fighter","Support, Tank","Fighter, Assassin","Support, Fighter",3,3,6
1102,Marksman,"Assassin, Mage","Assassin, Fighter","Mage, Support",5,1,6
2317,"Tank, Mage","Fighter, Assassin","Fighter, Tank","Tank, Fighter",5,1,6
166,"Fighter, Mage","Tank, Support",Fighter,"Support, Fighter",4,2,6
1116,"Assassin, Fighter","Mage, Support",Marksman,"Assassin, Fighter",4,2,6
1841,"Tank, Fighter","Support, Tank",Fighter,"Support, Fighter",2,4,6
754,"Fighter, Tank","Fighter, Mage","Tank, Mage","Assassin, Fighter",4,2,6
2323,"Marksman, Support","Support, Mage","Marksman, Mage","Support, Mage",4,2,6
461,"Fighter, Mage","Tank, Support","Assassin, Fighter","Support, Tank",1,5,6
3449,Fighter,"Support, Mage","Tank, Fighter","Tank, Support",3,3,6
1842,"Fighter, Tank","Mage, Fighter","Tank, Mage","Fighter, Assassin",2,4,6
2333,"Marksman, Support","Support, Fighter",Marksman,"Mage, Support",0,6,6
303,"Tank, Mage","Mage, Fighter","Tank, Fighter","Fighter, Mage",2,4,6
3022,"Tank, Fighter","Support, Tank","Fighter, Mage","Support, Mage",3,3,6
1097,"Mage, Fighter","Mage, Support","Assassin, Fighter","Assassin, Fighter",3,3,6
3024,"Tank, Fighter","Mage, Marksman","Tank, Fighter","Mage, Fighter",3,3,6
391,"Marksman, Support","Mage, Support","Marksman, Mage","Mage, Assassin",4,2,6
2741,"Fighter, Mage","Support, Mage","Mage, Fighter","Support, Mage",2,4,6
120,"Fighter, Tank","Fighter, Mage",Fighter,Fighter,2,4,6
5763,"Tank, Fighter",Fighter,"Tank, Fighter","Fighter, Mage",1,5,6
2287,Fighter,"Support, Mage","Fighter, Mage",Mage,4,2,6
1233,"Fighter, Tank",Mage,Fighter,"Mage, Marksman",3,3,6
2210,"Fighter, Assassin","Mage, Fighter","Fighter, Tank",Marksman,2,4,6
5543,"Fighter, Tank","Assassin, Fighter","Fighter, Tank",Fighter,4,2,6
1354,"Fighter, Assassin","Mage, Support","Assassin, Fighter",Marksman,1,5,6
8468,"Fighter, Assassin","Mage, Assassin","Tank, Fighter","Mage, Support",3,3,6
1256,"Marksman, Mage","Support, Tank","Marksman, Mage","Support, Fighter",3,3,6
2217,"Fighter, Mage","Fighter, Assassin","Fighter, Tank",Fighter,4,2,6
1365,Marksman,"Support, Mage","Mage, Fighter","Support, Mage",3,3,6
2220,Tank,"Assassin, Fighter","Tank, Fighter","Mage, Fighter",3,3,6
2579,"Tank, Fighter","Mage, Fighter","Tank, Fighter","Mage, Support",2,4,6
2128,"Fighter, Assassin",Fighter,"Fighter, Assassin","Fighter, Mage",3,3,6
2126,"Tank, Fighter","Support, Fighter",Fighter,"Tank, Fighter",3,3,6
5489,"Tank, Fighter","Mage, Fighter",Tank,"Assassin, Fighter",3,3,6
9516,"Assassin, Fighter",Mage,"Assassin, Fighter","Mage, Support",3,3,6
5488,"Tank, Fighter","Assassin, Fighter","Fighter, Mage","Assassin, Fighter",2,4,6
2123,Marksman,"Support, Mage","Marksman, Mage","Fighter, Tank",4,2,6
2122,"Fighter, Mage","Assassin, Fighter","Tank, Fighter","Assassin, Fighter",5,1,6
407,"Fighter, Tank","Fighter, Mage","Tank, Fighter","Fighter, Assassin",6,0,6
3818,"Assassin, Fighter","Support, Mage","Tank, Fighter","Support, Mage",4,2,6
8392,"Fighter, Assassin","Mage, Support",Fighter,"Assassin, Mage",3,3,6
1346,"Tank, Fighter","Mage, Support","Tank, Fighter","Support, Fighter",3,3,6
218,"Mage, Fighter","Mage, Marksman","Fighter, Mage",Mage,3,3,6
2181,"Fighter, Tank","Fighter, Mage","Fighter, Mage","Assassin, Fighter",1,5,6
412,"Mage, Fighter","Mage, Support",Fighter,"Tank, Support",4,2,6
417,"Mage, Fighter","Support, Tank",Marksman,"Mage, Support",2,4,6
2167,"Tank, Fighter","Assassin, Fighter","Tank, Fighter",Fighter,3,3,6
676,"Marksman, Support","Mage, Support","Marksman, Assassin","Support, Fighter",2,4,6
5584,"Tank, Fighter",Marksman,"Tank, Fighter","Assassin, Fighter",3,3,6
1289,"Assassin, Fighter","Tank, Support","Fighter, Mage","Support, Mage",1,5,6
8405,"Assassin, Fighter",Mage,Marksman,Mage,5,1,6
685,"Marksman, Assassin","Support, Mage",Marksman,"Tank, Fighter",2,4,6
418,"Fighter, Mage","Marksman, Mage",Fighter,"Mage, Marksman",2,4,6
298,Marksman,"Tank, Support","Mage, Fighter","Support, Fighter",2,4,6
225,Marksman,"Mage, Marksman","Mage, Fighter",Mage,4,2,6
3327,"Assassin, Fighter","Support, Fighter","Fighter, Mage","Support, Tank",3,3,6
3799,"Tank, Fighter",Mage,"Tank, Fighter","Mage, Support",3,3,6
2156,Fighter,"Support, Mage","Fighter, Assassin",Mage,1,5,6
663,"Assassin, Fighter","Support, Mage","Fighter, Assassin","Mage, Assassin",5,1,6
1377,"Tank, Mage","Fighter, Assassin","Tank, Fighter","Assassin, Fighter",3,3,6
426,"Assassin, Fighter","Tank, Support","Fighter, Mage","Support, Tank",4,2,6
2789,"Fighter, Tank","Mage, Support","Mage, Fighter","Support, Mage",0,6,6
108,"Fighter, Assassin","Support, Fighter","Fighter, Mage","Tank, Support",3,3,6
403,Marksman,Support,"Marksman, Assassin","Support, Mage",4,2,6
2268,"Fighter, Tank","Fighter, Mage","Fighter, Tank","Tank, Fighter",2,4,6
449,"Fighter, Mage","Mage, Support","Tank, Mage",Marksman,5,1,6
450,"Fighter, Mage","Assassin, Fighter",Tank,Marksman,3,3,6
1178,"Assassin, Fighter","Mage, Support","Fighter, Assassin","Support, Tank",4,2,6
1177,"Assassin, Fighter",Marksman,Marksman,"Mage, Support",4,2,6
458,"Fighter, Assassin","Mage, Assassin",Marksman,"Mage, Support",3,3,6
265,"Assassin, Fighter","Fighter, Mage",Tank,Fighter,4,2,6
1828,"Assassin, Fighter","Mage, Support","Fighter, Mage",Mage,4,2,6
648,Marksman,"Support, Mage","Marksman, Assassin","Mage, Assassin",2,4,6
1421,"Tank, Fighter","Fighter, Tank","Fighter, Tank","Fighter, Mage",3,3,6
401,"Fighter, Mage","Tank, Support",Fighter,"Support, Tank",2,4,6
234,"Marksman, Mage","Support, Mage","Marksman, Support","Support, Fighter",1,5,6
2588,Marksman,"Tank, Support","Marksman, Mage","Tank, Fighter",5,1,6
459,"Marksman, Mage","Support, Tank","Marksman, Support","Tank, Support",5,1,6
2796,"Assassin, Fighter","Support, Mage","Mage, Fighter","Support, Tank",3,3,6
206,"Fighter, Assassin","Support, Fighter","Mage, Fighter","Support, Tank",0,6,6
722,Marksman,Support,"Marksman, Support","Support, Tank",2,4,6
720,Fighter,"Tank, Support","Assassin, Fighter","Support, Tank",1,5,6
718,Marksman,"Fighter, Tank",Marksman,"Mage, Support",3,3,6
1400,"Tank, Mage","Assassin, Fighter","Fighter, Mage",Marksman,1,5,6
288,Fighter,"Support, Fighter","Fighter, Assassin","Support, Tank",5,1,6
1384,"Mage, Fighter","Mage, Support",Marksman,"Mage, Assassin",2,4,6
2234,"Fighter, Tank",Marksman,"Fighter, Assassin",Fighter,3,3,6
658,"Tank, Fighter",Fighter,"Fighter, Assassin","Mage, Fighter",3,3,6
6373,"Fighter, Tank","Mage, Fighter","Tank, Mage","Assassin, Fighter",1,5,6
2237,"Tank, Fighter","Fighter, Mage","Fighter, Tank","Assassin, Fighter",4,2,6
229,"Fighter, Assassin","Support, Tank",Fighter,"Support, Fighter",3,3,6
6356,"Tank, Mage","Tank, Fighter","Fighter, Tank","Fighter, Assassin",3,3,6
717,Tank,"Fighter, Mage","Fighter, Assassin","Mage, Fighter",4,2,6
651,"Fighter, Tank","Fighter, Mage","Tank, Fighter",Marksman,4,2,6
1202,Fighter,Mage,"Fighter, Assassin",Mage,4,2,6
1822,"Assassin, Fighter","Mage, Support",Fighter,"Support, Fighter",3,3,6
2256,"Fighter, Tank","Fighter, Assassin","Tank, Mage","Tank, Fighter",3,3,6
8854,"Fighter, Assassin","Mage, Support","Mage, Fighter","Assassin, Fighter",1,5,6
1408,Marksman,"Tank, Support","Assassin, Fighter","Support, Tank",2,4,6
1190,"Fighter, Assassin","Fighter, Mage","Fighter, Tank","Assassin, Fighter",3,3,6
1846,Fighter,"Assassin, Fighter","Tank, Fighter","Mage, Assassin",4,2,6
766,"Tank, Mage","Assassin, Fighter",Tank,"Fighter, Assassin",4,2,6
268,Fighter,Fighter,"Assassin, Fighter","Fighter, Mage",4,2,6
2425,Marksman,Support,Marksman,"Mage, Support",3,3,6
1684,Marksman,"Support, Tank","Marksman, Assassin","Fighter, Tank",2,4,6
1620,Marksman,Mage,"Assassin, Fighter","Mage, Marksman",3,3,6
540,Marksman,"Support, Fighter","Marksman, Assassin","Fighter, Tank",5,1,6
357,"Marksman, Support","Support, Tank","Marksman, Assassin","Mage, Support",6,0,6
524,Marksman,Support,"Marksman, Support","Support, Fighter",0,6,6
174,"Tank, Mage","Fighter, Mage","Fighter, Mage",Fighter,4,2,6
4678,"Marksman, Assassin","Tank, Fighter",Marksman,"Support, Mage",3,3,6
884,"Tank, Fighter","Mage, Fighter","Fighter, Mage","Fighter, Assassin",3,3,6
799,"Tank, Fighter","Assassin, Fighter",Tank,"Fighter, Assassin",3,3,6
882,"Tank, Fighter","Mage, Assassin","Fighter, Assassin","Mage, Assassin",5,1,6
999,"Fighter, Assassin",Mage,Fighter,Mage,3,3,6
4446,"Marksman, Mage","Support, Mage",Marksman,"Tank, Fighter",2,4,6
1961,"Mage, Fighter","Support, Mage","Fighter, Mage","Support, Mage",2,4,6
187,"Fighter, Mage","Support, Fighter",Fighter,"Mage, Support",4,2,6
312,"Fighter, Tank",Fighter,"Tank, Mage","Fighter, Mage",2,4,6
6103,"Fighter, Mage",Marksman,"Tank, Fighter","Mage, Fighter",4,2,6
875,"Fighter, Mage","Mage, Tank","Mage, Fighter","Mage, Support",3,3,6
192,"Assassin, Fighter","Support, Fighter","Mage, Fighter","Mage, Support",4,2,6
1536,"Tank, Fighter",Support,"Tank, Fighter","Support, Tank",5,1,6
1610,"Fighter, Mage",Mage,"Fighter, Assassin","Mage, Support",3,3,6
308,"Mage, Fighter","Fighter, Tank",Marksman,"Tank, Support",3,3,6
1634,Fighter,Mage,"Fighter, Assassin","Support, Mage",3,3,6
1957,"Tank, Fighter",Marksman,"Tank, Mage","Fighter, Assassin",5,1,6
951,Fighter,"Support, Mage","Mage, Fighter",Mage,2,4,6
1611,Marksman,"Tank, Fighter","Marksman, Mage","Mage, Support",5,1,6
155,Fighter,"Tank, Fighter","Fighter, Mage","Support, Fighter",3,3,6
5944,"Tank, Fighter","Assassin, Fighter","Fighter, Tank","Tank, Fighter",5,1,6
537,"Mage, Fighter","Support, Tank",Marksman,"Tank, Support",5,1,6
341,Marksman,"Support, Fighter","Marksman, Assassin",Support,3,3,6
835,"Mage, Fighter","Support, Fighter",Marksman,"Support, Tank",3,3,6
4577,Marksman,"Support, Mage","Marksman, Support","Support, Fighter",3,3,6
904,"Mage, Fighter","Assassin, Mage","Assassin, Fighter","Mage, Support",4,2,6
337,"Assassin, Fighter",Marksman,"Tank, Mage","Mage, Fighter",3,3,6
592,"Fighter, Mage","Tank, Support","Tank, Fighter","Support, Tank",4,2,6
2667,"Fighter, Mage","Assassin, Fighter","Tank, Mage",Fighter,3,3,6
1616,"Tank, Fighter",Marksman,"Fighter, Tank","Fighter, Mage",4,2,6
894,Fighter,"Mage, Support","Mage, Fighter","Support, Fighter",3,3,6
2618,"Fighter, Mage","Assassin, Fighter","Tank, Mage",Marksman,4,2,6
2504,"Mage, Fighter","Support, Mage","Fighter, Mage","Mage, Support",3,3,6
8889,"Fighter, Mage","Mage, Support","Assassin, Fighter","Mage, Support",5,1,6
2413,"Assassin, Fighter","Mage, Support",Fighter,"Support, Mage",2,4,6
978,"Mage, Fighter","Tank, Support","Assassin, Fighter","Support, Fighter",3,3,6
1560,"Tank, Fighter",Mage,Fighter,"Support, Mage",4,2,6
891,"Tank, Fighter","Mage, Fighter","Tank, Mage","Fighter, Mage",4,2,6
1619,Marksman,Support,"Marksman, Assassin","Mage, Support",5,1,6
1976,"Fighter, Mage",Mage,"Mage, Fighter","Mage, Support",2,4,6
1557,Marksman,"Assassin, Mage",Fighter,Mage,3,3,6
955,"Fighter, Mage","Mage, Support","Tank, Fighter","Mage, Support",4,2,6
317,Tank,"Assassin, Fighter","Tank, Mage","Assassin, Fighter",3,3,6
347,"Fighter, Assassin","Support, Tank","Fighter, Mage","Support, Mage",3,3,6
1969,"Fighter, Assassin","Mage, Support","Assassin, Fighter","Mage, Assassin",2,4,6
4531,"Marksman, Assassin","Support, Fighter","Marksman, Mage","Support, Mage",3,3,6
1609,"Assassin, Fighter","Support, Fighter",Marksman,"Support, Tank",4,2,6
1657,Fighter,Marksman,"Tank, Fighter","Mage, Support",1,5,6
1953,Marksman,Tank,Marksman,"Tank, Support",3,3,6
368,"Assassin, Fighter","Support, Fighter",Fighter,"Support, Tank",4,2,6
111,Fighter,"Support, Fighter","Fighter, Mage","Support, Mage",3,3,6
617,Fighter,"Mage, Support","Tank, Fighter","Support, Fighter",3,3,6
1035,Marksman,"Fighter, Tank","Marksman, Assassin","Tank, Support",3,3,6
2390,"Fighter, Tank","Fighter, Mage","Fighter, Assassin","Fighter, Tank",6,0,6
5889,"Fighter, Tank","Assassin, Fighter","Tank, Mage","Assassin, Fighter",4,2,6
851,Tank,"Assassin, Fighter","Tank, Fighter","Assassin, Fighter",3,3,6
927,Fighter,"Mage, Support","Fighter, Mage","Assassin, Mage",2,4,6
1853,Marksman,"Fighter, Tank","Marksman, Assassin","Support, Tank",4,2,6
1942,"Assassin, Fighter","Support, Tank","Mage, Fighter","Mage, Support",4,2,6
506,"Fighter, Mage","Support, Tank","Assassin, Fighter","Tank, Support",3,3,6
9354,"Assassin, Fighter","Mage, Support","Tank, Fighter","Mage, Assassin",4,2,6
1598,"Marksman, Assassin","Support, Mage",Marksman,Support,5,1,6
2635,"Fighter, Tank","Assassin, Fighter","Fighter, Tank",Marksman,4,2,6
6032,"Fighter, Mage",Fighter,"Fighter, Tank","Assassin, Fighter",3,3,6
921,"Mage, Fighter","Mage, Support","Fighter, Assassin",Marksman,2,4,6
307,Marksman,Mage,Fighter,"Support, Mage",3,3,6
620,"Tank, Fighter",Fighter,"Tank, Fighter","Mage, Fighter",3,3,6
1848,"Tank, Fighter","Tank, Support",Fighter,"Support, Mage",5,1,6
918,"Fighter, Assassin","Support, Fighter","Fighter, Mage","Support, Tank",5,1,6
829,Fighter,"Mage, Support",Marksman,"Support, Tank",2,4,6
3464,Fighter,Mage,"Assassin, Fighter",Mage,4,2,6
828,Marksman,"Support, Tank",Fighter,"Mage, Support",2,4,6
827,"Fighter, Assassin","Mage, Support","Assassin, Fighter","Support, Fighter",1,5,6
1019,Fighter,Marksman,"Tank, Fighter","Mage, Fighter",4,2,6
1950,Fighter,"Mage, Support","Tank, Fighter",Marksman,3,3,6
546,"Fighter, Mage","Mage, Fighter","Tank, Fighter","Fighter, Assassin",1,5,6
3090,"Tank, Fighter","Mage, Support","Tank, Fighter","Mage, Assassin",4,2,6
1011,"Assassin, Fighter","Mage, Fighter","Mage, Fighter",Mage,3,3,6
272,Tank,Marksman,"Tank, Mage","Assassin, Fighter",2,4,6
514,"Assassin, Fighter","Fighter, Tank",Marksman,"Tank, Support",3,3,6
362,Marksman,"Mage, Support",Marksman,Support,3,3,6
2437,"Tank, Fighter","Fighter, Mage","Fighter, Tank","Tank, Fighter",3,3,6
1016,"Assassin, Fighter","Mage, Support","Support, Mage","Mage, Support",2,4,6
97,"Mage, Fighter","Support, Mage",Fighter,"Support, Fighter",5,1,6
510,"Mage, Fighter","Mage, Support","Fighter, Mage","Support, Fighter",2,4,6
1592,"Marksman, Mage","Support, Tank","Marksman, Assassin","Tank, Support",4,2,6
2492,"Tank, Fighter","Fighter, Assassin","Tank, Fighter","Fighter, Mage",2,4,6
2471,"Fighter, Mage","Fighter, Assassin","Fighter, Tank","Tank, Fighter",3,3,6
8899,"Fighter, Mage","Mage, Assassin","Tank, Fighter","Mage, Support",4,2,6
964,"Fighter, Mage","Mage, Support",Fighter,"Support, Fighter",3,3,6
611,"Assassin, Fighter",Marksman,"Tank, Fighter",Marksman,3,3,6
176,"Assassin, Fighter",Fighter,"Tank, Mage","Mage, Fighter",5,1,6
2109,"Fighter, Mage",Marksman,"Fighter, Tank","Mage, Fighter",4,1,5
2115,"Fighter, Assassin","Assassin, Fighter","Fighter, Tank","Mage, Fighter",1,4,5
2110,"Tank, Fighter","Support, Fighter",Fighter,"Tank, Support",3,2,5
4217,Fighter,"Mage, Support","Assassin, Fighter",Mage,5,0,5
1379,"Mage, Fighter",Marksman,Fighter,Mage,2,3,5
1932,"Fighter, Mage","Tank, Support","Assassin, Fighter","Support, Mage",4,1,5
1885,"Assassin, Fighter","Support, Tank","Tank, Fighter","Support, Tank",2,3,5
1606,"Marksman, Mage","Tank, Fighter",Marksman,"Support, Mage",3,2,5
1928,"Mage, Fighter",Mage,Marksman,Marksman,5,0,5
281,"Fighter, Mage","Tank, Fighter",Fighter,"Tank, Support",2,3,5
1805,"Tank, Fighter","Support, Tank","Mage, Fighter","Support, Fighter",2,3,5
2133,Fighter,"Support, Fighter","Assassin, Fighter","Support, Tank",4,1,5
409,"Fighter, Assassin","Fighter, Mage","Tank, Fighter",Marksman,3,2,5
1907,Fighter,Mage,"Mage, Fighter","Assassin, Mage",1,4,5
1909,"Tank, Fighter","Tank, Support","Fighter, Mage","Support, Fighter",1,4,5
1661,"Marksman, Mage","Support, Mage","Marksman, Assassin","Tank, Fighter",2,3,5
1641,"Assassin, Fighter","Tank, Support","Fighter, Assassin","Support, Tank",3,2,5
1659,Fighter,"Mage, Marksman","Mage, Fighter",Mage,3,2,5
1643,"Tank, Fighter",Marksman,"Fighter, Mage",Mage,2,3,5
2162,"Fighter, Assassin","Mage, Support","Tank, Fighter","Support, Fighter",3,2,5
8412,"Assassin, Fighter","Mage, Fighter","Mage, Fighter","Mage, Support",4,1,5
1792,"Marksman, Mage","Mage, Assassin","Marksman, Mage","Mage, Support",4,1,5
1324,Fighter,"Mage, Fighter","Fighter, Mage",Mage,4,1,5
3359,"Tank, Fighter","Support, Mage","Fighter, Mage","Tank, Support",3,2,5
1906,"Tank, Fighter",Marksman,"Fighter, Assassin","Fighter, Mage",2,3,5
3172,"Assassin, Fighter","Mage, Assassin","Assassin, Fighter","Support, Mage",2,3,5
1320,"Fighter, Tank","Tank, Mage","Tank, Fighter","Tank, Mage",5,0,5
2889,"Fighter, Assassin","Mage, Support","Tank, Fighter","Support, Mage",2,3,5
1768,"Marksman, Support","Support, Tank","Marksman, Mage","Mage, Support",4,1,5
323,"Mage, Fighter","Fighter, Tank",Fighter,"Support, Tank",4,1,5
1903,"Mage, Fighter","Tank, Fighter",Fighter,"Support, Tank",2,3,5
1315,Fighter,"Mage, Support","Assassin, Fighter","Assassin, Fighter",3,2,5
1788,"Assassin, Fighter","Mage, Fighter",Fighter,Mage,4,1,5
6516,"Fighter, Assassin","Assassin, Mage","Tank, Fighter","Mage, Assassin",2,3,5
2172,"Fighter, Tank","Mage, Fighter","Tank, Fighter",Fighter,2,3,5
1308,"Marksman, Mage","Support, Fighter","Marksman, Support","Support, Tank",3,2,5
2158,"Assassin, Fighter",Fighter,"Fighter, Tank","Mage, Fighter",4,1,5
6542,"Tank, Mage","Assassin, Fighter","Fighter, Tank","Tank, Fighter",5,0,5
1332,"Assassin, Fighter",Marksman,"Fighter, Tank","Mage, Fighter",1,4,5
1795,"Assassin, Fighter","Mage, Support","Fighter, Mage","Support, Fighter",3,2,5
1802,"Fighter, Tank","Fighter, Assassin","Fighter, Tank","Fighter, Mage",2,3,5
1886,"Tank, Fighter",Support,"Tank, Fighter","Support, Fighter",3,2,5
3317,"Tank, Fighter","Support, Fighter","Assassin, Fighter","Support, Tank",5,0,5
6956,"Fighter, Assassin","Mage, Fighter","Fighter, Tank","Assassin, Fighter",3,2,5
1663,"Tank, Fighter","Tank, Mage","Fighter, Mage",Marksman,3,2,5
5715,Tank,"Mage, Fighter","Fighter, Tank","Assassin, Fighter",5,0,5
5711,"Tank, Mage","Mage, Fighter","Fighter, Tank","Fighter, Assassin",2,3,5
8361,"Fighter, Tank",Mage,"Fighter, Mage","Mage, Support",1,4,5
2106,"Tank, Fighter",Marksman,"Fighter, Tank","Mage, Fighter",2,3,5
2140,"Mage, Fighter","Fighter, Marksman","Assassin, Fighter","Mage, Support",3,2,5
334,"Support, Mage","Mage, Support",Fighter,"Mage, Support",4,1,5
1919,Marksman,"Mage, Marksman",Marksman,"Support, Mage",3,2,5
1350,"Mage, Fighter",Mage,Marksman,Mage,4,1,5
1798,"Fighter, Assassin","Support, Tank","Assassin, Fighter","Support, Tank",5,0,5
6085,"Fighter, Mage","Assassin, Fighter","Fighter, Tank","Fighter, Mage",4,1,5
6425,"Fighter, Tank","Fighter, Assassin","Tank, Fighter","Fighter, Mage",2,3,5
1914,Marksman,Mage,"Marksman, Mage","Tank, Support",3,2,5
1341,"Mage, Fighter",Mage,Marksman,"Support, Mage",5,0,5
1337,"Assassin, Fighter","Support, Mage",Marksman,Mage,5,0,5
1636,"Fighter, Assassin","Assassin, Mage","Tank, Fighter","Mage, Support",3,2,5
1637,"Fighter, Assassin",Mage,"Tank, Fighter","Mage, Assassin",3,2,5
1938,Marksman,Mage,"Mage, Fighter","Assassin, Mage",2,3,5
346,Fighter,"Mage, Support","Fighter, Tank","Support, Tank",3,2,5
6579,"Fighter, Assassin","Assassin, Mage","Assassin, Fighter",Mage,2,3,5
1693,Marksman,"Mage, Fighter","Mage, Fighter",Mage,3,2,5
1857,Tank,"Assassin, Fighter","Tank, Fighter",Fighter,3,2,5
5927,"Tank, Mage",Fighter,"Fighter, Tank","Fighter, Assassin",4,1,5
1472,"Fighter, Assassin","Mage, Assassin","Tank, Fighter",Mage,1,4,5
2046,"Tank, Fighter",Marksman,"Tank, Fighter",Marksman,1,4,5
3092,Fighter,"Support, Mage","Tank, Fighter","Mage, Support",4,1,5
245,Fighter,"Tank, Support","Mage, Fighter","Fighter, Tank",2,3,5
394,"Support, Mage","Support, Mage",Marksman,"Mage, Support",4,1,5
1464,"Mage, Fighter","Assassin, Mage",Fighter,Mage,2,3,5
1534,"Tank, Fighter",Mage,"Fighter, Mage",Mage,4,1,5
3018,"Fighter, Mage","Support, Fighter","Tank, Fighter","Mage, Support",2,3,5
243,"Fighter, Mage",Fighter,"Tank, Mage","Fighter, Mage",2,3,5
1460,"Mage, Fighter",Marksman,Marksman,"Mage, Support",3,2,5
3093,"Tank, Fighter","Support, Mage","Fighter, Assassin","Mage, Support",1,4,5
1538,"Assassin, Fighter","Mage, Support","Assassin, Fighter","Assassin, Fighter",4,1,5
6259,"Tank, Fighter","Mage, Fighter","Fighter, Tank","Fighter, Assassin",4,1,5
3648,"Tank, Fighter","Support, Fighter","Fighter, Assassin","Support, Tank",4,1,5
2058,"Fighter, Assassin","Fighter, Mage","Tank, Mage",Fighter,1,4,5
1453,"Fighter, Assassin","Mage, Support","Fighter, Mage",Marksman,3,2,5
1686,"Marksman, Mage","Support, Mage","Marksman, Support","Support, Tank",2,3,5
387,"Marksman, Mage",Marksman,Marksman,"Mage, Support",1,4,5
9461,Fighter,"Assassin, Mage","Mage, Fighter","Mage, Support",1,4,5
1391,"Fighter, Mage",Mage,Fighter,"Assassin, Fighter",2,3,5
5912,"Fighter, Tank","Tank, Fighter","Fighter, Assassin","Fighter, Assassin",2,3,5
2015,"Fighter, Mage","Support, Mage",Marksman,Mage,3,2,5
5884,"Tank, Mage","Assassin, Fighter","Tank, Fighter",Fighter,4,1,5
1700,"Marksman, Assassin","Mage, Support","Marksman, Assassin","Support, Tank",1,4,5
3050,"Fighter, Assassin","Mage, Support","Assassin, Fighter","Support, Tank",1,4,5
2023,"Fighter, Assassin",Marksman,Fighter,"Mage, Support",3,2,5
1496,"Assassin, Fighter",Mage,Fighter,"Mage, Assassin",3,2,5
1495,"Marksman, Mage","Tank, Fighter",Marksman,"Mage, Support",4,1,5
1507,"Mage, Fighter","Mage, Support",Marksman,Mage,4,1,5
382,"Marksman, Assassin","Support, Mage","Marksman, Mage","Mage, Assassin",2,3,5
1492,"Fighter, Assassin","Support, Fighter",Fighter,"Support, Mage",4,1,5
372,Fighter,"Support, Tank",Marksman,"Tank, Support",1,4,5
1510,Marksman,"Tank, Support","Mage, Fighter","Support, Mage",0,5,5
1487,Fighter,"Mage, Support","Fighter, Assassin","Assassin, Fighter",2,3,5
271,"Mage, Fighter","Mage, Marksman",Fighter,Mage,3,2,5
5874,"Fighter, Tank","Tank, Fighter","Tank, Mage","Assassin, Fighter",2,3,5
1898,"Fighter, Tank","Assassin, Fighter","Fighter, Mage",Marksman,4,1,5
5910,"Fighter, Tank","Tank, Fighter","Tank, Fighter",Fighter,2,3,5
1843,"Mage, Fighter","Support, Mage","Assassin, Fighter","Support, Fighter",1,4,5
365,Marksman,Mage,"Marksman, Assassin","Tank, Fighter",3,2,5
1540,"Fighter, Tank","Fighter, Tank","Tank, Fighter","Mage, Fighter",4,1,5
1452,"Fighter, Mage","Support, Mage","Fighter, Assassin","Support, Mage",2,3,5
359,"Mage, Fighter","Support, Tank",Fighter,"Support, Tank",4,1,5
1542,"Marksman, Support","Support, Tank","Marksman, Assassin","Support, Tank",4,1,5
1966,"Tank, Fighter","Support, Tank","Fighter, Mage",Support,3,2,5
1873,"Fighter, Assassin","Mage, Support",Fighter,Marksman,3,2,5
1574,"Assassin, Fighter","Mage, Marksman",Marksman,Mage,4,1,5
1419,"Fighter, Tank","Tank, Support","Mage, Fighter","Support, Tank",4,1,5
318,"Fighter, Mage","Mage, Support","Mage, Fighter","Tank, Support",4,1,5
1732,"Marksman, Mage","Support, Mage","Marksman, Assassin","Mage, Assassin",1,4,5
5986,"Fighter, Tank",Fighter,"Tank, Fighter","Mage, Fighter",5,0,5
3123,"Tank, Mage","Support, Fighter","Tank, Fighter","Support, Tank",3,2,5
6618,"Tank, Fighter",Mage,Fighter,Mage,0,5,5
1956,"Assassin, Fighter","Mage, Marksman",Marksman,"Assassin, Mage",2,3,5
1735,"Assassin, Fighter",Mage,"Fighter, Assassin",Mage,2,3,5
2982,"Mage, Fighter","Tank, Support",Marksman,"Support, Mage",2,3,5
1945,"Marksman, Assassin","Support, Mage",Marksman,Mage,3,2,5
1406,"Assassin, Fighter","Tank, Mage","Fighter, Assassin",Mage,2,3,5
1405,Fighter,"Mage, Support","Assassin, Fighter",Marksman,1,4,5
1403,Fighter,"Assassin, Mage","Fighter, Assassin","Mage, Assassin",2,3,5
1820,Fighter,Mage,"Assassin, Fighter","Mage, Marksman",4,1,5
1939,"Tank, Fighter","Support, Mage","Tank, Fighter","Support, Tank",3,2,5
1746,"Marksman, Support","Support, Mage","Marksman, Mage","Support, Fighter",3,2,5
399,"Fighter, Mage","Assassin, Fighter","Fighter, Mage",Marksman,3,2,5
3236,"Fighter, Mage",Mage,"Tank, Fighter","Mage, Support",3,2,5
1723,"Fighter, Mage","Support, Fighter","Tank, Fighter","Support, Tank",2,3,5
2067,Fighter,"Support, Fighter","Tank, Fighter","Support, Mage",3,2,5
1546,"Tank, Mage","Assassin, Fighter",Tank,Marksman,3,2,5
302,"Marksman, Assassin","Support, Tank","Marksman, Mage","Mage, Assassin",3,2,5
1547,"Assassin, Fighter",Marksman,"Tank, Fighter","Mage, Support",4,1,5
1838,"Tank, Fighter",Tank,"Tank, Fighter","Support, Tank",1,4,5
5624,"Tank, Mage","Mage, Fighter","Tank, Fighter","Assassin, Fighter",4,1,5
1550,Marksman,"Fighter, Tank","Assassin, Fighter","Tank, Support",2,3,5
9221,"Fighter, Assassin",Mage,"Assassin, Fighter",Mage,4,1,5
7664,"Tank, Mage","Fighter, Mage","Fighter, Tank","Assassin, Fighter",3,2,5
355,"Fighter, Assassin",Mage,"Fighter, Tank","Mage, Support",4,1,5
9203,"Assassin, Fighter","Mage, Support","Mage, Fighter",Mage,4,1,5
398,Marksman,"Assassin, Mage","Mage, Fighter","Mage, Marksman",2,3,5
5969,"Fighter, Tank",Fighter,"Fighter, Mage","Assassin, Fighter",2,3,5
236,Fighter,"Support, Tank","Fighter, Mage","Fighter, Tank",3,2,5
2074,"Fighter, Tank",Fighter,"Tank, Mage","Mage, Fighter",4,1,5
3116,"Tank, Fighter","Support, Tank","Tank, Fighter","Support, Mage",3,2,5
3431,"Fighter, Assassin","Mage, Assassin","Mage, Fighter","Mage, Support",3,2,5
1970,"Marksman, Mage","Mage, Support","Marksman, Support","Support, Tank",2,3,5
1569,Marksman,Mage,"Mage, Fighter",Mage,4,1,5
3587,"Assassin, Fighter","Support, Tank","Mage, Fighter","Support, Tank",2,3,5
6510,"Tank, Fighter","Assassin, Mage","Assassin, Fighter","Assassin, Fighter",3,2,5
2885,"Assassin, Fighter","Support, Tank","Fighter, Mage","Mage, Support",3,2,5
2672,"Fighter, Assassin",Fighter,"Fighter, Tank","Assassin, Fighter",3,2,5
948,"Assassin, Fighter",Fighter,"Tank, Mage",Marksman,2,3,5
4573,Marksman,"Support, Fighter","Marksman, Assassin","Support, Fighter",3,2,5
538,"Fighter, Assassin","Mage, Fighter","Fighter, Mage",Fighter,4,1,5
536,"Marksman, Assassin","Support, Tank","Marksman, Assassin","Support, Tank",4,1,5
2419,"Assassin, Fighter","Support, Mage","Mage, Fighter","Support, Fighter",4,1,5
2668,"Fighter, Assassin",Fighter,"Fighter, Tank","Fighter, Assassin",2,3,5
971,"Fighter, Mage",Support,"Tank, Fighter","Tank, Support",3,2,5
976,"Mage, Fighter",Mage,Fighter,"Mage, Fighter",3,2,5
1109,"Fighter, Tank","Mage, Support","Fighter, Assassin","Mage, Support",4,1,5
979,"Assassin, Fighter","Mage, Assassin",Marksman,"Support, Mage",4,1,5
4596,"Marksman, Mage","Support, Tank","Marksman, Mage","Mage, Support",5,0,5
527,"Tank, Fighter","Fighter, Assassin","Tank, Mage",Fighter,4,1,5
2676,"Fighter, Tank","Fighter, Assassin","Tank, Fighter",Marksman,4,1,5
988,"Fighter, Assassin","Fighter, Mage","Fighter, Assassin",Fighter,4,1,5
991,"Fighter, Mage",Mage,"Mage, Fighter",Mage,0,5,5
2407,"Assassin, Fighter","Fighter, Mage","Fighter, Assassin",Fighter,3,2,5
2428,"Fighter, Tank","Mage, Fighter","Fighter, Assassin","Fighter, Mage",1,4,5
2665,"Marksman, Assassin","Support, Mage","Marksman, Assassin","Support, Fighter",3,2,5
4547,"Marksman, Assassin","Support, Tank","Marksman, Assassin","Support, Mage",2,3,5
939,Fighter,"Mage, Support",Marksman,"Support, Mage",5,0,5
2454,"Fighter, Mage","Mage, Support","Tank, Fighter","Tank, Support",5,0,5
899,"Assassin, Fighter","Mage, Marksman","Assassin, Mage",Mage,4,1,5
4530,"Marksman, Mage","Support, Fighter","Marksman, Assassin","Support, Mage",1,4,5
908,Marksman,"Tank, Support",Fighter,"Support, Mage",3,2,5
910,"Tank, Mage","Fighter, Assassin","Tank, Fighter","Mage, Fighter",2,3,5
4532,"Marksman, Assassin","Support, Fighter","Marksman, Mage","Tank, Support",4,1,5
916,"Tank, Fighter","Assassin, Fighter","Tank, Fighter","Mage, Fighter",3,2,5
2649,"Fighter, Tank","Support, Fighter",Fighter,"Mage, Support",4,1,5
4535,"Marksman, Mage","Support, Fighter",Marksman,"Tank, Fighter",1,4,5
923,Fighter,"Support, Tank","Tank, Fighter","Support, Fighter",2,3,5
924,"Tank, Fighter","Support, Fighter",Fighter,"Support, Mage",4,1,5
929,"Fighter, Mage",Mage,"Tank, Fighter",Mage,4,1,5
930,Fighter,Marksman,"Mage, Fighter","Mage, Support",3,2,5
548,"Tank, Fighter","Fighter, Mage","Fighter, Tank","Fighter, Assassin",2,3,5
2655,Fighter,"Support, Tank","Fighter, Tank","Support, Fighter",3,2,5
994,"Assassin, Fighter","Support, Fighter","Assassin, Fighter","Mage, Support",2,3,5
995,"Mage, Fighter","Support, Mage","Assassin, Fighter",Mage,4,1,5
5623,"Tank, Fighter","Assassin, Fighter","Fighter, Tank","Assassin, Fighter",4,1,5
194,"Fighter, Mage","Support, Fighter","Assassin, Mage","Tank, Support",3,2,5
504,Fighter,"Mage, Tank","Fighter, Mage","Mage, Assassin",1,4,5
8704,Marksman,Mage,Fighter,Mage,1,4,5
497,"Fighter, Mage","Mage, Support",Fighter,Marksman,3,2,5
2366,"Fighter, Tank","Support, Mage",Fighter,"Mage, Support",3,2,5
4020,"Tank, Fighter","Mage, Support","Mage, Fighter",Mage,3,2,5
4701,Marksman,"Tank, Support",Marksman,Tank,2,3,5
1074,Marksman,"Support, Mage","Mage, Fighter","Mage, Support",3,2,5
1075,"Fighter, Mage",Marksman,"Fighter, Assassin","Mage, Support",4,1,5
2347,"Fighter, Mage","Support, Tank","Assassin, Fighter","Support, Mage",4,1,5
2339,"Fighter, Mage","Fighter, Assassin",Tank,"Assassin, Fighter",5,0,5
199,"Fighter, Mage","Tank, Support",Fighter,"Tank, Fighter",4,1,5
1098,"Fighter, Tank",Fighter,"Tank, Fighter","Fighter, Mage",3,2,5
2335,"Tank, Fighter","Mage, Support",Fighter,"Support, Mage",4,1,5
1101,"Assassin, Fighter","Support, Tank","Fighter, Assassin","Support, Tank",3,2,5
2330,"Fighter, Tank","Tank, Fighter","Tank, Fighter","Tank, Mage",2,3,5
1050,"Fighter, Assassin","Mage, Support","Fighter, Tank","Support, Mage",3,2,5
8707,"Assassin, Fighter","Assassin, Mage",Fighter,"Mage, Support",3,2,5
4061,"Tank, Fighter","Mage, Support","Fighter, Mage","Support, Mage",3,2,5
2384,"Mage, Fighter","Mage, Tank",Marksman,"Mage, Support",3,2,5
522,"Tank, Mage","Fighter, Assassin","Fighter, Mage","Assassin, Fighter",4,1,5
1002,"Assassin, Fighter","Support, Fighter","Fighter, Assassin","Mage, Support",2,3,5
1005,"Mage, Fighter","Mage, Marksman",Marksman,"Assassin, Mage",1,4,5
1010,"Fighter, Assassin","Mage, Support",Marksman,"Mage, Assassin",2,3,5
8730,"Mage, Fighter",Mage,"Fighter, Mage","Mage, Support",2,3,5
1018,"Fighter, Mage","Fighter, Tank",Marksman,"Tank, Support",3,2,5
1020,"Mage, Fighter","Tank, Support",Fighter,"Support, Mage",2,3,5
8719,"Tank, Fighter","Assassin, Mage","Fighter, Mage","Mage, Support",4,1,5
1022,"Mage, Fighter","Support, Fighter","Assassin, Fighter","Support, Mage",4,1,5
509,Marksman,"Mage, Assassin","Fighter, Assassin","Support, Mage",3,2,5
4641,"Marksman, Assassin","Tank, Fighter","Marksman, Mage","Support, Fighter",4,1,5
1031,"Fighter, Tank","Support, Fighter","Assassin, Fighter","Support, Tank",2,3,5
1033,"Tank, Fighter","Mage, Support","Tank, Mage","Mage, Support",3,2,5
2695,"Assassin, Fighter",Marksman,Fighter,"Mage, Support",4,1,5
2385,"Fighter, Tank","Assassin, Fighter",Tank,Fighter,4,1,5
2455,"Tank, Mage","Fighter, Assassin","Fighter, Tank",Fighter,3,2,5
561,"Fighter, Mage","Mage, Support","Fighter, Assassin","Support, Fighter",4,1,5
888,Fighter,"Support, Tank","Fighter, Mage","Support, Tank",2,3,5
4395,"Marksman, Assassin","Tank, Fighter",Marksman,"Support, Tank",2,3,5
729,Tank,"Mage, Fighter","Tank, Mage","Fighter, Assassin",2,3,5
646,"Fighter, Mage","Support, Fighter","Fighter, Assassin","Support, Tank",5,0,5
732,"Fighter, Assassin","Mage, Support",Marksman,"Support, Mage",4,1,5
638,Marksman,"Mage, Marksman",Marksman,"Mage, Fighter",3,2,5
636,Fighter,Mage,"Assassin, Fighter","Tank, Support",3,2,5
2540,"Marksman, Support","Support, Tank","Marksman, Mage","Tank, Support",2,3,5
750,Marksman,"Tank, Support","Mage, Fighter","Mage, Support",4,1,5
631,"Fighter, Assassin","Mage, Fighter","Assassin, Fighter","Mage, Support",3,2,5
757,"Fighter, Mage","Support, Fighter","Mage, Fighter","Tank, Support",3,2,5
4408,Marksman,"Support, Fighter","Marksman, Mage","Tank, Fighter",2,3,5
8862,"Mage, Fighter","Mage, Support","Assassin, Fighter","Assassin, Mage",5,0,5
2595,"Fighter, Tank",Fighter,"Fighter, Assassin","Tank, Fighter",2,3,5
2525,"Tank, Mage","Mage, Fighter","Fighter, Tank","Fighter, Mage",4,1,5
776,"Fighter, Mage","Support, Tank",Marksman,"Support, Fighter",3,2,5
2601,"Tank, Mage","Fighter, Assassin","Fighter, Tank","Assassin, Fighter",2,3,5
728,Marksman,"Support, Fighter","Fighter, Marksman","Tank, Fighter",2,3,5
2545,"Marksman, Mage","Support, Fighter","Marksman, Support","Support, Mage",5,0,5
165,"Tank, Mage","Assassin, Mage","Fighter, Mage",Fighter,2,3,5
721,"Marksman, Support","Support, Tank",Marksman,Support,3,2,5
668,"Marksman, Mage","Mage, Assassin","Marksman, Assassin",Marksman,3,2,5
675,"Marksman, Assassin","Mage, Assassin","Marksman, Support","Mage, Support",4,1,5
677,"Tank, Mage","Mage, Fighter","Tank, Fighter",Marksman,4,1,5
4223,Fighter,"Mage, Support","Tank, Fighter",Mage,3,2,5
2567,"Fighter, Mage","Mage, Support","Fighter, Assassin","Support, Mage",2,3,5
686,"Tank, Mage","Mage, Fighter","Assassin, Fighter",Fighter,3,2,5
688,"Tank, Mage",Marksman,"Tank, Fighter","Fighter, Assassin",3,2,5
2577,"Assassin, Fighter","Mage, Marksman",Marksman,"Mage, Fighter",3,2,5
2560,"Marksman, Support","Support, Tank",Marksman,"Support, Tank",3,2,5
2587,Fighter,"Mage, Support","Assassin, Fighter","Mage, Assassin",1,4,5
2552,"Fighter, Tank",Fighter,"Fighter, Mage","Fighter, Assassin",5,0,5
4186,"Tank, Fighter",Mage,Fighter,"Mage, Support",3,2,5
4366,"Fighter, Assassin","Mage, Support","Tank, Fighter",Mage,2,3,5
712,Fighter,"Fighter, Tank","Mage, Fighter","Support, Tank",2,3,5
715,Fighter,"Support, Mage","Fighter, Mage","Support, Fighter",2,3,5
2521,"Fighter, Mage","Support, Mage","Assassin, Fighter","Mage, Support",4,1,5
786,"Fighter, Mage","Mage, Support","Tank, Fighter","Tank, Mage",3,2,5
2639,"Fighter, Mage",Fighter,"Fighter, Tank","Fighter, Tank",3,2,5
573,"Fighter, Assassin","Tank, Fighter","Fighter, Mage","Assassin, Fighter",2,3,5
8790,"Fighter, Mage",Marksman,"Mage, Fighter","Mage, Support",2,3,5
855,"Assassin, Fighter","Support, Tank","Fighter, Assassin","Tank, Support",3,2,5
858,Marksman,"Tank, Support","Fighter, Mage","Support, Tank",4,1,5
859,"Fighter, Tank","Fighter, Assassin","Fighter, Mage","Tank, Fighter",4,1,5
4472,Marksman,"Tank, Fighter","Marksman, Mage","Tank, Support",3,2,5
866,Marksman,"Support, Fighter","Mage, Fighter","Tank, Support",3,2,5
867,Marksman,"Mage, Support","Fighter, Mage","Support, Tank",3,2,5
868,Tank,"Assassin, Fighter","Tank, Fighter","Fighter, Assassin",3,2,5
4483,Marksman,"Tank, Fighter","Marksman, Mage","Support, Mage",3,2,5
2637,"Tank, Mage",Fighter,"Tank, Fighter","Mage, Fighter",1,4,5
873,Fighter,"Support, Mage",Marksman,"Mage, Support",3,2,5
874,Fighter,"Assassin, Mage","Tank, Fighter","Mage, Assassin",2,3,5
4484,"Marksman, Mage","Support, Mage","Marksman, Mage","Support, Tank",2,3,5
879,Fighter,"Mage, Tank","Fighter, Mage","Mage, Support",2,3,5
2463,"Tank, Fighter","Mage, Fighter","Fighter, Assassin","Fighter, Mage",2,3,5
572,"Fighter, Assassin","Mage, Fighter",Tank,Fighter,3,2,5
2481,Marksman,"Fighter, Tank","Marksman, Assassin","Support, Fighter",3,2,5
790,Marksman,"Tank, Support","Mage, Fighter","Fighter, Tank",1,4,5
577,"Fighter, Tank",Fighter,Tank,"Mage, Fighter",2,3,5
792,"Mage, Fighter","Support, Mage",Fighter,"Tank, Support",2,3,5
607,Marksman,"Assassin, Fighter","Fighter, Assassin","Mage, Support",3,2,5
161,"Assassin, Fighter","Mage, Fighter","Assassin, Fighter",Mage,3,2,5
594,Marksman,"Mage, Assassin","Assassin, Fighter","Support, Mage",2,3,5
2614,"Tank, Fighter","Mage, Support","Fighter, Assassin","Mage, Assassin",2,3,5
8883,"Assassin, Fighter","Mage, Support","Assassin, Fighter","Mage, Tank",4,1,5
809,"Tank, Mage",Fighter,"Fighter, Tank","Mage, Fighter",0,5,5
812,Fighter,Mage,"Mage, Fighter","Mage, Fighter",2,3,5
814,"Fighter, Tank","Fighter, Mage","Mage, Marksman","Tank, Fighter",5,0,5
819,Tank,"Assassin, Fighter","Tank, Mage",Marksman,4,1,5
831,Fighter,Mage,"Tank, Fighter","Tank, Support",2,3,5
836,"Mage, Fighter","Support, Mage","Assassin, Fighter","Mage, Assassin",4,1,5
2624,"Tank, Fighter","Mage, Fighter","Tank, Fighter","Fighter, Mage",3,2,5
2488,"Fighter, Mage","Fighter, Assassin","Tank, Mage","Assassin, Fighter",1,4,5
841,"Tank, Mage","Fighter, Mage","Assassin, Fighter",Fighter,3,2,5
2751,"Fighter, Tank","Support, Mage","Fighter, Mage","Mage, Support",2,3,5
2682,"Tank, Fighter","Fighter, Assassin","Fighter, Tank","Assassin, Fighter",2,3,5
1235,"Mage, Fighter","Mage, Support","Fighter, Mage","Support, Tank",2,3,5
2280,Tank,"Fighter, Assassin","Tank, Fighter","Assassin, Fighter",3,2,5
5530,"Fighter, Assassin","Assassin, Fighter","Tank, Fighter",Marksman,5,0,5
2284,"Fighter, Tank","Mage, Fighter",Tank,"Fighter, Assassin",2,3,5
1154,Marksman,Mage,Marksman,"Tank, Fighter",4,1,5
9116,"Tank, Fighter","Mage, Assassin",Fighter,"Assassin, Mage",3,2,5
3794,"Assassin, Fighter","Support, Mage","Tank, Fighter","Mage, Support",0,5,5
1208,Fighter,"Mage, Fighter","Fighter, Tank",Fighter,2,3,5
2291,"Tank, Mage","Assassin, Fighter",Tank,"Mage, Fighter",3,2,5
9124,"Fighter, Mage","Assassin, Mage",Fighter,Mage,4,1,5
5383,Marksman,"Mage, Marksman",Marksman,Mage,3,2,5
1148,"Mage, Fighter",Mage,Fighter,"Support, Mage",2,3,5
2186,"Fighter, Tank","Fighter, Assassin","Fighter, Mage",Fighter,4,1,5
1147,"Tank, Fighter","Tank, Mage","Fighter, Tank","Tank, Fighter",4,1,5
1252,"Fighter, Mage","Mage, Marksman",Fighter,"Marksman, Mage",3,2,5
5527,"Tank, Mage","Tank, Fighter","Fighter, Tank","Tank, Mage",2,3,5
4885,Marksman,Mage,Marksman,"Support, Tank",2,3,5
2196,"Fighter, Tank",Marksman,"Fighter, Assassin","Mage, Fighter",4,1,5
2279,"Fighter, Mage","Tank, Fighter","Tank, Mage",Fighter,2,3,5
2219,"Tank, Fighter",Marksman,"Fighter, Assassin","Mage, Fighter",3,2,5
2201,"Fighter, Tank","Fighter, Mage",Tank,Marksman,3,2,5
2207,Fighter,"Support, Tank","Fighter, Tank","Mage, Support",3,2,5
217,Fighter,"Fighter, Mage","Assassin, Fighter",Fighter,4,1,5
9062,"Tank, Fighter",Mage,"Tank, Fighter",Mage,4,1,5
2265,"Fighter, Tank","Fighter, Assassin","Fighter, Mage",Marksman,4,1,5
2208,"Fighter, Mage","Support, Fighter","Assassin, Fighter","Tank, Fighter",1,4,5
439,"Fighter, Assassin","Support, Fighter",Fighter,"Tank, Support",3,2,5
2819,Fighter,"Support, Tank","Tank, Fighter","Support, Mage",3,2,5
2253,"Assassin, Fighter","Mage, Support",Fighter,"Support, Tank",2,3,5
8454,"Assassin, Fighter","Mage, Assassin","Fighter, Assassin",Mage,3,2,5
421,"Tank, Mage",Fighter,"Fighter, Mage","Fighter, Mage",3,2,5
2212,"Tank, Fighter","Mage, Fighter","Fighter, Mage","Assassin, Fighter",3,2,5
1171,"Marksman, Assassin","Tank, Support",Marksman,"Tank, Fighter",2,3,5
1169,Marksman,"Tank, Fighter","Marksman, Assassin","Support, Mage",4,1,5
420,Marksman,"Mage, Marksman","Mage, Fighter","Marksman, Mage",2,3,5
433,"Tank, Mage","Assassin, Fighter","Fighter, Mage","Assassin, Fighter",3,2,5
2840,"Fighter, Mage","Support, Tank","Mage, Fighter","Support, Mage",0,5,5
5577,"Tank, Fighter","Assassin, Fighter","Fighter, Tank",Marksman,4,1,5
2184,"Tank, Mage","Assassin, Fighter",Tank,Fighter,2,3,5
2228,"Fighter, Tank","Mage, Fighter",Fighter,"Fighter, Mage",2,3,5
5475,"Tank, Fighter","Tank, Fighter","Fighter, Tank","Tank, Mage",4,1,5
2178,"Assassin, Fighter","Support, Mage","Tank, Fighter","Support, Fighter",2,3,5
2852,"Fighter, Mage","Support, Mage",Fighter,"Support, Mage",1,4,5
2229,Tank,"Fighter, Tank","Fighter, Tank","Fighter, Mage",1,4,5
2853,"Fighter, Mage","Support, Mage","Tank, Fighter","Mage, Support",3,2,5
2883,"Fighter, Assassin",Mage,"Tank, Fighter","Support, Mage",4,1,5
5602,"Fighter, Tank","Fighter, Mage","Tank, Fighter","Assassin, Fighter",3,2,5
2311,"Tank, Mage","Fighter, Mage","Tank, Mage","Tank, Fighter",2,3,5
4868,"Marksman, Mage","Mage, Assassin",Marksman,"Support, Mage",3,2,5
5485,Tank,Marksman,"Fighter, Tank","Assassin, Fighter",1,4,5
5469,"Fighter, Tank","Mage, Fighter","Tank, Fighter","Tank, Fighter",3,2,5
1124,"Assassin, Fighter","Tank, Support",Marksman,"Support, Fighter",5,0,5
2221,"Assassin, Fighter","Mage, Support","Tank, Fighter",Marksman,3,2,5
10212,"Mage, Fighter",Mage,"Fighter, Mage","Support, Mage",2,3,5
1115,"Support, Mage","Mage, Support","Assassin, Fighter","Mage, Support",3,2,5
1297,"Fighter, Mage",Mage,"Fighter, Tank","Mage, Support",3,2,5
1114,"Fighter, Assassin","Mage, Fighter","Tank, Fighter","Fighter, Mage",3,2,5
3952,"Tank, Fighter","Support, Mage","Assassin, Fighter","Mage, Support",2,3,5
5484,"Tank, Fighter",Marksman,"Fighter, Tank","Fighter, Assassin",3,2,5
2843,"Assassin, Fighter","Support, Fighter","Tank, Fighter","Support, Tank",1,4,5
9075,Fighter,"Mage, Support","Fighter, Mage",Marksman,1,4,5
5458,"Fighter, Tank","Fighter, Assassin","Fighter, Mage","Assassin, Fighter",3,2,5
5479,"Fighter, Assassin","Fighter, Mage","Fighter, Tank","Tank, Fighter",2,3,5
2921,Marksman,"Support, Mage","Assassin, Fighter","Support, Tank",2,2,4
2620,"Fighter, Tank","Fighter, Mage","Tank, Fighter","Tank, Fighter",2,2,4
2142,"Assassin, Fighter","Mage, Support","Fighter, Tank","Support, Mage",1,3,4
2906,"Tank, Fighter","Tank, Support","Fighter, Mage","Support, Mage",3,1,4
3244,"Tank, Fighter","Support, Mage","Mage, Fighter","Support, Tank",4,0,4
8488,"Mage, Fighter",Marksman,"Fighter, Assassin",Mage,1,3,4
2512,"Tank, Fighter",Support,"Fighter, Mage","Tank, Support",3,1,4
1910,"Tank, Fighter","Fighter, Assassin","Tank, Fighter","Mage, Fighter",1,3,4
2905,"Fighter, Mage","Mage, Support",Marksman,"Support, Tank",2,2,4
2211,Marksman,Mage,"Marksman, Assassin","Support, Fighter",3,1,4
6720,"Tank, Fighter","Assassin, Fighter","Tank, Mage","Mage, Fighter",2,2,4
9179,"Fighter, Assassin",Mage,"Mage, Fighter",Mage,2,2,4
2472,"Fighter, Mage",Mage,Fighter,"Mage, Tank",3,1,4
8463,"Fighter, Mage","Mage, Assassin","Assassin, Fighter","Mage, Support",3,1,4
2510,"Fighter, Tank","Support, Fighter","Fighter, Mage","Mage, Support",3,1,4
2511,"Tank, Mage","Fighter, Mage","Fighter, Tank","Mage, Fighter",1,3,4
2467,"Fighter, Mage",Fighter,"Tank, Mage","Fighter, Assassin",3,1,4
3229,"Tank, Fighter","Support, Fighter","Tank, Mage","Support, Tank",2,2,4
8898,Fighter,"Assassin, Mage","Tank, Fighter","Mage, Support",3,1,4
2215,"Tank, Mage","Fighter, Tank","Fighter, Tank","Fighter, Mage",3,1,4
1893,"Fighter, Mage",Mage,Fighter,"Marksman, Mage",2,2,4
6873,"Fighter, Assassin","Tank, Fighter","Tank, Fighter","Fighter, Mage",0,4,4
1892,"Tank, Mage","Fighter, Tank",Tank,"Assassin, Fighter",2,2,4
2632,"Assassin, Fighter",Marksman,"Fighter, Assassin","Mage, Assassin",1,3,4
3210,"Assassin, Fighter",Mage,"Fighter, Assassin","Assassin, Mage",1,3,4
3213,"Assassin, Fighter","Mage, Support","Fighter, Assassin","Mage, Tank",2,2,4
2514,"Tank, Mage",Fighter,"Fighter, Mage","Tank, Fighter",2,2,4
2216,"Fighter, Assassin","Fighter, Mage","Fighter, Assassin","Mage, Fighter",3,1,4
2475,"Fighter, Assassin","Support, Mage","Support, Mage","Mage, Support",1,3,4
2131,"Fighter, Assassin","Fighter, Tank","Fighter, Assassin",Fighter,2,2,4
2134,"Fighter, Assassin","Mage, Support","Assassin, Fighter","Assassin, Mage",1,3,4
2497,"Fighter, Tank","Assassin, Fighter","Fighter, Mage",Fighter,0,4,4
2138,"Assassin, Fighter","Support, Tank",Fighter,"Support, Fighter",3,1,4
1884,"Assassin, Fighter",Mage,"Mage, Fighter","Mage, Marksman",1,3,4
2919,Fighter,"Mage, Support","Fighter, Tank","Support, Mage",2,2,4
1880,Marksman,"Support, Tank","Fighter, Assassin","Support, Fighter",3,1,4
2907,Fighter,"Support, Mage","Assassin, Fighter","Support, Tank",1,3,4
1905,"Marksman, Assassin","Support, Fighter",Marksman,Mage,0,4,4
6777,"Fighter, Tank","Fighter, Mage","Tank, Fighter","Tank, Mage",2,2,4
1894,"Fighter, Mage","Mage, Fighter",Fighter,Mage,1,3,4
1874,"Tank, Fighter","Mage, Support","Mage, Fighter","Mage, Support",1,3,4
2141,"Assassin, Fighter","Mage, Fighter","Tank, Fighter",Marksman,4,0,4
1860,"Fighter, Tank","Mage, Marksman",Fighter,Mage,1,3,4
2055,"Fighter, Mage","Fighter, Assassin","Tank, Mage","Mage, Fighter",2,2,4
6719,"Fighter, Assassin","Assassin, Fighter","Tank, Fighter","Mage, Support",2,2,4
2551,"Fighter, Assassin","Fighter, Mage","Mage, Fighter",Fighter,3,1,4
6563,"Tank, Fighter","Tank, Fighter","Tank, Mage","Tank, Fighter",3,1,4
2559,"Marksman, Support","Mage, Support","Marksman, Assassin","Tank, Fighter",3,1,4
8835,"Fighter, Tank",Mage,Fighter,"Mage, Fighter",3,1,4
286,"Mage, Fighter","Support, Fighter","Fighter, Mage","Tank, Support",0,4,4
1809,Fighter,Mage,"Fighter, Mage","Mage, Assassin",1,3,4
285,"Fighter, Mage","Assassin, Fighter","Tank, Mage","Assassin, Fighter",2,2,4
3303,"Tank, Fighter","Support, Tank","Fighter, Mage","Mage, Support",1,3,4
9139,Fighter,"Mage, Support","Fighter, Tank","Assassin, Mage",2,2,4
2877,"Tank, Fighter","Support, Mage","Tank, Fighter","Support, Fighter",3,1,4
1814,"Assassin, Mage",Mage,"Assassin, Fighter",Mage,3,1,4
3300,"Tank, Fighter","Support, Mage","Fighter, Mage","Support, Tank",2,2,4
9512,"Assassin, Fighter","Assassin, Mage","Fighter, Assassin","Mage, Support",3,1,4
6606,"Fighter, Assassin","Mage, Assassin","Tank, Fighter","Assassin, Mage",3,1,4
284,Marksman,"Support, Tank","Fighter, Mage","Support, Tank",1,3,4
2169,"Tank, Fighter","Mage, Support",Fighter,"Support, Fighter",2,2,4
8846,"Mage, Fighter","Assassin, Fighter","Fighter, Assassin",Mage,2,2,4
9137,"Assassin, Fighter","Mage, Support",Fighter,"Assassin, Mage",0,4,4
1796,"Marksman, Mage","Mage, Assassin","Marksman, Assassin","Support, Mage",2,2,4
2568,"Assassin, Fighter","Mage, Support",Marksman,"Support, Fighter",3,1,4
2575,"Fighter, Tank","Support, Tank",Fighter,"Support, Fighter",1,3,4
2173,"Assassin, Fighter","Support, Mage","Assassin, Fighter","Mage, Assassin",0,4,4
8843,"Fighter, Mage","Mage, Support","Assassin, Fighter",Marksman,3,1,4
8422,"Fighter, Mage","Mage, Marksman",Marksman,Mage,4,0,4
2175,Fighter,"Support, Tank","Assassin, Fighter","Support, Fighter",4,0,4
6536,Fighter,"Mage, Assassin","Tank, Fighter","Assassin, Mage",1,3,4
1789,"Fighter, Mage","Mage, Support",Fighter,"Mage, Assassin",1,3,4
2177,Marksman,"Support, Mage","Marksman, Support","Mage, Assassin",1,3,4
3331,"Fighter, Mage","Support, Mage","Fighter, Assassin","Tank, Support",3,1,4
2574,"Fighter, Tank",Fighter,"Assassin, Fighter","Fighter, Mage",3,1,4
1782,"Mage, Fighter","Support, Mage",Marksman,"Tank, Support",3,1,4
1781,Fighter,"Mage, Assassin","Fighter, Assassin","Assassin, Mage",2,2,4
2549,Marksman,"Mage, Assassin","Assassin, Fighter",Marksman,2,2,4
2547,"Fighter, Assassin","Tank, Fighter","Fighter, Tank","Fighter, Mage",4,0,4
1856,"Tank, Fighter","Support, Mage","Tank, Fighter",Fighter,3,1,4
2204,"Fighter, Tank","Fighter, Assassin",Tank,"Assassin, Fighter",2,2,4
8400,Fighter,Mage,"Mage, Fighter","Assassin, Fighter",2,2,4
2592,Marksman,"Tank, Support","Marksman, Support","Support, Fighter",1,3,4
2867,Fighter,"Support, Fighter","Fighter, Tank","Support, Mage",3,1,4
2529,"Fighter, Mage","Assassin, Fighter","Fighter, Mage",Fighter,2,2,4
8343,Marksman,Mage,"Assassin, Fighter","Support, Mage",1,3,4
2152,"Fighter, Tank","Mage, Fighter","Mage, Marksman",Fighter,2,2,4
3267,Marksman,Mage,Fighter,"Mage, Support",1,3,4
283,"Mage, Fighter","Mage, Marksman","Fighter, Assassin",Mage,1,3,4
9153,Marksman,Marksman,"Assassin, Fighter",Mage,0,4,4
2150,"Tank, Fighter",Marksman,"Fighter, Tank",Fighter,3,1,4
2604,Fighter,Mage,"Assassin, Fighter","Assassin, Fighter",3,1,4
2518,"Marksman, Assassin",Support,"Marksman, Mage","Support, Mage",0,4,4
2605,"Tank, Fighter","Mage, Fighter",Tank,"Fighter, Assassin",1,3,4
9154,Fighter,"Assassin, Mage","Assassin, Fighter",Mage,1,3,4
2535,"Tank, Fighter","Fighter, Mage",Tank,"Tank, Fighter",2,2,4
2536,Tank,"Tank, Fighter","Tank, Mage","Fighter, Mage",2,2,4
2591,"Marksman, Support","Fighter, Tank",Marksman,"Tank, Support",2,2,4
2538,"Tank, Fighter","Tank, Support","Fighter, Mage","Mage, Support",2,2,4
2200,Marksman,"Support, Mage","Marksman, Support","Tank, Support",3,1,4
8449,"Mage, Fighter","Support, Mage","Fighter, Mage",Mage,2,2,4
2197,"Fighter, Tank","Mage, Fighter",Tank,"Fighter, Tank",2,2,4
2871,"Fighter, Tank","Support, Mage","Fighter, Tank","Support, Mage",3,1,4
6642,"Fighter, Mage","Fighter, Mage","Fighter, Tank","Tank, Fighter",4,0,4
1835,Marksman,"Mage, Assassin","Marksman, Mage","Support, Mage",4,0,4
3277,"Mage, Fighter",Marksman,"Support, Mage","Mage, Support",2,2,4
3280,"Support, Mage","Mage, Support","Fighter, Assassin","Mage, Support",3,1,4
6627,Fighter,Mage,"Tank, Fighter","Assassin, Fighter",0,4,4
3287,"Fighter, Mage",Marksman,"Tank, Fighter",Mage,1,3,4
2876,"Fighter, Mage","Support, Mage",Marksman,"Mage, Support",1,3,4
9140,Fighter,Mage,"Assassin, Fighter","Assassin, Mage",0,4,4
2546,"Fighter, Tank","Fighter, Assassin","Fighter, Tank",Fighter,3,1,4
2153,"Tank, Fighter","Support, Tank","Fighter, Mage","Support, Tank",3,1,4
9376,"Tank, Fighter",Mage,"Mage, Fighter","Mage, Support",1,3,4
1911,"Fighter, Mage","Support, Fighter","Assassin, Fighter","Tank, Support",3,1,4
2388,"Tank, Mage",Fighter,"Fighter, Tank","Assassin, Fighter",4,0,4
2072,"Tank, Mage","Assassin, Fighter","Fighter, Tank",Marksman,3,1,4
8717,"Tank, Mage","Mage, Support","Tank, Fighter",Marksman,3,1,4
3076,"Tank, Fighter","Mage, Support","Fighter, Assassin","Support, Mage",2,2,4
2008,"Tank, Fighter","Support, Fighter",Fighter,"Mage, Support",3,1,4
8601,"Assassin, Fighter",Mage,"Mage, Fighter","Mage, Support",1,3,4
2009,Marksman,"Support, Mage","Assassin, Fighter",Mage,4,0,4
2387,"Mage, Fighter","Mage, Support","Fighter, Mage","Support, Mage",3,1,4
9038,"Tank, Fighter","Mage, Assassin",Fighter,Mage,1,3,4
2699,"Fighter, Tank","Mage, Assassin","Assassin, Fighter","Mage, Support",3,1,4
2012,"Fighter, Mage","Mage, Marksman",Marksman,"Assassin, Mage",0,4,4
2070,"Fighter, Mage","Mage, Fighter","Fighter, Tank","Fighter, Mage",1,3,4
2774,"Assassin, Fighter","Mage, Support",Marksman,"Tank, Support",2,2,4
2014,Fighter,"Assassin, Mage","Mage, Fighter",Mage,0,4,4
2377,"Fighter, Assassin","Fighter, Mage","Tank, Fighter","Mage, Fighter",1,3,4
2001,Marksman,"Mage, Marksman",Fighter,Mage,2,2,4
2392,"Fighter, Tank","Fighter, Tank","Fighter, Mage",Fighter,1,3,4
1986,"Fighter, Mage",Mage,"Mage, Fighter","Mage, Marksman",2,2,4
2401,"Tank, Mage","Fighter, Mage","Tank, Fighter","Fighter, Assassin",1,3,4
8560,"Fighter, Assassin",Mage,"Fighter, Mage","Mage, Support",3,1,4
2275,"Fighter, Mage",Fighter,"Tank, Fighter","Fighter, Assassin",1,3,4
2278,"Tank, Mage",Fighter,"Tank, Fighter","Fighter, Mage",1,3,4
2080,"Tank, Fighter","Assassin, Fighter","Fighter, Mage","Mage, Fighter",2,2,4
1991,"Assassin, Fighter",Mage,"Fighter, Mage","Support, Mage",3,1,4
2402,"Assassin, Fighter","Assassin, Fighter","Tank, Fighter",Marksman,1,3,4
2399,"Fighter, Tank","Fighter, Mage",Tank,"Assassin, Fighter",3,1,4
3000,"Assassin, Fighter","Support, Mage",Marksman,"Support, Fighter",2,2,4
273,"Fighter, Mage","Support, Tank","Fighter, Assassin","Support, Fighter",3,1,4
7718,"Fighter, Tank","Fighter, Mage","Fighter, Tank",Marksman,2,2,4
8957,Marksman,Mage,"Assassin, Fighter",Mage,1,3,4
2692,"Fighter, Assassin",Marksman,"Assassin, Fighter","Mage, Support",2,2,4
2289,"Assassin, Fighter","Support, Tank",Marksman,"Tank, Support",1,3,4
2999,"Assassin, Fighter","Mage, Assassin","Fighter, Assassin",Marksman,2,2,4
7675,Tank,"Assassin, Fighter","Tank, Mage","Mage, Fighter",2,2,4
2376,"Mage, Fighter","Fighter, Mage","Tank, Mage",Fighter,1,3,4
2375,"Marksman, Mage","Support, Mage","Marksman, Support","Mage, Assassin",2,2,4
8622,"Tank, Fighter",Marksman,Fighter,"Mage, Support",3,1,4
2040,"Fighter, Tank","Support, Tank","Mage, Fighter","Fighter, Tank",2,2,4
2763,"Fighter, Assassin","Mage, Support","Support, Mage","Mage, Support",1,3,4
2044,"Fighter, Tank","Support, Mage",Fighter,"Support, Tank",3,1,4
2060,"Fighter, Mage",Marksman,"Mage, Fighter",Mage,3,1,4
2337,Fighter,"Support, Mage","Assassin, Fighter","Tank, Support",2,2,4
2336,"Tank, Fighter","Tank, Fighter","Fighter, Mage","Fighter, Assassin",2,2,4
2319,"Fighter, Mage",Marksman,Fighter,"Mage, Support",2,2,4
2301,Tank,"Mage, Fighter","Tank, Mage","Assassin, Fighter",2,2,4
2758,"Fighter, Assassin","Mage, Assassin",Fighter,"Mage, Support",3,1,4
2331,Marksman,"Support, Fighter","Marksman, Support","Tank, Support",2,2,4
3020,"Tank, Mage",Support,"Tank, Fighter","Support, Tank",3,1,4
9013,Fighter,"Mage, Support","Mage, Fighter","Mage, Fighter",1,3,4
8634,Fighter,Mage,"Assassin, Fighter","Mage, Support",1,3,4
2054,"Tank, Fighter",Marksman,"Tank, Mage","Mage, Support",2,2,4
8660,"Mage, Fighter","Assassin, Mage",Fighter,"Mage, Support",2,2,4
2349,"Marksman, Mage","Support, Fighter","Marksman, Assassin","Tank, Support",3,1,4
2727,"Mage, Fighter","Support, Tank","Fighter, Tank","Support, Mage",0,4,4
2725,"Fighter, Assassin","Mage, Support","Fighter, Mage","Support, Mage",3,1,4
2360,Tank,"Fighter, Tank","Fighter, Assassin",Fighter,2,2,4
2035,"Fighter, Tank","Fighter, Assassin","Tank, Mage",Fighter,4,0,4
9247,Fighter,"Mage, Fighter","Assassin, Fighter","Mage, Support",2,2,4
2063,"Tank, Fighter","Fighter, Mage","Fighter, Tank",Marksman,1,3,4
7543,"Tank, Fighter","Fighter, Assassin","Fighter, Tank","Tank, Fighter",1,3,4
2364,"Fighter, Tank",Marksman,"Fighter, Mage","Mage, Fighter",2,2,4
3044,"Tank, Fighter","Mage, Support","Tank, Fighter","Tank, Mage",1,3,4
2304,"Tank, Mage",Marksman,"Fighter, Mage","Assassin, Fighter",3,1,4
2713,"Assassin, Fighter","Support, Mage","Fighter, Mage","Support, Mage",3,1,4
2710,"Fighter, Mage","Support, Mage",Fighter,Mage,2,2,4
2302,Fighter,"Support, Mage","Fighter, Assassin","Support, Fighter",3,1,4
2372,"Fighter, Assassin","Fighter, Assassin","Fighter, Tank","Mage, Fighter",2,2,4
2373,"Fighter, Assassin","Mage, Fighter","Tank, Fighter",Fighter,2,2,4
2085,"Tank, Mage","Fighter, Mage","Tank, Fighter","Mage, Fighter",3,1,4
2272,"Fighter, Mage","Tank, Support","Mage, Fighter","Support, Mage",2,2,4
8491,"Assassin, Fighter",Mage,"Fighter, Assassin",Marksman,2,2,4
2443,"Tank, Fighter","Fighter, Mage","Tank, Fighter","Fighter, Assassin",1,3,4
1931,"Fighter, Assassin","Support, Mage","Mage, Fighter","Support, Tank",1,3,4
2242,"Assassin, Fighter","Mage, Support","Tank, Fighter","Support, Fighter",3,1,4
3154,"Fighter, Assassin","Tank, Mage","Fighter, Mage","Mage, Support",1,3,4
8516,"Fighter, Tank","Mage, Support","Fighter, Mage","Assassin, Fighter",2,2,4
8520,"Fighter, Mage","Mage, Support","Tank, Mage","Mage, Support",2,2,4
7995,"Fighter, Tank",Marksman,"Assassin, Fighter","Mage, Fighter",0,4,4
2651,Marksman,"Tank, Support","Marksman, Assassin","Fighter, Tank",3,1,4
2644,"Fighter, Assassin","Tank, Fighter","Fighter, Tank",Fighter,2,2,4
2966,"Fighter, Assassin","Support, Fighter","Fighter, Tank","Support, Tank",1,3,4
1944,Marksman,"Tank, Support","Marksman, Mage",Mage,3,1,4
2097,"Assassin, Fighter","Mage, Fighter",Fighter,"Mage, Support",4,0,4
2438,"Tank, Fighter","Support, Fighter","Fighter, Mage",Support,2,2,4
7108,"Assassin, Fighter","Fighter, Marksman",Fighter,Mage,2,2,4
7159,Tank,"Fighter, Assassin","Fighter, Tank","Assassin, Fighter",2,2,4
2448,"Mage, Fighter",Marksman,"Assassin, Fighter","Mage, Assassin",3,1,4
6974,"Fighter, Mage","Mage, Fighter","Fighter, Tank",Marksman,4,0,4
2679,Marksman,"Tank, Fighter",Marksman,"Fighter, Tank",3,1,4
2460,Fighter,"Support, Fighter","Assassin, Fighter","Tank, Fighter",2,2,4
9398,"Assassin, Fighter",Marksman,Fighter,Mage,2,2,4
2462,"Fighter, Assassin","Mage, Fighter","Tank, Mage","Assassin, Fighter",2,2,4
1916,Marksman,"Support, Mage","Fighter, Mage","Support, Tank",1,3,4
3182,"Assassin, Fighter","Support, Mage","Fighter, Mage","Support, Fighter",2,2,4
8900,"Tank, Fighter",Marksman,"Tank, Fighter",Mage,2,2,4
3180,"Assassin, Fighter","Mage, Assassin","Mage, Fighter","Mage, Support",3,1,4
6953,"Fighter, Assassin",Fighter,Tank,"Fighter, Tank",1,3,4
9070,"Fighter, Assassin","Mage, Support","Fighter, Mage",Mage,1,3,4
2641,"Fighter, Mage","Assassin, Mage",Fighter,"Mage, Support",2,2,4
9022,"Assassin, Fighter",Mage,"Mage, Fighter","Assassin, Mage",2,2,4
2456,"Tank, Fighter","Assassin, Fighter","Fighter, Assassin","Fighter, Assassin",3,1,4
2111,"Fighter, Mage",Marksman,"Assassin, Fighter","Assassin, Fighter",4,0,4
2643,"Marksman, Mage","Fighter, Tank",Marksman,"Support, Mage",3,1,4
8498,"Assassin, Fighter","Mage, Assassin",Marksman,"Assassin, Mage",1,3,4
2096,Fighter,"Support, Mage","Fighter, Tank","Support, Fighter",3,1,4
1951,"Mage, Fighter","Assassin, Fighter",Marksman,Mage,2,2,4
2094,"Marksman, Support","Support, Fighter","Marksman, Assassin","Support, Mage",3,1,4
3110,"Fighter, Tank","Support, Tank","Assassin, Fighter","Support, Fighter",1,3,4
2416,"Fighter, Assassin","Mage, Support","Mage, Fighter",Marksman,2,2,4
2088,Marksman,"Support, Fighter",Fighter,"Support, Tank",1,3,4
1973,Marksman,"Support, Mage","Support, Mage","Mage, Support",3,1,4
2412,"Fighter, Tank","Fighter, Assassin","Tank, Fighter","Mage, Fighter",0,4,4
9202,"Fighter, Tank",Mage,Fighter,"Mage, Support",4,0,4
8741,"Assassin, Fighter","Mage, Tank","Fighter, Assassin","Mage, Support",2,2,4
7274,"Fighter, Tank","Tank, Fighter","Tank, Fighter","Mage, Fighter",3,1,4
2249,"Assassin, Fighter","Fighter, Mage","Fighter, Tank",Fighter,2,2,4
1980,Fighter,Mage,"Assassin, Fighter","Support, Mage",1,3,4
7297,Tank,Marksman,"Fighter, Tank","Mage, Fighter",0,4,4
1983,"Assassin, Fighter","Support, Tank","Tank, Fighter","Support, Mage",3,1,4
2809,"Fighter, Tank","Support, Mage","Assassin, Fighter","Support, Tank",0,4,4
1985,Tank,"Fighter, Mage","Tank, Mage","Tank, Fighter",1,3,4
2086,"Fighter, Tank","Mage, Fighter","Fighter, Assassin",Marksman,3,1,4
2669,"Fighter, Mage","Support, Tank","Assassin, Fighter","Support, Tank",3,1,4
2262,"Fighter, Mage",Marksman,"Tank, Fighter","Fighter, Assassin",1,3,4
2260,"Fighter, Mage","Tank, Fighter","Tank, Fighter","Fighter, Mage",2,2,4
2258,"Marksman, Mage","Mage, Support","Marksman, Mage","Support, Tank",4,0,4
2255,"Tank, Fighter","Assassin, Fighter","Tank, Mage","Fighter, Tank",3,1,4
2420,"Fighter, Tank","Mage, Fighter","Fighter, Mage","Fighter, Mage",0,4,4
2421,Marksman,"Mage, Support",Fighter,"Support, Tank",2,2,4
2423,"Fighter, Mage","Tank, Mage","Tank, Fighter",Marksman,1,3,4
2666,"Tank, Mage",Marksman,"Fighter, Tank","Assassin, Fighter",2,2,4
1965,"Fighter, Mage","Support, Mage","Mage, Fighter",Mage,2,2,4
8533,"Tank, Fighter","Mage, Support","Fighter, Tank","Mage, Support",4,0,4
275,Fighter,Mage,"Mage, Fighter","Mage, Marksman",2,2,4
2427,"Mage, Fighter",Mage,"Tank, Fighter",Marksman,0,4,4
2981,"Fighter, Mage","Mage, Support",Marksman,"Support, Mage",4,0,4
1960,"Fighter, Tank","Assassin, Fighter",Tank,"Fighter, Assassin",3,1,4
2429,"Tank, Mage","Assassin, Fighter","Fighter, Tank","Mage, Fighter",2,2,4
2433,Tank,"Fighter, Mage","Tank, Mage","Assassin, Fighter",0,4,4
2232,"Fighter, Mage","Support, Tank",Fighter,"Mage, Support",4,0,4
671,"Mage, Fighter","Assassin, Fighter",Marksman,"Mage, Support",2,2,4
6509,"Tank, Fighter","Mage, Assassin","Fighter, Assassin","Assassin, Fighter",2,2,4
5552,"Tank, Fighter","Tank, Mage","Fighter, Tank","Fighter, Mage",2,2,4
1226,"Assassin, Fighter","Assassin, Fighter",Marksman,"Mage, Support",2,2,4
1227,"Tank, Mage","Fighter, Mage","Tank, Fighter","Tank, Fighter",2,2,4
1231,"Assassin, Fighter","Mage, Support","Fighter, Assassin","Mage, Fighter",3,1,4
5480,"Tank, Fighter",Fighter,"Fighter, Assassin","Fighter, Mage",1,3,4
5518,"Fighter, Tank","Assassin, Fighter","Fighter, Assassin","Fighter, Assassin",4,0,4
1253,"Fighter, Mage",Support,"Assassin, Fighter","Support, Tank",3,1,4
1254,"Mage, Fighter","Mage, Fighter","Fighter, Mage",Mage,3,1,4
5534,"Fighter, Tank",Fighter,"Fighter, Tank","Assassin, Fighter",3,1,4
5535,"Tank, Fighter","Assassin, Fighter","Mage, Marksman","Mage, Fighter",2,2,4
424,"Tank, Mage",Fighter,"Assassin, Fighter",Marksman,1,3,4
3815,"Fighter, Assassin","Support, Tank","Tank, Fighter","Support, Mage",2,2,4
3810,"Tank, Fighter",Mage,"Assassin, Fighter","Tank, Support",2,2,4
10266,"Assassin, Fighter",Mage,"Fighter, Mage",Mage,4,0,4
5650,"Mage, Fighter","Assassin, Fighter","Fighter, Tank","Mage, Fighter",3,1,4
5559,"Fighter, Tank","Tank, Fighter","Fighter, Assassin","Tank, Fighter",3,1,4
1273,"Marksman, Assassin",Support,Marksman,"Tank, Support",3,1,4
3796,"Assassin, Fighter","Support, Mage","Tank, Fighter","Support, Tank",3,1,4
1285,"Assassin, Fighter",Mage,"Mage, Fighter","Fighter, Marksman",3,1,4
5595,"Fighter, Tank",Marksman,"Assassin, Fighter",Marksman,3,1,4
5604,"Tank, Fighter","Assassin, Fighter","Tank, Fighter","Assassin, Fighter",3,1,4
5620,"Fighter, Tank","Fighter, Mage","Tank, Fighter",Fighter,3,1,4
1305,Marksman,Support,"Marksman, Mage","Mage, Support",3,1,4
5641,"Tank, Fighter","Mage, Fighter","Tank, Fighter","Fighter, Assassin",2,2,4
1311,"Mage, Fighter","Support, Fighter","Tank, Fighter","Mage, Support",0,4,4
5642,"Fighter, Assassin",Fighter,"Fighter, Tank",Marksman,3,1,4
1316,Fighter,"Mage, Support","Fighter, Mage","Support, Fighter",0,4,4
1224,"Fighter, Mage","Support, Mage","Tank, Fighter","Support, Fighter",2,2,4
3866,"Fighter, Mage","Mage, Assassin","Mage, Fighter","Mage, Support",2,2,4
1218,"Fighter, Tank","Support, Tank","Fighter, Mage","Tank, Support",3,1,4
428,Marksman,"Tank, Support",Fighter,"Fighter, Tank",2,2,4
4811,"Marksman, Mage","Support, Mage","Mage, Marksman","Mage, Support",2,2,4
1144,Tank,"Tank, Fighter","Tank, Fighter","Fighter, Mage",1,3,4
1149,"Assassin, Fighter","Fighter, Marksman",Marksman,"Mage, Support",4,0,4
1152,Tank,"Fighter, Tank","Fighter, Mage","Assassin, Fighter",4,0,4
1158,Marksman,"Mage, Fighter","Mage, Fighter","Mage, Marksman",3,1,4
1159,Marksman,"Mage, Support","Support, Mage",Marksman,2,2,4
1160,Marksman,"Support, Mage",Fighter,"Mage, Support",3,1,4
1162,"Assassin, Fighter","Assassin, Fighter","Assassin, Fighter","Assassin, Mage",4,0,4
1164,"Fighter, Assassin",Mage,"Fighter, Mage","Assassin, Mage",2,2,4
1172,Marksman,"Support, Fighter","Fighter, Marksman","Tank, Support",1,3,4
1174,"Fighter, Mage","Assassin, Fighter",Tank,"Fighter, Assassin",4,0,4
1182,Fighter,"Tank, Support","Mage, Fighter","Support, Fighter",1,3,4
1183,"Assassin, Fighter","Assassin, Fighter","Assassin, Fighter",Marksman,4,0,4
1186,"Marksman, Assassin","Tank, Support",Marksman,"Fighter, Tank",1,3,4
446,"Fighter, Mage","Assassin, Fighter","Fighter, Mage","Fighter, Assassin",1,3,4
5118,"Tank, Fighter","Mage, Assassin","Tank, Fighter","Support, Mage",3,1,4
1192,"Tank, Fighter","Tank, Fighter","Tank, Mage",Fighter,1,3,4
443,"Fighter, Assassin","Support, Mage",Marksman,"Support, Mage",3,1,4
1200,"Mage, Fighter","Tank, Support","Tank, Fighter","Support, Tank",1,3,4
5368,Marksman,"Mage, Marksman",Marksman,"Tank, Fighter",3,1,4
436,"Fighter, Assassin","Mage, Assassin","Tank, Fighter","Mage, Assassin",2,2,4
431,"Fighter, Mage","Mage, Fighter",Tank,Marksman,3,1,4
1211,"Assassin, Fighter","Mage, Support","Assassin, Fighter","Support, Tank",4,0,4
1212,Fighter,Marksman,"Mage, Fighter",Mage,2,2,4
1215,Marksman,"Tank, Support",Fighter,"Support, Tank",3,1,4
1318,Fighter,"Tank, Support","Fighter, Mage","Tank, Fighter",3,1,4
1328,"Mage, Fighter","Tank, Fighter","Fighter, Mage","Support, Fighter",3,1,4
1118,"Assassin, Fighter","Assassin, Fighter","Mage, Fighter","Mage, Support",3,1,4
1459,"Assassin, Fighter","Support, Tank","Fighter, Mage","Tank, Support",3,1,4
5770,"Tank, Fighter","Fighter, Assassin","Fighter, Assassin",Fighter,4,0,4
1423,"Fighter, Assassin","Fighter, Assassin","Tank, Fighter","Fighter, Mage",2,2,4
1427,"Tank, Fighter","Support, Fighter","Mage, Fighter","Support, Mage",4,0,4
1429,"Assassin, Fighter","Tank, Support",Fighter,"Support, Fighter",1,3,4
1431,Fighter,"Assassin, Mage","Fighter, Assassin",Mage,4,0,4
1432,Fighter,"Support, Fighter","Assassin, Fighter","Tank, Support",1,3,4
5791,"Fighter, Tank","Assassin, Fighter","Tank, Fighter",Fighter,3,1,4
1435,"Fighter, Mage","Support, Tank",Marksman,"Fighter, Tank",2,2,4
1446,"Fighter, Tank","Mage, Support","Fighter, Mage","Mage, Support",1,3,4
5808,"Fighter, Tank",Marksman,"Fighter, Mage","Assassin, Fighter",2,2,4
5819,"Tank, Fighter","Fighter, Mage","Tank, Mage","Tank, Fighter",3,1,4
1458,"Marksman, Support","Fighter, Tank",Marksman,"Support, Tank",4,0,4
1463,"Fighter, Tank","Mage, Support","Fighter, Assassin",Mage,3,1,4
1329,"Mage, Fighter",Mage,"Fighter, Assassin","Assassin, Mage",1,3,4
5838,"Fighter, Tank",Marksman,"Fighter, Assassin","Fighter, Mage",2,2,4
1468,"Tank, Fighter","Support, Mage","Assassin, Fighter","Support, Fighter",1,3,4
5852,"Tank, Fighter",Marksman,"Assassin, Fighter","Assassin, Fighter",1,3,4
1477,"Fighter, Assassin","Support, Fighter","Mage, Fighter","Support, Mage",2,2,4
5867,"Fighter, Tank","Fighter, Assassin","Fighter, Tank","Assassin, Fighter",2,2,4
5879,"Fighter, Tank","Mage, Fighter","Tank, Mage",Fighter,2,2,4
1486,"Fighter, Mage",Mage,Fighter,"Mage, Assassin",2,2,4
1488,"Fighter, Tank","Assassin, Fighter","Tank, Mage","Mage, Fighter",4,0,4
3617,"Assassin, Fighter","Support, Fighter","Mage, Fighter","Support, Mage",3,1,4
1491,"Mage, Fighter","Support, Mage","Fighter, Assassin","Tank, Support",1,3,4
1498,"Assassin, Fighter",Marksman,"Tank, Fighter","Mage, Fighter",4,0,4
375,"Fighter, Mage","Fighter, Assassin",Tank,"Mage, Fighter",2,2,4
5762,"Tank, Mage",Marksman,"Fighter, Tank","Fighter, Mage",3,1,4
3684,"Mage, Fighter","Support, Mage","Fighter, Assassin","Support, Fighter",1,3,4
1407,Marksman,"Fighter, Tank","Mage, Fighter","Support, Tank",2,2,4
1404,"Mage, Fighter","Mage, Support","Assassin, Fighter","Support, Fighter",3,1,4
3739,Fighter,Mage,"Fighter, Assassin","Mage, Marksman",3,1,4
5670,"Fighter, Tank",Fighter,"Fighter, Assassin","Fighter, Tank",2,2,4
1342,"Fighter, Assassin","Support, Tank","Mage, Fighter","Tank, Support",2,2,4
5679,"Mage, Fighter",Fighter,"Fighter, Tank","Fighter, Mage",1,3,4
1347,"Mage, Fighter",Mage,"Fighter, Mage","Mage, Tank",3,1,4
1348,Fighter,"Tank, Support","Fighter, Assassin","Support, Fighter",1,3,4
1351,"Mage, Fighter",Mage,"Assassin, Fighter","Mage, Marksman",0,4,4
1352,Marksman,Mage,Fighter,"Mage, Marksman",2,2,4
5693,"Fighter, Tank","Fighter, Assassin","Fighter, Tank","Tank, Fighter",2,2,4
1358,"Tank, Fighter","Fighter, Mage","Fighter, Assassin","Mage, Fighter",3,1,4
5704,"Fighter, Mage","Mage, Fighter","Fighter, Tank","Tank, Fighter",2,2,4
1369,"Mage, Fighter","Mage, Assassin",Fighter,Mage,3,1,4
5726,"Fighter, Tank","Fighter, Assassin",Tank,"Fighter, Mage",2,2,4
5730,"Fighter, Tank","Fighter, Mage","Fighter, Tank","Fighter, Assassin",2,2,4
408,"Tank, Fighter",Support,"Tank, Mage","Support, Fighter",1,3,4
10065,"Assassin, Fighter","Mage, Support","Fighter, Mage",Marksman,2,2,4
1380,Fighter,"Support, Fighter","Fighter, Assassin","Tank, Support",3,1,4
3703,Fighter,"Support, Fighter","Assassin, Fighter","Support, Mage",2,2,4
5736,"Fighter, Mage","Tank, Fighter","Fighter, Tank",Fighter,3,1,4
1389,"Mage, Fighter",Marksman,Marksman,"Mage, Assassin",3,1,4
5741,Fighter,Marksman,"Tank, Fighter","Assassin, Fighter",2,2,4
1393,"Tank, Fighter","Fighter, Assassin","Tank, Fighter",Marksman,2,2,4
3690,Marksman,Mage,"Mage, Fighter","Support, Mage",4,0,4
406,Tank,"Fighter, Mage",Fighter,"Mage, Fighter",3,1,4
10037,Marksman,Mage,"Assassin, Fighter","Mage, Fighter",1,3,4
1119,Marksman,"Support, Mage","Fighter, Assassin","Support, Mage",0,4,4
1112,"Mage, Fighter","Support, Mage","Assassin, Fighter","Support, Mage",4,0,4
373,Fighter,"Support, Tank","Mage, Fighter","Fighter, Tank",3,1,4
825,Fighter,"Tank, Support","Fighter, Mage","Tank, Support",4,0,4
606,"Assassin, Mage","Tank, Support","Fighter, Mage","Support, Mage",2,2,4
605,"Marksman, Mage","Mage, Assassin","Marksman, Support","Support, Mage",1,3,4
602,"Fighter, Assassin","Tank, Support",Fighter,"Support, Fighter",4,0,4
801,"Fighter, Assassin","Support, Tank","Fighter, Mage","Tank, Support",3,1,4
806,"Fighter, Mage",Mage,Fighter,"Support, Fighter",2,2,4
808,"Mage, Fighter","Mage, Fighter",Fighter,Mage,2,2,4
591,Fighter,"Tank, Fighter","Fighter, Mage","Mage, Support",2,2,4
590,"Marksman, Assassin","Mage, Support","Marksman, Support","Support, Fighter",0,4,4
816,"Fighter, Assassin","Mage, Assassin","Assassin, Fighter","Support, Tank",2,2,4
587,"Marksman, Assassin","Fighter, Tank","Marksman, Support","Support, Tank",1,3,4
586,"Marksman, Support","Fighter, Tank","Marksman, Assassin","Support, Tank",2,2,4
824,"Mage, Fighter","Mage, Support",Fighter,"Support, Fighter",2,2,4
580,"Marksman, Mage","Support, Fighter","Marksman, Assassin","Tank, Fighter",2,2,4
885,"Assassin, Fighter","Tank, Support","Mage, Fighter","Support, Mage",2,2,4
4452,"Marksman, Assassin","Support, Tank","Marksman, Assassin","Mage, Support",4,0,4
839,"Assassin, Fighter","Tank, Support",Fighter,"Mage, Support",2,2,4
842,"Fighter, Mage","Support, Tank","Mage, Fighter","Mage, Support",3,1,4
847,"Tank, Fighter","Assassin, Fighter",Fighter,"Mage, Assassin",2,2,4
575,"Assassin, Fighter","Fighter, Assassin","Tank, Mage",Marksman,2,2,4
4466,Marksman,"Tank, Support","Marksman, Assassin","Mage, Support",1,3,4
571,"Fighter, Assassin","Support, Fighter",Marksman,"Support, Tank",2,2,4
861,"Mage, Fighter","Mage, Support","Fighter, Mage","Tank, Mage",3,1,4
862,"Assassin, Fighter",Mage,Marksman,"Support, Mage",2,2,4
863,"Tank, Mage","Assassin, Fighter",Tank,"Support, Mage",2,2,4
872,Marksman,"Tank, Fighter","Fighter, Marksman","Support, Fighter",2,2,4
878,Fighter,"Mage, Tank","Mage, Fighter","Mage, Support",3,1,4
4423,Marksman,"Support, Mage","Marksman, Mage","Tank, Fighter",3,1,4
784,"Mage, Fighter","Tank, Support",Marksman,"Fighter, Tank",3,1,4
783,"Fighter, Mage","Tank, Mage","Mage, Fighter","Mage, Support",4,0,4
780,Tank,"Mage, Fighter","Fighter, Mage","Assassin, Fighter",3,1,4
669,"Marksman, Mage","Support, Tank","Marksman, Support","Mage, Assassin",2,2,4
678,"Fighter, Mage",Support,"Tank, Fighter","Support, Tank",2,2,4
680,Fighter,"Support, Tank","Mage, Fighter","Support, Tank",3,1,4
664,"Tank, Fighter","Mage, Fighter",Fighter,Marksman,2,2,4
691,"Fighter, Tank","Assassin, Mage","Tank, Mage","Assassin, Fighter",1,3,4
695,"Fighter, Assassin","Support, Tank",Marksman,"Tank, Support",3,1,4
696,"Fighter, Mage","Support, Fighter",Fighter,"Fighter, Tank",4,0,4
700,Marksman,"Tank, Support","Assassin, Fighter","Fighter, Tank",3,1,4
711,"Support, Mage","Tank, Fighter","Fighter, Mage","Fighter, Assassin",1,3,4
714,"Fighter, Tank","Mage, Fighter","Mage, Fighter",Fighter,2,2,4
716,"Fighter, Mage","Fighter, Tank","Mage, Fighter","Support, Tank",1,3,4
723,"Mage, Fighter","Support, Mage","Fighter, Assassin","Mage, Assassin",1,3,4
650,Fighter,"Assassin, Mage",Marksman,"Mage, Assassin",2,2,4
647,"Mage, Fighter","Tank, Support","Fighter, Mage","Support, Fighter",2,2,4
730,"Fighter, Mage","Support, Fighter","Mage, Fighter","Support, Mage",2,2,4
738,"Tank, Fighter",Fighter,"Tank, Mage","Fighter, Assassin",1,3,4
752,"Fighter, Assassin","Assassin, Fighter","Assassin, Fighter","Mage, Support",1,3,4
632,"Assassin, Fighter",Fighter,"Tank, Mage","Assassin, Fighter",1,3,4
4405,"Marksman, Support","Tank, Fighter",Marksman,"Mage, Support",1,3,4
625,"Tank, Fighter","Support, Fighter","Fighter, Assassin",Mage,3,1,4
770,Tank,"Assassin, Fighter","Tank, Fighter",Marksman,2,2,4
772,"Mage, Fighter","Tank, Fighter","Fighter, Assassin","Support, Fighter",1,3,4
775,Tank,"Fighter, Assassin","Tank, Mage","Assassin, Fighter",2,2,4
778,"Tank, Fighter",Support,"Fighter, Mage","Support, Mage",3,1,4
779,"Fighter, Mage","Support, Fighter","Mage, Fighter","Fighter, Tank",3,1,4
563,"Tank, Mage",Marksman,"Fighter, Mage",Marksman,2,2,4
886,Marksman,"Mage, Fighter",Marksman,"Mage, Marksman",1,3,4
1107,"Assassin, Fighter","Support, Fighter",Marksman,"Mage, Support",1,3,4
1055,"Fighter, Assassin","Support, Mage","Fighter, Tank","Mage, Support",2,2,4
1006,"Mage, Fighter",Marksman,"Assassin, Fighter",Mage,4,0,4
518,"Fighter, Mage","Mage, Tank",Fighter,"Mage, Assassin",2,2,4
511,Fighter,"Support, Tank","Assassin, Fighter","Tank, Support",1,3,4
4634,Marksman,"Support, Mage","Marksman, Assassin","Fighter, Tank",2,2,4
507,"Assassin, Fighter","Fighter, Tank","Mage, Fighter","Tank, Support",3,1,4
1032,Fighter,Mage,Marksman,"Mage, Marksman",1,3,4
1038,"Fighter, Tank","Mage, Support","Fighter, Assassin",Marksman,1,3,4
4649,"Marksman, Assassin","Support, Tank",Marksman,"Tank, Fighter",0,4,4
1040,"Assassin, Fighter","Mage, Support","Fighter, Assassin","Fighter, Marksman",1,3,4
1041,"Mage, Fighter","Support, Fighter",Marksman,"Mage, Support",1,3,4
1046,"Fighter, Mage","Mage, Support","Assassin, Fighter",Mage,3,1,4
4676,"Marksman, Assassin","Tank, Fighter",Marksman,"Tank, Support",2,2,4
4029,"Fighter, Assassin","Mage, Support","Tank, Fighter","Mage, Support",1,3,4
890,"Assassin, Fighter","Mage, Fighter","Support, Mage",Marksman,3,1,4
4696,Marksman,"Tank, Support",Marksman,"Tank, Support",3,1,4
1072,"Fighter, Assassin",Marksman,"Tank, Fighter","Mage, Fighter",2,2,4
492,Tank,Fighter,Fighter,"Fighter, Mage",3,1,4
491,"Assassin, Fighter",Fighter,Fighter,"Fighter, Mage",1,3,4
4733,Marksman,"Support, Mage","Marksman, Assassin",Support,2,2,4
488,"Mage, Fighter","Mage, Marksman",Fighter,"Assassin, Mage",2,2,4
4737,Marksman,"Tank, Support",Marksman,"Mage, Marksman",2,2,4
487,"Fighter, Assassin","Tank, Support",Fighter,"Support, Tank",2,2,4
3992,Marksman,Mage,"Fighter, Assassin","Mage, Support",3,1,4
1096,"Tank, Fighter","Mage, Support","Fighter, Mage","Tank, Mage",1,3,4
484,"Assassin, Fighter","Support, Tank","Fighter, Mage","Support, Tank",3,1,4
4749,"Marksman, Assassin","Support, Mage","Marksman, Assassin","Tank, Support",2,2,4
1004,"Mage, Fighter","Mage, Tank","Fighter, Mage",Mage,2,2,4
996,"Assassin, Fighter",Mage,"Assassin, Fighter","Mage, Fighter",4,0,4
992,Fighter,"Mage, Tank","Mage, Fighter","Mage, Fighter",2,2,4
4600,Marksman,"Mage, Assassin",Marksman,"Support, Mage",1,3,4
896,"Mage, Fighter",Mage,"Fighter, Mage",Marksman,1,3,4
898,"Tank, Mage","Fighter, Assassin","Tank, Fighter",Fighter,4,0,4
901,"Tank, Mage","Tank, Fighter","Fighter, Mage",Fighter,1,3,4
903,"Tank, Mage",Marksman,Tank,"Assassin, Fighter",4,0,4
907,Marksman,"Mage, Support","Mage, Fighter","Support, Tank",3,1,4
557,"Mage, Fighter","Fighter, Tank",Marksman,"Support, Tank",3,1,4
554,Fighter,"Support, Tank",Marksman,"Support, Fighter",2,2,4
551,"Fighter, Assassin","Support, Mage","Assassin, Fighter","Mage, Assassin",1,3,4
550,"Mage, Fighter","Mage, Support","Fighter, Assassin","Support, Fighter",3,1,4
926,"Mage, Fighter","Support, Tank","Fighter, Assassin","Support, Tank",3,1,4
4538,"Mage, Marksman","Mage, Support",Marksman,"Support, Mage",3,1,4
933,"Fighter, Assassin","Mage, Support",Fighter,"Assassin, Fighter",2,2,4
935,Marksman,"Mage, Assassin",Fighter,Marksman,2,2,4
937,"Tank, Mage","Mage, Support","Fighter, Mage",Marksman,0,4,4
544,"Mage, Fighter","Support, Fighter",Fighter,Support,4,0,4
541,"Mage, Fighter","Support, Fighter","Fighter, Assassin","Mage, Support",1,3,4
947,Marksman,"Mage, Fighter","Assassin, Fighter",Mage,2,2,4
949,"Assassin, Fighter","Tank, Support",Fighter,"Support, Tank",3,1,4
4564,"Marksman, Support","Support, Mage","Marksman, Assassin","Support, Tank",4,0,4
956,"Mage, Marksman","Fighter, Assassin","Fighter, Marksman","Mage, Fighter",2,2,4
958,"Assassin, Fighter","Mage, Support","Fighter, Mage","Support, Tank",2,2,4
539,Marksman,"Support, Fighter","Fighter, Assassin","Mage, Support",2,2,4
4587,"Marksman, Support","Tank, Support",Marksman,"Support, Mage",3,1,4
982,Tank,Fighter,"Assassin, Fighter","Fighter, Mage",0,4,4
983,Fighter,Mage,"Mage, Fighter","Support, Mage",4,0,4
9874,"Assassin, Fighter","Assassin, Mage","Assassin, Fighter",Mage,1,3,4
1309,Fighter,"Tank, Support","Assassin, Fighter","Support, Mage",3,1,4
9601,Marksman,"Mage, Tank","Mage, Fighter","Mage, Support",1,3,4
2573,"Mage, Fighter","Mage, Support","Fighter, Assassin",Mage,3,1,4
6332,"Tank, Mage","Tank, Fighter","Fighter, Tank","Mage, Fighter",3,1,4
1605,Marksman,"Tank, Support","Marksman, Support","Support, Mage",3,1,4
3536,Marksman,"Support, Mage","Fighter, Mage","Mage, Support",1,3,4
5977,"Assassin, Fighter",Fighter,"Fighter, Tank","Assassin, Fighter",2,2,4
349,Fighter,Support,"Fighter, Mage","Support, Fighter",2,2,4
6333,"Tank, Mage","Fighter, Assassin","Fighter, Tank","Mage, Fighter",1,3,4
6063,"Tank, Fighter","Assassin, Fighter","Fighter, Tank",Fighter,3,1,4
6336,"Fighter, Tank","Assassin, Fighter","Tank, Mage","Fighter, Assassin",2,2,4
1614,Marksman,Mage,"Mage, Fighter",Marksman,1,3,4
1618,"Fighter, Mage","Support, Mage",Marksman,"Support, Tank",2,2,4
5955,"Fighter, Assassin","Tank, Fighter","Fighter, Tank","Fighter, Assassin",1,3,4
1555,"Fighter, Mage","Support, Mage","Fighter, Assassin","Mage, Support",2,2,4
1664,"Tank, Fighter","Tank, Mage","Tank, Fighter",Marksman,0,4,4
330,"Marksman, Assassin","Mage, Support","Marksman, Support",Marksman,3,1,4
6353,Fighter,"Tank, Fighter","Fighter, Tank","Tank, Fighter",4,0,4
5942,Tank,"Tank, Fighter","Fighter, Tank","Fighter, Mage",4,0,4
5940,"Tank, Fighter","Tank, Fighter","Fighter, Tank","Assassin, Fighter",3,1,4
301,"Mage, Fighter","Support, Tank",Fighter,Support,1,3,4
1549,"Fighter, Mage",Support,"Tank, Fighter","Support, Fighter",4,0,4
6092,"Fighter, Mage","Tank, Fighter","Fighter, Tank","Fighter, Assassin",4,0,4
1666,Fighter,"Mage, Tank",Marksman,Mage,2,2,4
1632,"Fighter, Assassin","Support, Fighter","Mage, Fighter","Tank, Fighter",2,2,4
1665,"Fighter, Tank","Mage, Support","Tank, Fighter","Mage, Support",3,1,4
1535,"Tank, Mage",Marksman,"Tank, Fighter",Fighter,3,1,4
1670,"Fighter, Mage","Tank, Mage","Tank, Fighter","Mage, Support",4,0,4
1571,Marksman,"Support, Tank","Marksman, Assassin",Support,3,1,4
1671,"Tank, Fighter","Mage, Support","Assassin, Fighter","Tank, Mage",2,2,4
6198,"Fighter, Tank","Tank, Mage","Tank, Mage","Tank, Fighter",1,3,4
1594,"Mage, Fighter","Support, Tank","Fighter, Assassin","Support, Mage",2,2,4
1695,"Mage, Fighter","Mage, Support","Assassin, Fighter","Mage, Fighter",4,0,4
343,Fighter,"Tank, Support","Fighter, Mage","Fighter, Tank",1,3,4
1682,"Assassin, Fighter","Assassin, Fighter","Assassin, Fighter","Mage, Support",1,3,4
6005,"Fighter, Tank","Tank, Mage","Tank, Fighter","Fighter, Mage",2,2,4
1681,Fighter,"Support, Fighter","Mage, Fighter","Support, Mage",2,2,4
6211,"Fighter, Tank","Tank, Fighter","Fighter, Assassin","Fighter, Tank",3,1,4
6235,"Fighter, Assassin",Marksman,"Fighter, Tank",Fighter,1,3,4
1601,"Mage, Fighter",Mage,Fighter,"Mage, Assassin",3,1,4
3476,Fighter,Mage,"Tank, Fighter","Mage, Support",2,2,4
1708,"Marksman, Mage","Tank, Support","Marksman, Support","Support, Tank",3,1,4
1714,Marksman,"Support, Tank","Fighter, Mage","Support, Mage",2,2,4
6261,"Fighter, Tank","Mage, Fighter","Fighter, Tank",Marksman,2,2,4
1581,Fighter,"Mage, Support","Tank, Fighter","Mage, Support",1,3,4
1580,Fighter,"Support, Mage","Assassin, Fighter","Support, Fighter",2,2,4
6293,"Fighter, Assassin","Fighter, Tank","Fighter, Tank","Mage, Fighter",0,4,4
1722,"Assassin, Fighter","Support, Mage","Fighter, Mage","Tank, Support",2,2,4
345,"Fighter, Mage","Mage, Support",Fighter,"Fighter, Tank",3,1,4
1675,"Marksman, Assassin","Support, Tank","Marksman, Support","Fighter, Tank",1,3,4
1604,"Assassin, Fighter","Assassin, Mage","Fighter, Mage",Mage,2,2,4
1725,"Tank, Fighter",Fighter,"Tank, Fighter","Fighter, Assassin",3,1,4
5983,"Tank, Fighter","Mage, Fighter","Fighter, Assassin",Marksman,4,0,4
1726,"Assassin, Fighter","Mage, Support",Marksman,"Mage, Tank",2,2,4
1533,"Fighter, Mage",Marksman,"Tank, Fighter",Marksman,3,1,4
3467,"Fighter, Mage","Support, Mage","Assassin, Fighter","Support, Mage",3,1,4
6429,"Fighter, Mage","Fighter, Mage","Fighter, Tank","Assassin, Fighter",0,4,4
360,"Marksman, Support","Support, Fighter",Marksman,Support,2,2,4
1654,"Tank, Fighter",Marksman,"Fighter, Mage","Tank, Mage",3,1,4
5908,"Fighter, Assassin",Fighter,"Fighter, Tank","Tank, Fighter",2,2,4
1769,"Marksman, Assassin","Mage, Assassin",Marksman,"Support, Mage",1,3,4
1766,"Assassin, Fighter",Mage,"Mage, Fighter",Marksman,2,2,4
6454,"Tank, Fighter","Mage, Fighter","Tank, Mage",Fighter,3,1,4
1520,"Assassin, Fighter","Assassin, Mage","Fighter, Assassin",Mage,3,1,4
6144,"Tank, Fighter","Fighter, Mage","Tank, Mage","Assassin, Fighter",4,0,4
6162,"Fighter, Tank","Fighter, Assassin","Tank, Fighter","Tank, Fighter",2,2,4
1646,Marksman,Mage,"Marksman, Assassin","Support, Mage",3,1,4
5896,"Fighter, Assassin","Assassin, Fighter","Tank, Mage",Marksman,3,1,4
3372,"Assassin, Fighter","Support, Tank","Assassin, Fighter","Support, Mage",3,1,4
1513,"Marksman, Mage","Tank, Fighter","Marksman, Support","Mage, Support",4,0,4
3350,"Assassin, Fighter","Support, Fighter","Tank, Fighter","Support, Mage",3,1,4
9553,"Tank, Fighter","Mage, Support",Fighter,Marksman,4,0,4
1508,"Fighter, Mage","Assassin, Mage","Tank, Fighter","Mage, Support",3,1,4
6420,"Fighter, Tank","Assassin, Fighter",Tank,"Mage, Fighter",1,3,4
297,"Fighter, Mage",Fighter,"Tank, Mage","Assassin, Mage",3,1,4
1662,Marksman,"Mage, Support",Fighter,"Mage, Tank",1,3,4
3982,"Fighter, Assassin","Support, Tank","Mage, Fighter","Support, Mage",1,2,3
4633,"Marksman, Mage","Tank, Support","Marksman, Support","Support, Mage",3,0,3
2691,"Fighter, Tank","Support, Mage","Mage, Fighter","Support, Mage",0,3,3
3983,"Assassin, Fighter","Support, Mage","Support, Mage","Support, Mage",1,2,3
2752,Fighter,"Support, Mage","Assassin, Fighter",Marksman,1,2,3
4829,Marksman,Support,"Marksman, Mage","Tank, Support",1,2,3
6163,"Fighter, Assassin","Assassin, Fighter","Assassin, Fighter","Fighter, Assassin",0,3,3
8639,"Fighter, Mage","Mage, Support","Fighter, Assassin",Marksman,1,2,3
3984,"Fighter, Assassin","Support, Tank","Tank, Fighter","Support, Tank",2,1,3
3478,"Tank, Fighter","Tank, Support",Fighter,"Support, Fighter",0,3,3
4589,"Marksman, Support","Tank, Support","Marksman, Assassin","Support, Tank",2,1,3
2745,"Assassin, Fighter",Marksman,"Assassin, Fighter","Mage, Support",3,0,3
4574,Marksman,"Mage, Marksman","Marksman, Assassin","Tank, Support",0,3,3
3985,"Assassin, Fighter","Support, Tank","Fighter, Assassin",Support,2,1,3
4635,Marksman,"Support, Fighter","Marksman, Support","Support, Mage",1,2,3
4753,"Marksman, Mage","Tank, Support","Marksman, Assassin",Support,3,0,3
3469,Fighter,Mage,"Tank, Fighter","Support, Mage",2,1,3
6753,"Fighter, Assassin","Mage, Fighter","Fighter, Tank","Fighter, Tank",2,1,3
6200,"Fighter, Marksman","Tank, Fighter","Fighter, Tank","Assassin, Fighter",3,0,3
2686,"Assassin, Fighter","Support, Mage","Assassin, Fighter","Support, Tank",2,1,3
8749,"Fighter, Mage",Mage,"Mage, Fighter",Marksman,1,2,3
4632,"Marksman, Assassin","Tank, Support","Marksman, Support","Support, Tank",1,2,3
8631,"Assassin, Fighter",Mage,"Fighter, Assassin","Mage, Fighter",1,2,3
2760,"Mage, Fighter","Mage, Support",Marksman,"Tank, Support",1,2,3
4592,"Marksman, Assassin","Support, Fighter","Marksman, Support","Tank, Support",2,1,3
4593,"Marksman, Support","Fighter, Tank",Marksman,"Support, Mage",3,0,3
4803,Marksman,"Mage, Marksman",Marksman,"Support, Fighter",1,2,3
6725,"Fighter, Tank","Fighter, Mage","Mage, Tank",Fighter,1,2,3
6881,"Fighter, Tank","Tank, Fighter","Fighter, Tank","Fighter, Assassin",3,0,3
6156,Tank,"Assassin, Fighter","Fighter, Tank","Fighter, Mage",1,2,3
4609,Marksman,"Mage, Assassin","Marksman, Assassin","Mage, Support",0,3,3
3245,"Fighter, Assassin","Support, Mage",Fighter,"Mage, Support",2,1,3
6210,"Fighter, Tank","Tank, Mage","Fighter, Mage","Tank, Fighter",3,0,3
4621,"Marksman, Support","Mage, Support","Marksman, Mage","Tank, Fighter",1,2,3
4795,"Marksman, Mage","Support, Fighter","Marksman, Assassin","Support, Fighter",2,1,3
4631,Marksman,"Mage, Support","Marksman, Assassin","Fighter, Tank",0,3,3
3240,Fighter,"Mage, Support","Assassin, Fighter","Tank, Support",2,1,3
3475,"Assassin, Fighter",Mage,"Fighter, Assassin","Support, Fighter",2,1,3
4646,Marksman,"Tank, Support","Marksman, Mage",Support,2,1,3
4074,"Tank, Fighter","Tank, Support","Fighter, Assassin","Support, Tank",2,1,3
4588,"Marksman, Support","Support, Mage",Marksman,"Tank, Support",0,3,3
3497,"Assassin, Fighter","Support, Fighter",Marksman,"Support, Mage",2,1,3
2685,"Mage, Marksman","Tank, Fighter","Tank, Mage","Tank, Fighter",3,0,3
4576,"Marksman, Assassin",Support,Marksman,"Support, Mage",2,1,3
4000,"Mage, Fighter","Mage, Assassin","Support, Mage","Mage, Support",1,2,3
6165,"Fighter, Tank",Marksman,"Fighter, Mage","Fighter, Assassin",2,1,3
6765,"Tank, Fighter","Tank, Mage","Fighter, Tank",Fighter,2,1,3
2717,Fighter,"Support, Mage","Fighter, Assassin","Tank, Support",3,0,3
4690,"Marksman, Support","Mage, Support",Marksman,"Tank, Support",0,3,3
6178,"Tank, Fighter",Fighter,"Fighter, Tank","Tank, Fighter",0,3,3
8648,Marksman,"Assassin, Mage","Assassin, Fighter",Mage,1,2,3
4691,"Marksman, Assassin","Mage, Support","Marksman, Support","Tank, Support",1,2,3
3217,"Fighter, Assassin","Support, Fighter",Fighter,"Mage, Support",3,0,3
4743,Marksman,Mage,"Marksman, Mage","Mage, Support",2,1,3
2737,"Mage, Fighter","Mage, Support",Fighter,"Mage, Assassin",2,1,3
8656,"Tank, Mage","Mage, Support","Fighter, Mage",Mage,1,2,3
4698,"Marksman, Support","Tank, Fighter","Marksman, Mage","Support, Mage",2,1,3
2735,Fighter,"Support, Tank","Mage, Fighter","Support, Mage",1,2,3
3216,Fighter,Mage,"Fighter, Tank","Mage, Assassin",2,1,3
8646,"Assassin, Fighter","Mage, Support","Fighter, Mage","Assassin, Fighter",2,1,3
8682,"Assassin, Fighter","Mage, Assassin","Assassin, Fighter","Mage, Tank",1,2,3
4013,"Fighter, Assassin","Support, Tank",Marksman,"Support, Mage",2,1,3
2723,Fighter,"Support, Mage","Tank, Fighter","Support, Tank",1,2,3
8659,"Tank, Mage",Mage,"Fighter, Mage","Mage, Support",2,1,3
4702,"Marksman, Assassin","Fighter, Tank",Marksman,"Support, Mage",3,0,3
8667,"Fighter, Assassin","Mage, Fighter",Marksman,Mage,3,0,3
4724,"Marksman, Mage",Support,Marksman,"Support, Fighter",1,2,3
4005,"Mage, Fighter","Tank, Support","Assassin, Fighter","Support, Tank",3,0,3
8663,"Assassin, Fighter",Mage,"Mage, Fighter","Mage, Assassin",2,1,3
3998,"Assassin, Fighter","Tank, Support","Fighter, Assassin","Support, Mage",3,0,3
8693,"Fighter, Mage","Assassin, Mage","Mage, Fighter",Mage,0,3,3
4024,"Assassin, Fighter","Tank, Support","Assassin, Fighter","Support, Fighter",1,2,3
6716,"Tank, Fighter","Fighter, Tank","Tank, Mage","Assassin, Fighter",2,1,3
2709,"Assassin, Fighter",Mage,"Mage, Fighter","Support, Mage",0,3,3
2742,"Support, Mage","Mage, Support",Fighter,"Mage, Assassin",2,1,3
4658,"Marksman, Assassin","Support, Fighter",Marksman,"Support, Fighter",2,1,3
3215,Fighter,"Mage, Assassin","Mage, Fighter",Mage,3,0,3
4659,"Marksman, Support","Support, Mage",Marksman,"Support, Fighter",2,1,3
6176,"Fighter, Mage",Fighter,Tank,"Fighter, Tank",2,1,3
2700,"Fighter, Assassin","Support, Fighter","Assassin, Fighter","Mage, Support",1,2,3
3212,Marksman,Mage,"Fighter, Assassin","Assassin, Mage",3,0,3
2701,"Fighter, Mage",Mage,"Assassin, Fighter","Tank, Support",2,1,3
4664,Marksman,"Fighter, Tank",Marksman,"Tank, Fighter",1,2,3
4747,"Marksman, Assassin","Support, Mage","Marksman, Assassin","Support, Tank",0,3,3
8710,"Tank, Fighter","Fighter, Marksman",Fighter,Mage,0,3,3
6782,"Fighter, Tank","Fighter, Tank","Fighter, Tank","Assassin, Fighter",0,3,3
4037,Fighter,"Support, Tank","Fighter, Tank","Tank, Support",3,0,3
6194,"Mage, Fighter",Fighter,"Fighter, Tank","Mage, Fighter",2,1,3
3483,"Fighter, Assassin","Support, Fighter","Fighter, Assassin","Support, Mage",1,2,3
4683,"Marksman, Assassin","Mage, Support","Marksman, Mage","Tank, Fighter",2,1,3
3995,"Tank, Fighter","Support, Fighter","Fighter, Mage","Mage, Support",3,0,3
6787,"Mage, Marksman","Assassin, Fighter","Fighter, Mage","Fighter, Assassin",2,1,3
4686,"Marksman, Mage","Tank, Fighter","Marksman, Assassin","Support, Tank",1,2,3
4689,"Marksman, Mage","Tank, Support",Marksman,"Tank, Support",1,2,3
8696,"Mage, Fighter",Mage,"Fighter, Mage",Mage,2,1,3
3612,"Fighter, Tank","Mage, Support",Marksman,"Mage, Support",1,2,3
6240,"Tank, Fighter","Fighter, Mage","Assassin, Fighter",Marksman,2,1,3
4572,"Marksman, Support","Tank, Support","Marksman, Assassin","Support, Fighter",2,1,3
6574,"Tank, Fighter","Mage, Marksman",Fighter,"Mage, Assassin",2,1,3
2593,"Assassin, Fighter","Fighter, Mage","Fighter, Tank","Mage, Fighter",1,2,3
2594,"Tank, Fighter","Assassin, Fighter",Tank,"Assassin, Fighter",2,1,3
4415,Marksman,"Support, Mage","Marksman, Mage",Mage,2,1,3
6551,"Tank, Mage","Assassin, Fighter","Tank, Mage","Tank, Fighter",2,1,3
2597,"Marksman, Assassin","Support, Tank",Marksman,Mage,1,2,3
2598,Tank,"Assassin, Fighter","Fighter, Mage","Fighter, Assassin",2,1,3
3383,"Support, Mage","Support, Mage","Mage, Fighter","Mage, Support",3,0,3
8829,"Fighter, Tank","Mage, Assassin","Mage, Fighter","Mage, Support",1,2,3
6391,"Fighter, Mage",Marksman,"Fighter, Tank","Fighter, Assassin",1,2,3
2602,"Fighter, Marksman",Marksman,"Fighter, Mage","Fighter, Assassin",2,1,3
3388,"Assassin, Fighter","Support, Tank","Assassin, Fighter","Tank, Support",2,1,3
6388,"Tank, Fighter","Fighter, Mage","Tank, Mage",Fighter,1,2,3
3311,"Mage, Fighter","Support, Mage","Assassin, Fighter","Tank, Support",3,0,3
6577,Fighter,"Assassin, Fighter","Fighter, Mage","Fighter, Assassin",2,1,3
2619,Tank,"Mage, Fighter","Tank, Fighter","Fighter, Assassin",2,1,3
4426,"Marksman, Mage","Support, Tank",Marksman,Mage,1,2,3
2607,"Fighter, Mage","Assassin, Fighter","Tank, Fighter","Mage, Fighter",2,1,3
4432,"Marksman, Mage","Mage, Assassin","Marksman, Mage","Support, Mage",1,2,3
2608,"Mage, Marksman",Marksman,"Fighter, Mage","Fighter, Assassin",2,1,3
6374,"Fighter, Assassin","Mage, Fighter","Fighter, Mage","Assassin, Fighter",3,0,3
3396,Fighter,"Support, Mage","Mage, Fighter","Support, Mage",3,0,3
6361,"Fighter, Assassin","Assassin, Fighter","Tank, Fighter","Fighter, Assassin",2,1,3
3306,"Fighter, Mage","Support, Tank","Tank, Mage","Support, Fighter",3,0,3
2610,"Mage, Fighter","Mage, Support","Support, Mage","Mage, Assassin",1,2,3
2615,"Tank, Mage","Assassin, Fighter",Tank,"Assassin, Fighter",3,0,3
4436,"Marksman, Mage","Mage, Support","Marksman, Mage","Mage, Support",1,2,3
2616,"Assassin, Fighter","Mage, Support","Support, Mage","Support, Fighter",1,2,3
4442,Marksman,"Support, Tank","Marksman, Mage",Tank,2,1,3
4414,"Marksman, Assassin","Support, Mage","Marksman, Mage","Tank, Support",3,0,3
3378,"Assassin, Fighter","Mage, Support",Fighter,"Tank, Fighter",2,1,3
4168,"Fighter, Tank","Support, Mage","Assassin, Fighter","Mage, Support",3,0,3
4404,Marksman,"Support, Mage","Marksman, Assassin","Tank, Fighter",2,1,3
3347,"Tank, Fighter","Support, Mage","Tank, Fighter","Tank, Fighter",2,1,3
6506,"Fighter, Tank","Mage, Fighter","Fighter, Mage","Fighter, Tank",1,2,3
4224,"Tank, Fighter","Mage, Support","Fighter, Assassin","Support, Fighter",2,1,3
6504,"Fighter, Tank",Fighter,"Fighter, Tank","Fighter, Tank",2,1,3
8840,"Fighter, Mage","Marksman, Mage","Mage, Fighter","Assassin, Mage",2,1,3
4226,"Assassin, Fighter","Support, Fighter",Fighter,"Tank, Support",2,1,3
4211,Fighter,"Support, Mage","Assassin, Fighter",Mage,2,1,3
6517,"Tank, Fighter","Assassin, Mage","Fighter, Assassin","Assassin, Fighter",1,2,3
2580,Tank,Fighter,"Fighter, Tank","Fighter, Tank",2,1,3
2581,"Fighter, Mage",Marksman,"Mage, Marksman","Assassin, Fighter",1,2,3
4280,Fighter,Mage,"Fighter, Mage","Support, Mage",0,3,3
4326,"Mage, Fighter","Tank, Support","Fighter, Tank","Support, Mage",2,1,3
4190,"Tank, Fighter","Tank, Support","Tank, Fighter",Support,0,3,3
2584,"Marksman, Mage","Mage, Support","Marksman, Mage","Support, Fighter",2,1,3
2585,"Fighter, Mage","Mage, Support","Mage, Fighter","Support, Fighter",1,2,3
2586,"Assassin, Fighter","Mage, Assassin","Fighter, Tank","Support, Mage",3,0,3
6525,"Tank, Fighter","Assassin, Mage","Assassin, Fighter","Mage, Support",3,0,3
3334,"Tank, Fighter",Mage,"Tank, Fighter","Tank, Support",1,2,3
4189,"Fighter, Assassin","Support, Mage","Assassin, Fighter","Tank, Support",2,1,3
4356,"Tank, Fighter","Mage, Support","Tank, Fighter",Mage,3,0,3
3351,"Assassin, Fighter","Tank, Support","Assassin, Fighter","Support, Tank",3,0,3
6476,"Fighter, Tank","Assassin, Fighter","Tank, Mage","Tank, Fighter",1,2,3
6539,"Fighter, Assassin","Assassin, Fighter",Fighter,"Assassin, Mage",2,1,3
6467,Tank,"Tank, Fighter","Tank, Mage","Assassin, Fighter",3,0,3
6433,Tank,Fighter,"Tank, Fighter","Fighter, Tank",3,0,3
2589,"Fighter, Tank","Assassin, Fighter",Tank,Marksman,1,2,3
4170,"Fighter, Assassin","Mage, Assassin","Assassin, Fighter",Mage,3,0,3
6347,"Tank, Fighter","Fighter, Tank","Fighter, Tank","Tank, Fighter",2,1,3
2621,"Fighter, Assassin","Support, Tank","Mage, Fighter","Support, Fighter",1,2,3
6218,"Fighter, Tank","Mage, Fighter","Assassin, Fighter","Assassin, Fighter",2,1,3
6238,"Tank, Mage","Mage, Fighter","Assassin, Fighter",Marksman,0,3,3
6266,"Tank, Fighter",Fighter,"Tank, Fighter","Assassin, Fighter",1,2,3
2642,"Fighter, Tank",Marksman,"Tank, Fighter",Fighter,2,1,3
4522,Marksman,Mage,"Marksman, Assassin","Mage, Support",1,2,3
6650,"Fighter, Marksman","Tank, Fighter","Fighter, Tank","Fighter, Mage",1,2,3
6247,"Tank, Fighter",Marksman,"Tank, Fighter",Fighter,2,1,3
3452,"Tank, Fighter","Mage, Support","Fighter, Mage","Tank, Fighter",2,1,3
8774,"Mage, Fighter","Mage, Marksman",Marksman,"Assassin, Fighter",2,1,3
4533,"Marksman, Mage","Tank, Support","Marksman, Mage","Support, Fighter",3,0,3
8765,"Mage, Fighter","Assassin, Fighter",Fighter,Mage,1,2,3
8763,"Assassin, Fighter","Mage, Marksman",Fighter,Mage,2,1,3
4842,"Marksman, Assassin","Support, Mage","Marksman, Mage","Support, Fighter",1,2,3
6239,"Tank, Fighter",Marksman,"Tank, Mage","Fighter, Mage",1,2,3
3271,"Assassin, Fighter","Mage, Support","Fighter, Assassin","Tank, Fighter",2,1,3
4541,"Marksman, Assassin","Support, Fighter","Marksman, Mage","Tank, Fighter",0,3,3
3408,"Mage, Fighter","Support, Mage","Fighter, Assassin","Support, Tank",3,0,3
2654,"Support, Mage","Support, Fighter",Marksman,"Support, Tank",3,0,3
6667,"Fighter, Mage","Fighter, Assassin","Fighter, Mage","Assassin, Fighter",2,1,3
6670,Tank,"Assassin, Fighter","Fighter, Mage","Assassin, Fighter",2,1,3
6704,"Fighter, Tank","Fighter, Mage","Fighter, Tank","Tank, Mage",3,0,3
6229,Tank,"Assassin, Fighter","Fighter, Mage","Mage, Fighter",3,0,3
2657,"Mage, Fighter","Mage, Support","Support, Mage","Support, Mage",0,3,3
4548,Marksman,Support,Marksman,"Tank, Support",2,1,3
8755,"Mage, Fighter","Mage, Support","Tank, Fighter",Marksman,1,2,3
2664,Marksman,"Mage, Support","Fighter, Assassin","Mage, Assassin",3,0,3
4549,"Marksman, Mage","Tank, Support",Marksman,Support,3,0,3
4555,"Marksman, Support","Tank, Fighter","Marksman, Mage","Mage, Support",3,0,3
3254,"Fighter, Assassin","Mage, Support",Fighter,"Support, Tank",2,1,3
3465,Fighter,"Support, Tank","Assassin, Fighter","Mage, Support",2,1,3
3426,Fighter,"Tank, Support","Mage, Fighter","Support, Mage",3,0,3
4495,"Marksman, Mage","Fighter, Tank","Marksman, Assassin","Support, Tank",1,2,3
4111,"Fighter, Assassin","Support, Tank","Assassin, Fighter","Support, Mage",2,1,3
4114,"Support, Mage","Mage, Support",Marksman,"Support, Mage",2,1,3
3409,"Fighter, Assassin","Tank, Fighter","Assassin, Fighter","Mage, Support",2,1,3
6610,Fighter,"Assassin, Mage","Tank, Fighter",Mage,2,1,3
6345,"Tank, Fighter","Tank, Fighter",Tank,"Tank, Fighter",2,1,3
6614,"Tank, Fighter","Mage, Marksman","Fighter, Mage","Marksman, Mage",2,1,3
6340,"Tank, Mage","Assassin, Fighter","Tank, Fighter","Tank, Fighter",1,2,3
3293,"Fighter, Assassin","Mage, Support",Marksman,"Mage, Fighter",2,1,3
8802,"Mage, Fighter","Assassin, Mage","Fighter, Assassin","Mage, Support",1,2,3
4136,"Assassin, Fighter","Mage, Assassin","Fighter, Mage","Support, Mage",2,1,3
3414,"Mage, Fighter","Support, Fighter","Fighter, Assassin","Support, Mage",2,1,3
3290,"Assassin, Fighter","Mage, Support","Support, Mage",Mage,0,3,3
4459,"Marksman, Mage","Fighter, Tank",Marksman,"Support, Fighter",3,0,3
2627,Marksman,"Support, Mage","Assassin, Fighter","Mage, Assassin",0,3,3
8800,Marksman,"Support, Mage",Fighter,Mage,2,1,3
8797,Marksman,"Mage, Assassin","Mage, Fighter",Mage,2,1,3
4465,"Marksman, Assassin","Support, Tank","Marksman, Mage",Support,3,0,3
3420,"Fighter, Tank","Mage, Support","Assassin, Fighter","Support, Mage",2,1,3
4127,"Mage, Fighter","Mage, Support","Assassin, Fighter",Marksman,2,1,3
2634,"Mage, Fighter","Tank, Fighter","Fighter, Assassin","Support, Mage",2,1,3
4469,"Marksman, Assassin","Fighter, Tank",Marksman,"Mage, Support",2,1,3
4125,"Fighter, Mage","Support, Mage",Marksman,"Tank, Support",1,2,3
6331,"Tank, Mage","Fighter, Assassin","Fighter, Assassin","Assassin, Fighter",0,3,3
6623,"Tank, Fighter","Assassin, Fighter","Tank, Fighter","Assassin, Mage",2,1,3
3425,"Mage, Fighter","Support, Fighter","Tank, Fighter","Tank, Support",2,1,3
4124,"Assassin, Fighter","Mage, Assassin",Marksman,Marksman,2,1,3
2636,Marksman,"Support, Tank","Marksman, Assassin","Mage, Assassin",1,2,3
4477,"Marksman, Support","Mage, Assassin",Marksman,"Mage, Support",2,1,3
4479,"Marksman, Assassin","Mage, Assassin",Marksman,"Mage, Support",2,1,3
4839,"Marksman, Support","Support, Mage","Marksman, Assassin","Support, Mage",3,0,3
2782,"Assassin, Fighter","Support, Mage",Fighter,"Support, Mage",2,1,3
3956,"Assassin, Fighter","Tank, Support","Mage, Fighter","Support, Fighter",3,0,3
3567,Marksman,"Mage, Support",Fighter,Marksman,2,1,3
5728,"Mage, Marksman",Fighter,"Fighter, Tank","Mage, Fighter",1,2,3
5970,"Assassin, Fighter","Fighter, Mage","Tank, Mage","Assassin, Fighter",2,1,3
8337,"Fighter, Mage","Mage, Support","Assassin, Fighter","Mage, Assassin",2,1,3
8305,"Tank, Mage","Mage, Fighter","Fighter, Tank",Marksman,3,0,3
2940,"Fighter, Mage",Mage,Fighter,"Support, Mage",1,2,3
5731,"Fighter, Assassin","Fighter, Mage","Tank, Fighter","Fighter, Assassin",1,2,3
5960,"Tank, Fighter",Fighter,"Tank, Mage","Fighter, Mage",3,0,3
7231,"Fighter, Tank","Tank, Fighter","Fighter, Tank","Assassin, Fighter",2,1,3
2946,"Tank, Fighter","Support, Tank","Fighter, Assassin","Support, Tank",1,2,3
8024,"Assassin, Fighter",Marksman,"Fighter, Tank","Assassin, Fighter",2,1,3
2957,"Tank, Fighter","Tank, Fighter","Fighter, Mage","Support, Mage",1,2,3
5734,"Fighter, Tank","Fighter, Mage","Tank, Mage","Fighter, Tank",2,1,3
3701,Marksman,"Tank, Fighter","Assassin, Fighter","Mage, Support",3,0,3
7259,"Fighter, Tank",Fighter,"Tank, Fighter","Tank, Fighter",1,2,3
5737,"Tank, Mage",Marksman,"Fighter, Assassin","Mage, Fighter",1,2,3
3698,"Assassin, Fighter","Mage, Support","Mage, Fighter","Support, Tank",1,2,3
5946,"Fighter, Mage","Assassin, Fighter","Fighter, Tank","Tank, Fighter",1,2,3
7266,"Support, Mage",Fighter,"Tank, Mage","Tank, Fighter",1,2,3
3695,Fighter,"Support, Fighter","Fighter, Tank","Support, Tank",0,3,3
7924,"Fighter, Mage","Tank, Mage","Tank, Fighter","Mage, Fighter",3,0,3
2967,"Assassin, Fighter",Mage,Fighter,"Support, Fighter",2,1,3
7913,"Fighter, Mage","Assassin, Fighter","Tank, Mage","Fighter, Assassin",1,2,3
7867,"Fighter, Tank","Fighter, Mage",Tank,"Fighter, Assassin",1,2,3
3689,"Assassin, Fighter","Tank, Support","Fighter, Mage","Fighter, Tank",2,1,3
5943,"Fighter, Assassin","Assassin, Fighter","Fighter, Mage",Fighter,3,0,3
7840,"Tank, Fighter","Mage, Fighter","Fighter, Mage",Marksman,2,1,3
5755,"Tank, Mage","Mage, Fighter","Tank, Fighter",Fighter,1,2,3
2976,Marksman,"Tank, Support","Fighter, Assassin","Support, Mage",0,3,3
3106,"Fighter, Assassin",Mage,"Tank, Fighter","Mage, Support",2,1,3
2925,Marksman,"Mage, Support","Mage, Fighter","Tank, Support",1,2,3
3118,"Mage, Fighter","Tank, Support","Assassin, Fighter","Support, Mage",3,0,3
3751,"Tank, Fighter",Support,"Fighter, Mage","Support, Fighter",1,2,3
5725,"Fighter, Tank",Marksman,"Tank, Mage","Assassin, Fighter",0,3,3
5653,"Fighter, Mage","Mage, Fighter","Tank, Fighter","Assassin, Fighter",2,1,3
8406,Marksman,"Mage, Fighter",Fighter,Mage,2,1,3
3125,"Tank, Fighter",Support,"Fighter, Mage","Support, Tank",1,2,3
5998,"Tank, Mage","Tank, Fighter","Tank, Fighter","Fighter, Mage",2,1,3
5658,"Tank, Fighter","Fighter, Assassin","Fighter, Assassin","Mage, Fighter",1,2,3
5666,"Fighter, Assassin",Fighter,Tank,"Fighter, Mage",3,0,3
5667,"Fighter, Assassin",Fighter,"Tank, Fighter","Fighter, Mage",1,2,3
8402,Marksman,"Mage, Tank",Fighter,"Mage, Support",1,2,3
5668,"Fighter, Mage",Fighter,"Fighter, Assassin","Fighter, Tank",2,1,3
5994,"Tank, Fighter","Assassin, Fighter",Tank,Fighter,0,3,3
5990,"Fighter, Tank","Mage, Fighter","Support, Tank",Fighter,1,2,3
3122,"Fighter, Mage","Mage, Support","Tank, Fighter","Support, Tank",1,2,3
3732,Fighter,"Tank, Support","Tank, Fighter","Tank, Fighter",1,2,3
8395,"Fighter, Tank",Mage,Fighter,"Assassin, Mage",1,2,3
7216,"Fighter, Tank","Tank, Mage","Fighter, Tank","Tank, Fighter",0,3,3
5681,"Tank, Fighter",Fighter,"Fighter, Tank","Fighter, Mage",3,0,3
3120,"Fighter, Assassin","Support, Fighter","Tank, Fighter",Support,0,3,3
5685,"Fighter, Mage","Assassin, Fighter","Assassin, Fighter","Fighter, Assassin",1,2,3
5689,"Fighter, Marksman","Tank, Fighter","Fighter, Tank","Mage, Fighter",1,2,3
5984,Tank,Fighter,"Fighter, Assassin","Fighter, Mage",1,2,3
5695,"Fighter, Marksman","Mage, Fighter","Fighter, Tank",Fighter,2,1,3
8384,Marksman,Mage,"Mage, Fighter","Assassin, Fighter",1,2,3
8377,"Tank, Fighter","Support, Mage","Fighter, Mage",Mage,2,1,3
8365,Marksman,Mage,Fighter,"Assassin, Mage",2,1,3
5697,Tank,"Tank, Fighter","Fighter, Tank","Tank, Mage",3,0,3
5698,Tank,"Fighter, Assassin","Fighter, Tank",Fighter,2,1,3
8363,"Fighter, Mage",Marksman,Fighter,Mage,1,2,3
5701,"Fighter, Mage","Tank, Fighter","Fighter, Assassin","Tank, Fighter",1,2,3
3710,"Tank, Fighter","Support, Mage","Tank, Fighter",Mage,2,1,3
3685,"Mage, Fighter","Support, Mage","Fighter, Mage","Tank, Support",1,2,3
7301,"Fighter, Mage","Assassin, Fighter","Tank, Fighter","Fighter, Tank",1,2,3
5936,"Tank, Fighter",Fighter,"Fighter, Tank","Fighter, Assassin",3,0,3
3673,Fighter,"Support, Mage","Fighter, Assassin","Support, Tank",1,2,3
3635,"Assassin, Fighter","Mage, Support","Tank, Fighter","Support, Mage",2,1,3
5850,"Fighter, Tank","Fighter, Assassin","Tank, Mage","Fighter, Mage",1,2,3
7335,"Fighter, Tank","Fighter, Tank","Fighter, Assassin","Fighter, Mage",1,2,3
5853,"Fighter, Assassin","Assassin, Fighter","Tank, Fighter","Fighter, Mage",1,2,3
5857,"Fighter, Assassin","Assassin, Fighter","Tank, Fighter",Fighter,2,1,3
7577,"Fighter, Tank","Tank, Fighter","Fighter, Mage","Assassin, Fighter",1,2,3
3027,"Fighter, Mage","Tank, Support","Tank, Fighter","Mage, Support",2,1,3
3028,"Tank, Fighter","Tank, Support","Tank, Fighter","Mage, Support",2,1,3
7364,"Fighter, Mage","Mage, Fighter","Tank, Mage","Assassin, Fighter",3,0,3
3031,Marksman,"Mage, Support","Assassin, Fighter","Support, Fighter",1,2,3
3033,"Assassin, Fighter","Assassin, Mage","Tank, Fighter","Mage, Marksman",3,0,3
5876,"Tank, Fighter","Assassin, Fighter","Fighter, Tank","Support, Mage",1,2,3
7385,Tank,"Fighter, Tank","Fighter, Tank","Mage, Fighter",2,1,3
3034,"Tank, Fighter","Mage, Support","Tank, Fighter","Mage, Marksman",3,0,3
3035,"Tank, Fighter",Mage,"Fighter, Tank","Mage, Marksman",2,1,3
7551,Mage,"Tank, Fighter","Fighter, Tank",Fighter,1,2,3
3071,"Tank, Fighter","Mage, Support","Tank, Fighter","Support, Mage",1,2,3
3066,"Assassin, Fighter","Tank, Mage","Fighter, Assassin","Mage, Support",1,2,3
5883,"Tank, Fighter","Fighter, Assassin",Fighter,"Assassin, Fighter",3,0,3
3039,"Mage, Fighter","Support, Tank","Tank, Fighter","Support, Tank",1,2,3
3040,Marksman,"Support, Tank","Fighter, Tank","Mage, Support",2,1,3
3046,Marksman,"Support, Mage","Fighter, Assassin","Support, Tank",0,3,3
3616,"Support, Mage","Mage, Support",Marksman,"Mage, Support",1,2,3
3049,Marksman,"Support, Tank","Assassin, Fighter","Support, Tank",2,1,3
3611,Marksman,"Mage, Support","Mage, Fighter","Mage, Assassin",1,2,3
3615,"Fighter, Assassin","Mage, Support",Fighter,"Mage, Assassin",3,0,3
3051,"Fighter, Assassin","Support, Mage","Fighter, Mage","Support, Tank",2,1,3
3063,"Assassin, Fighter","Support, Fighter","Assassin, Fighter","Support, Mage",3,0,3
7505,"Mage, Fighter",Fighter,"Assassin, Fighter",Marksman,2,1,3
5921,"Mage, Marksman","Tank, Fighter","Fighter, Tank","Tank, Fighter",2,1,3
5834,"Fighter, Tank","Assassin, Fighter","Fighter, Assassin","Fighter, Mage",2,1,3
3084,"Tank, Fighter",Mage,"Assassin, Mage","Mage, Assassin",2,1,3
3659,"Fighter, Assassin","Tank, Fighter","Mage, Fighter","Mage, Support",2,1,3
2986,"Support, Mage","Mage, Assassin","Fighter, Assassin","Mage, Support",0,3,3
3670,"Fighter, Tank","Support, Mage","Fighter, Assassin","Support, Tank",3,0,3
3097,"Tank, Fighter","Support, Tank","Fighter, Assassin","Support, Mage",0,3,3
2990,Marksman,"Support, Mage",Fighter,"Tank, Support",2,1,3
3668,"Fighter, Mage","Support, Tank","Tank, Fighter","Support, Tank",1,2,3
3095,"Fighter, Assassin","Support, Mage","Tank, Fighter",Mage,0,3,3
5789,"Support, Tank",Marksman,"Tank, Fighter","Assassin, Fighter",1,2,3
7306,"Fighter, Tank","Fighter, Assassin","Fighter, Mage","Fighter, Mage",1,2,3
5933,"Fighter, Tank",Fighter,Mage,"Fighter, Tank",1,2,3
5928,"Mage, Marksman",Fighter,"Fighter, Tank","Tank, Fighter",2,1,3
3003,Fighter,"Support, Mage","Assassin, Fighter","Support, Mage",3,0,3
3665,"Mage, Fighter","Support, Tank","Tank, Fighter","Support, Fighter",2,1,3
5793,"Tank, Fighter",Marksman,"Fighter, Assassin","Assassin, Fighter",3,0,3
7674,"Fighter, Tank","Tank, Fighter","Fighter, Marksman","Fighter, Mage",2,1,3
5830,"Tank, Mage","Mage, Fighter","Fighter, Mage","Fighter, Assassin",3,0,3
5803,"Fighter, Tank",Marksman,Tank,"Fighter, Mage",2,1,3
7667,"Fighter, Tank","Fighter, Tank","Fighter, Tank",Fighter,1,2,3
3591,Marksman,"Support, Fighter","Mage, Fighter","Support, Mage",3,0,3
7649,"Fighter, Tank","Mage, Fighter","Tank, Fighter","Fighter, Assassin",3,0,3
3656,"Mage, Fighter","Mage, Assassin",Marksman,"Mage, Support",2,1,3
7646,"Tank, Fighter","Assassin, Fighter",Fighter,"Mage, Fighter",0,3,3
5811,Tank,"Tank, Fighter","Fighter, Tank","Tank, Fighter",2,1,3
7637,"Fighter, Mage","Assassin, Fighter","Assassin, Fighter",Marksman,2,1,3
7323,"Fighter, Mage",Marksman,"Fighter, Tank","Support, Mage",2,1,3
5826,"Tank, Mage","Tank, Fighter",Fighter,"Fighter, Mage",1,2,3
7324,"Fighter, Tank",Marksman,"Tank, Fighter","Assassin, Fighter",1,2,3
3592,"Assassin, Fighter","Support, Tank",Marksman,"Support, Tank",2,1,3
5828,"Tank, Mage","Mage, Fighter","Tank, Fighter","Fighter, Assassin",2,1,3
7210,Fighter,"Mage, Fighter","Fighter, Tank","Fighter, Mage",2,1,3
5644,"Fighter, Assassin","Assassin, Fighter","Fighter, Assassin",Fighter,3,0,3
2766,"Support, Mage","Mage, Support","Assassin, Fighter","Support, Mage",1,2,3
2798,"Assassin, Fighter","Tank, Support",Marksman,"Mage, Support",3,0,3
6132,"Fighter, Assassin","Assassin, Fighter","Fighter, Mage","Fighter, Assassin",2,1,3
8555,"Mage, Fighter","Mage, Support","Tank, Fighter","Mage, Support",2,1,3
5073,"Fighter, Tank","Mage, Support","Fighter, Mage",Mage,1,2,3
6936,"Tank, Mage","Tank, Fighter","Tank, Mage",Fighter,2,1,3
2810,"Tank, Fighter","Support, Fighter","Tank, Mage","Tank, Support",2,1,3
8537,"Assassin, Fighter","Mage, Assassin","Fighter, Assassin","Assassin, Fighter",1,2,3
6124,"Fighter, Tank","Fighter, Mage","Tank, Fighter","Support, Mage",2,1,3
2818,"Tank, Fighter","Support, Mage","Tank, Mage","Support, Fighter",1,2,3
6117,Tank,"Assassin, Fighter","Tank, Fighter","Support, Mage",1,2,3
5110,"Tank, Fighter","Mage, Support","Assassin, Fighter","Mage, Assassin",1,2,3
5115,Marksman,"Mage, Support",Fighter,"Mage, Support",2,1,3
5117,"Fighter, Tank","Mage, Support","Assassin, Fighter",Mage,0,3,3
6094,"Tank, Mage","Assassin, Fighter","Fighter, Tank","Assassin, Fighter",1,2,3
6940,"Fighter, Assassin","Tank, Fighter","Mage, Marksman","Tank, Fighter",1,2,3
5174,"Fighter, Tank",Marksman,"Assassin, Fighter","Mage, Support",0,3,3
6942,Tank,"Fighter, Mage","Fighter, Tank","Tank, Fighter",3,0,3
5179,"Fighter, Tank","Mage, Support","Mage, Fighter",Mage,0,3,3
5288,"Mage, Fighter","Mage, Support","Assassin, Fighter","Mage, Marksman",2,1,3
5339,Marksman,"Mage, Assassin","Marksman, Assassin","Support, Mage",2,1,3
3522,"Fighter, Assassin","Tank, Support",Fighter,"Support, Mage",3,0,3
8525,"Tank, Mage","Mage, Support","Tank, Mage","Mage, Support",2,1,3
3528,Fighter,"Support, Fighter","Tank, Fighter","Support, Tank",2,1,3
6074,"Fighter, Mage","Assassin, Fighter","Fighter, Assassin","Fighter, Assassin",1,2,3
2827,"Tank, Fighter",Support,"Fighter, Mage","Mage, Support",2,1,3
3875,Fighter,"Support, Mage",Marksman,Mage,2,1,3
8511,Marksman,"Assassin, Fighter","Assassin, Fighter","Assassin, Mage",2,1,3
8506,"Assassin, Fighter","Mage, Support","Assassin, Fighter",Mage,2,1,3
8503,Marksman,"Assassin, Mage","Assassin, Fighter","Assassin, Mage",0,3,3
2837,Fighter,"Support, Mage",Marksman,"Tank, Support",2,1,3
5072,"Fighter, Tank",Mage,Marksman,"Mage, Support",2,1,3
8571,"Assassin, Fighter","Assassin, Fighter",Marksman,Mage,1,2,3
2890,"Assassin, Fighter",Mage,"Fighter, Assassin","Support, Mage",2,1,3
3921,"Mage, Fighter","Tank, Support","Fighter, Assassin","Support, Tank",3,0,3
4871,"Marksman, Assassin","Mage, Support",Marksman,Mage,2,1,3
2767,"Assassin, Fighter","Mage, Support","Fighter, Tank","Mage, Assassin",2,1,3
4881,Marksman,"Support, Tank",Marksman,Mage,3,0,3
2771,"Assassin, Fighter","Mage, Support",Fighter,"Tank, Support",2,1,3
8603,Marksman,"Mage, Assassin","Assassin, Fighter",Mage,0,3,3
4883,"Marksman, Assassin","Tank, Support",Marksman,Mage,0,3,3
2773,"Fighter, Tank","Mage, Support","Support, Mage",Marksman,1,2,3
3948,"Tank, Fighter","Support, Tank","Assassin, Fighter","Support, Fighter",3,0,3
6909,"Tank, Fighter","Tank, Fighter","Fighter, Tank",Fighter,1,2,3
3944,"Fighter, Assassin","Support, Mage",Marksman,"Support, Fighter",2,1,3
3191,Fighter,"Support, Mage","Fighter, Mage","Marksman, Mage",1,2,3
8597,"Tank, Mage","Mage, Support","Tank, Fighter",Mage,1,2,3
8596,"Tank, Fighter","Mage, Marksman","Fighter, Mage",Mage,2,1,3
8594,"Tank, Fighter",Mage,"Tank, Mage","Mage, Support",3,0,3
3936,"Tank, Fighter","Support, Tank","Assassin, Fighter","Support, Mage",2,1,3
2781,Fighter,"Mage, Support","Assassin, Fighter","Support, Tank",0,3,3
5886,"Tank, Fighter","Tank, Fighter","Fighter, Assassin",Fighter,2,1,3
8590,"Tank, Fighter",Mage,"Tank, Fighter","Assassin, Mage",3,0,3
4975,"Fighter, Assassin","Support, Mage",Marksman,"Support, Tank",2,1,3
6926,"Tank, Mage","Tank, Fighter",Tank,"Tank, Fighter",0,3,3
3932,"Mage, Fighter","Support, Tank","Assassin, Fighter","Support, Tank",3,0,3
2788,"Assassin, Fighter","Support, Mage","Fighter, Tank","Support, Mage",3,0,3
4987,"Assassin, Fighter","Support, Tank","Tank, Fighter","Tank, Support",3,0,3
6927,"Tank, Mage","Assassin, Fighter","Tank, Fighter","Fighter, Mage",2,1,3
2791,"Fighter, Mage","Support, Tank",Marksman,"Mage, Support",1,2,3
3188,"Assassin, Fighter","Mage, Support","Mage, Fighter","Support, Fighter",1,2,3
6135,"Fighter, Tank","Mage, Fighter",Tank,"Tank, Fighter",1,2,3
4988,"Tank, Fighter","Support, Tank","Fighter, Tank","Tank, Support",3,0,3
5027,Marksman,"Support, Fighter",Marksman,Tank,1,2,3
2838,"Tank, Fighter",Tank,"Assassin, Fighter","Support, Tank",0,3,3
5455,"Fighter, Tank","Fighter, Tank","Fighter, Mage","Assassin, Fighter",1,2,3
6067,"Mage, Fighter",Fighter,"Fighter, Assassin","Mage, Fighter",3,0,3
6968,"Tank, Fighter","Assassin, Fighter",Marksman,"Fighter, Mage",2,1,3
5565,"Fighter, Tank","Mage, Fighter","Fighter, Assassin","Tank, Fighter",0,3,3
5566,"Tank, Fighter","Tank, Fighter","Fighter, Tank","Mage, Fighter",2,1,3
3800,"Fighter, Assassin","Support, Fighter","Tank, Fighter","Tank, Fighter",2,1,3
8441,"Fighter, Mage",Mage,Marksman,Mage,2,1,3
5567,"Fighter, Assassin","Tank, Mage","Fighter, Tank","Fighter, Mage",1,2,3
2872,"Tank, Fighter","Support, Mage",Fighter,Mage,2,1,3
3149,"Assassin, Fighter","Support, Mage","Fighter, Assassin","Tank, Support",2,1,3
5569,"Fighter, Tank","Tank, Fighter","Fighter, Tank","Tank, Mage",2,1,3
2874,"Tank, Fighter","Support, Mage","Fighter, Tank","Support, Mage",1,2,3
5572,"Tank, Fighter","Assassin, Fighter","Fighter, Assassin",Marksman,3,0,3
3789,"Fighter, Mage","Tank, Support","Tank, Fighter",Support,1,2,3
5585,"Tank, Mage","Fighter, Mage","Fighter, Assassin","Mage, Fighter",1,2,3
3783,"Assassin, Fighter","Tank, Support","Tank, Fighter","Support, Mage",2,1,3
6027,"Fighter, Tank",Marksman,"Assassin, Fighter","Assassin, Fighter",2,1,3
5596,"Mage, Fighter",Fighter,"Fighter, Tank",Marksman,1,2,3
2879,Fighter,"Support, Mage","Fighter, Assassin","Support, Mage",2,1,3
5597,"Tank, Mage",Marksman,"Fighter, Tank","Mage, Fighter",1,2,3
2880,"Tank, Fighter","Support, Tank","Tank, Fighter",Support,2,1,3
3773,"Fighter, Assassin","Support, Tank","Assassin, Fighter","Tank, Support",2,1,3
7115,"Mage, Fighter","Assassin, Fighter","Tank, Fighter","Assassin, Mage",1,2,3
6020,"Fighter, Mage","Assassin, Fighter","Fighter, Tank",Fighter,1,2,3
3345,"Tank, Fighter","Tank, Support","Tank, Fighter","Support, Mage",1,2,3
7186,"Mage, Fighter",Fighter,"Fighter, Assassin",Marksman,1,2,3
6017,"Tank, Mage","Tank, Fighter","Fighter, Tank","Assassin, Mage",2,1,3
8421,Marksman,"Mage, Marksman","Fighter, Mage","Support, Mage",2,1,3
5643,Fighter,"Fighter, Mage","Fighter, Assassin",Fighter,2,1,3
7198,"Tank, Mage","Mage, Fighter","Fighter, Tank","Assassin, Fighter",0,3,3
6002,"Tank, Mage","Tank, Fighter","Fighter, Mage","Tank, Fighter",2,1,3
3756,"Assassin, Fighter","Support, Mage",Fighter,Mage,1,2,3
2868,"Tank, Fighter","Support, Mage","Assassin, Fighter",Mage,1,2,3
6028,"Tank, Fighter","Mage, Fighter","Tank, Fighter",Fighter,1,2,3
5563,Tank,"Tank, Mage","Fighter, Tank","Tank, Fighter",1,2,3
3840,"Tank, Fighter","Tank, Fighter","Tank, Fighter","Support, Fighter",1,2,3
5464,"Tank, Fighter","Fighter, Assassin","Tank, Mage","Tank, Fighter",1,2,3
5467,"Fighter, Mage","Mage, Fighter","Fighter, Tank","Assassin, Fighter",3,0,3
6061,"Mage, Fighter",Marksman,"Fighter, Assassin","Mage, Fighter",2,1,3
8495,"Assassin, Fighter","Mage, Support","Mage, Fighter","Mage, Fighter",0,3,3
6975,"Fighter, Assassin","Fighter, Mage","Fighter, Tank","Fighter, Assassin",3,0,3
8494,"Assassin, Fighter","Assassin, Mage","Fighter, Assassin","Assassin, Fighter",1,2,3
5478,"Mage, Marksman","Fighter, Mage","Fighter, Tank",Fighter,2,1,3
8489,"Fighter, Tank","Mage, Fighter","Assassin, Fighter","Mage, Support",1,2,3
3164,Marksman,"Support, Mage","Assassin, Fighter","Tank, Support",0,3,3
5492,Tank,Marksman,"Fighter, Tank","Fighter, Assassin",2,1,3
5499,"Fighter, Assassin","Fighter, Assassin","Fighter, Tank","Fighter, Tank",2,1,3
5500,"Fighter, Mage","Fighter, Assassin","Mage, Marksman","Assassin, Fighter",3,0,3
5502,"Assassin, Fighter","Fighter, Mage","Fighter, Tank","Assassin, Fighter",3,0,3
3830,"Assassin, Fighter","Support, Fighter","Fighter, Mage","Tank, Support",1,2,3
3151,"Tank, Fighter",Marksman,"Mage, Fighter","Mage, Support",3,0,3
6052,"Tank, Fighter","Assassin, Fighter","Fighter, Assassin","Mage, Fighter",2,1,3
3163,"Tank, Fighter","Support, Mage","Fighter, Mage","Mage, Support",3,0,3
7060,"Fighter, Mage",Fighter,"Fighter, Tank",Marksman,2,1,3
2858,"Tank, Fighter",Mage,"Assassin, Fighter","Support, Fighter",3,0,3
3155,"Fighter, Assassin","Mage, Support","Tank, Fighter","Tank, Mage",0,3,3
3822,"Tank, Fighter","Tank, Fighter",Fighter,"Tank, Support",2,1,3
6033,"Tank, Fighter","Fighter, Mage","Tank, Fighter",Fighter,2,1,3
3153,"Mage, Fighter","Mage, Support","Fighter, Tank","Support, Mage",1,2,3
3814,"Fighter, Assassin","Tank, Support","Tank, Fighter","Support, Fighter",2,1,3
3811,"Tank, Fighter","Tank, Support","Fighter, Assassin","Support, Fighter",3,0,3
3545,"Mage, Fighter","Support, Fighter","Fighter, Mage","Mage, Support",1,2,3
6030,"Fighter, Assassin","Mage, Fighter","Fighter, Assassin",Marksman,0,3,3
8451,"Assassin, Fighter","Assassin, Mage",Marksman,"Mage, Fighter",3,0,3
6072,Tank,"Assassin, Fighter","Fighter, Tank","Assassin, Fighter",1,2,3
2444,"Marksman, Assassin","Support, Fighter",Marksman,"Fighter, Tank",3,0,3
2571,"Assassin, Fighter",Fighter,"Tank, Fighter","Fighter, Mage",1,2,3
1199,Marksman,"Mage, Marksman","Marksman, Support","Tank, Support",2,1,3
1210,Fighter,"Assassin, Mage","Fighter, Mage","Mage, Tank",1,2,3
10432,"Assassin, Fighter","Mage, Fighter",Marksman,"Mage, Assassin",0,3,3
1225,"Mage, Fighter","Support, Tank","Fighter, Tank","Support, Fighter",3,0,3
1975,"Tank, Mage","Tank, Support","Tank, Fighter",Support,0,3,3
1968,"Tank, Fighter",Marksman,"Tank, Fighter","Support, Mage",2,1,3
1236,"Fighter, Marksman","Assassin, Fighter","Tank, Fighter","Fighter, Assassin",0,3,3
1964,Fighter,"Mage, Support","Assassin, Fighter","Support, Fighter",3,0,3
1962,Marksman,"Support, Mage",Fighter,"Support, Mage",1,2,3
1959,Tank,Marksman,"Tank, Mage","Fighter, Assassin",3,0,3
1958,"Tank, Fighter","Support, Mage",Fighter,"Tank, Fighter",1,2,3
1954,"Fighter, Mage",Mage,Marksman,"Support, Mage",2,1,3
10355,"Tank, Fighter","Tank, Mage","Fighter, Mage","Mage, Support",2,1,3
1239,"Fighter, Mage","Support, Tank","Fighter, Tank","Tank, Support",2,1,3
1245,"Mage, Fighter","Assassin, Mage","Assassin, Fighter",Mage,2,1,3
9342,"Mage, Fighter",Marksman,Marksman,"Support, Mage",0,3,3
9288,"Tank, Fighter",Mage,"Fighter, Mage","Mage, Assassin",1,2,3
1997,Fighter,Mage,Marksman,"Support, Mage",2,1,3
2034,"Fighter, Mage","Tank, Fighter","Tank, Fighter","Support, Mage",2,1,3
1999,"Fighter, Mage","Mage, Assassin",Fighter,"Mage, Marksman",1,2,3
2032,Tank,Marksman,"Fighter, Tank","Fighter, Mage",2,1,3
9253,"Fighter, Assassin","Mage, Support","Fighter, Tank",Mage,2,1,3
2027,"Tank, Mage","Fighter, Assassin","Fighter, Mage",Fighter,3,0,3
2026,"Assassin, Fighter","Support, Mage",Fighter,"Support, Fighter",2,1,3
9254,"Fighter, Tank","Mage, Support","Fighter, Assassin","Mage, Fighter",3,0,3
1170,Marksman,"Mage, Assassin","Mage, Fighter",Marksman,2,1,3
1173,"Fighter, Assassin","Assassin, Mage","Tank, Fighter","Fighter, Marksman",2,1,3
2011,"Fighter, Mage","Support, Fighter","Mage, Fighter","Mage, Support",1,2,3
1187,"Fighter, Assassin","Fighter, Marksman","Mage, Fighter","Assassin, Fighter",2,1,3
2007,"Tank, Fighter","Tank, Support",Fighter,Mage,3,0,3
1193,"Mage, Fighter","Tank, Fighter",Marksman,"Mage, Support",3,0,3
2006,Fighter,Mage,"Fighter, Mage","Fighter, Assassin",1,2,3
1196,"Fighter, Mage","Support, Fighter","Assassin, Fighter","Support, Tank",1,2,3
9277,"Tank, Fighter","Assassin, Mage","Tank, Fighter",Marksman,1,2,3
2002,Marksman,"Tank, Fighter","Fighter, Mage","Support, Tank",2,1,3
1247,"Fighter, Mage",Fighter,"Fighter, Tank","Mage, Fighter",3,0,3
10327,"Tank, Fighter","Assassin, Mage","Fighter, Assassin",Mage,1,2,3
9347,Fighter,"Mage, Assassin","Assassin, Fighter",Mage,2,1,3
1946,"Tank, Mage","Fighter, Assassin","Fighter, Tank","Fighter, Mage",2,1,3
1274,"Marksman, Assassin","Mage, Support",Marksman,Support,2,1,3
1275,"Fighter, Assassin","Support, Fighter",Fighter,Mage,2,1,3
10247,"Fighter, Mage","Mage, Tank","Assassin, Fighter","Mage, Support",1,2,3
1277,Fighter,Marksman,"Fighter, Assassin","Mage, Assassin",0,3,3
1279,Tank,"Mage, Fighter","Tank, Fighter","Fighter, Mage",1,2,3
1284,Fighter,Mage,"Assassin, Fighter",Marksman,2,1,3
1897,Fighter,Mage,"Fighter, Tank","Mage, Fighter",1,2,3
1286,"Tank, Fighter","Mage, Support","Fighter, Mage","Support, Tank",1,2,3
9407,"Tank, Fighter","Mage, Support",Fighter,"Assassin, Mage",1,2,3
1891,"Assassin, Fighter","Marksman, Mage",Fighter,"Mage, Marksman",0,3,3
1890,"Marksman, Assassin","Support, Fighter","Marksman, Assassin","Tank, Fighter",2,1,3
1889,"Tank, Fighter","Fighter, Assassin","Fighter, Mage","Assassin, Fighter",0,3,3
1883,Fighter,"Mage, Assassin","Assassin, Fighter","Marksman, Mage",2,1,3
1295,Marksman,Support,"Marksman, Support","Mage, Support",0,3,3
1881,Marksman,"Support, Mage","Assassin, Fighter","Support, Fighter",2,1,3
1272,"Assassin, Mage","Tank, Support","Assassin, Fighter","Tank, Fighter",2,1,3
1900,"Tank, Fighter",Marksman,Tank,"Fighter, Assassin",2,1,3
1901,Marksman,"Mage, Support","Mage, Fighter","Mage, Marksman",0,3,3
1933,Fighter,"Support, Fighter",Marksman,"Tank, Support",2,1,3
10321,Fighter,"Mage, Support","Mage, Fighter","Mage, Assassin",2,1,3
1943,"Tank, Fighter","Assassin, Mage","Assassin, Mage","Mage, Support",1,2,3
1941,"Mage, Fighter","Tank, Support","Fighter, Mage","Support, Mage",2,1,3
9356,"Tank, Fighter","Assassin, Fighter","Tank, Fighter","Mage, Support",3,0,3
9362,"Fighter, Assassin",Mage,"Tank, Fighter",Mage,0,3,3
1258,"Fighter, Mage","Support, Mage",Fighter,"Tank, Fighter",2,1,3
1926,"Assassin, Mage","Assassin, Mage","Tank, Fighter","Mage, Marksman",0,3,3
1902,"Mage, Marksman","Fighter, Tank",Marksman,"Support, Mage",1,2,3
1924,"Tank, Fighter","Support, Fighter","Fighter, Assassin","Support, Mage",1,2,3
1264,Fighter,"Mage, Support","Fighter, Assassin",Marksman,2,1,3
1922,"Assassin, Fighter","Support, Fighter","Fighter, Tank","Mage, Support",2,1,3
9377,"Tank, Fighter","Mage, Support","Mage, Fighter",Marksman,1,2,3
1266,"Assassin, Fighter",Marksman,"Fighter, Assassin","Assassin, Mage",2,1,3
1915,"Fighter, Mage","Tank, Fighter",Fighter,"Support, Mage",1,2,3
9242,"Assassin, Fighter","Mage, Assassin",Fighter,"Assassin, Mage",3,0,3
2038,"Tank, Fighter","Mage, Fighter","Assassin, Fighter",Marksman,1,2,3
2193,"Marksman, Support","Tank, Fighter","Marksman, Assassin","Support, Fighter",2,1,3
2144,"Fighter, Tank","Fighter, Mage","Fighter, Mage","Fighter, Assassin",3,0,3
2137,"Assassin, Fighter","Support, Tank","Fighter, Mage",Support,2,1,3
10730,Fighter,"Marksman, Mage","Assassin, Mage",Mage,2,1,3
2132,"Fighter, Mage","Fighter, Assassin",Tank,Marksman,3,0,3
9168,"Fighter, Assassin",Mage,"Assassin, Fighter","Assassin, Fighter",1,2,3
2127,"Fighter, Mage","Fighter, Tank","Fighter, Assassin",Fighter,2,1,3
1083,Marksman,"Support, Tank","Assassin, Fighter","Tank, Support",1,2,3
1084,Fighter,"Mage, Support",Marksman,"Mage, Assassin",2,1,3
1085,"Fighter, Mage","Mage, Marksman",Fighter,"Mage, Support",3,0,3
2121,Fighter,Mage,"Fighter, Mage","Tank, Fighter",2,1,3
10688,"Tank, Fighter",Mage,Fighter,"Mage, Marksman",1,2,3
1092,"Mage, Fighter",Marksman,"Tank, Fighter","Assassin, Mage",1,2,3
1094,"Tank, Fighter","Fighter, Marksman","Fighter, Mage",Marksman,2,1,3
10665,Marksman,Mage,"Mage, Fighter","Marksman, Fighter",2,1,3
1103,"Support, Mage","Support, Mage","Assassin, Fighter","Mage, Support",3,0,3
9183,"Fighter, Mage","Mage, Support","Fighter, Assassin","Assassin, Mage",2,1,3
2139,"Fighter, Tank","Mage, Fighter","Assassin, Fighter","Fighter, Mage",1,2,3
2145,"Assassin, Fighter","Mage, Fighter","Fighter, Assassin",Mage,1,2,3
2039,Fighter,Mage,"Fighter, Assassin","Support, Fighter",1,2,3
2146,"Tank, Fighter","Assassin, Fighter","Fighter, Assassin","Fighter, Mage",2,1,3
9126,"Tank, Fighter","Mage, Marksman","Tank, Fighter","Assassin, Mage",2,1,3
1057,"Assassin, Fighter",Marksman,"Fighter, Tank","Fighter, Mage",3,0,3
2182,"Assassin, Fighter","Mage, Support","Support, Mage",Marksman,0,3,3
2180,"Fighter, Marksman",Mage,Marksman,"Support, Fighter",3,0,3
1061,"Support, Mage",Marksman,"Assassin, Fighter","Mage, Support",1,2,3
2174,"Tank, Mage","Assassin, Fighter",Fighter,"Fighter, Mage",2,1,3
1064,"Assassin, Fighter","Mage, Assassin",Marksman,"Support, Tank",1,2,3
2168,"Fighter, Assassin",Mage,"Tank, Fighter","Tank, Support",2,1,3
2166,"Support, Tank",Fighter,"Fighter, Tank","Mage, Fighter",2,1,3
2163,"Assassin, Fighter","Mage, Fighter",Fighter,"Assassin, Fighter",3,0,3
1066,Marksman,Marksman,"Mage, Fighter","Mage, Fighter",2,1,3
9145,"Fighter, Mage","Mage, Fighter","Fighter, Assassin","Mage, Support",2,1,3
2155,"Assassin, Fighter","Mage, Support",Marksman,"Fighter, Marksman",2,1,3
9155,"Tank, Fighter","Mage, Assassin","Assassin, Fighter",Mage,0,3,3
9159,"Support, Mage","Mage, Support",Marksman,"Assassin, Fighter",1,2,3
2117,"Fighter, Mage","Fighter, Assassin","Fighter, Tank","Fighter, Mage",0,3,3
2114,"Tank, Fighter",Marksman,Fighter,"Mage, Fighter",1,2,3
1110,Marksman,"Mage, Fighter",Fighter,"Mage, Support",1,2,3
2113,"Fighter, Tank","Fighter, Mage",Mage,Fighter,0,3,3
2077,"Tank, Mage",Marksman,"Assassin, Fighter","Assassin, Fighter",2,1,3
10584,"Assassin, Fighter","Assassin, Fighter","Mage, Fighter",Mage,0,3,3
2076,"Mage, Marksman","Fighter, Assassin","Fighter, Mage",Marksman,1,2,3
9209,"Assassin, Fighter","Mage, Support","Assassin, Fighter","Fighter, Marksman",3,0,3
2073,"Fighter, Tank","Tank, Fighter",Fighter,"Support, Fighter",0,3,3
9214,"Assassin, Fighter",Mage,"Assassin, Fighter",Marksman,0,3,3
9216,Marksman,"Fighter, Marksman","Assassin, Fighter","Mage, Support",2,1,3
1146,"Fighter, Tank","Tank, Fighter","Fighter, Tank","Support, Mage",1,2,3
2065,"Mage, Fighter","Mage, Support","Fighter, Mage","Tank, Support",3,0,3
2064,"Tank, Mage",Fighter,"Assassin, Fighter","Fighter, Mage",3,0,3
2059,"Assassin, Fighter",Marksman,"Tank, Mage","Assassin, Fighter",1,2,3
2047,"Fighter, Assassin","Mage, Fighter","Fighter, Assassin","Fighter, Mage",3,0,3
1157,"Mage, Fighter","Support, Tank","Fighter, Mage","Support, Tank",1,2,3
1165,Tank,"Tank, Fighter","Fighter, Mage",Fighter,3,0,3
2043,"Fighter, Tank","Fighter, Tank",Fighter,"Support, Tank",2,1,3
1142,"Assassin, Fighter",Marksman,"Assassin, Fighter","Assassin, Fighter",2,1,3
1141,"Marksman, Assassin","Support, Fighter","Marksman, Assassin","Tank, Support",1,2,3
2079,"Assassin, Mage","Tank, Support","Tank, Fighter","Support, Fighter",0,3,3
2098,"Mage, Fighter","Support, Mage","Fighter, Tank","Mage, Support",2,1,3
2112,"Fighter, Mage","Mage, Fighter","Tank, Fighter",Marksman,1,2,3
1117,"Fighter, Assassin",Mage,"Support, Mage","Mage, Support",2,1,3
9193,"Fighter, Assassin","Mage, Support","Fighter, Mage","Assassin, Mage",0,3,3
2100,"Tank, Fighter","Mage, Fighter","Assassin, Fighter","Mage, Assassin",2,1,3
2099,"Tank, Mage",Marksman,Tank,"Fighter, Assassin",0,3,3
1128,"Mage, Fighter","Support, Fighter",Fighter,"Support, Mage",2,1,3
9198,Fighter,"Mage, Support","Fighter, Assassin","Mage, Fighter",2,1,3
10631,"Fighter, Mage","Mage, Marksman","Assassin, Fighter",Mage,3,0,3
2093,"Assassin, Fighter","Support, Mage","Mage, Fighter","Tank, Support",2,1,3
2092,Fighter,"Mage, Fighter","Fighter, Assassin",Marksman,1,2,3
2090,"Fighter, Assassin",Marksman,"Mage, Fighter",Mage,1,2,3
2084,"Fighter, Tank","Mage, Fighter","Assassin, Fighter",Fighter,2,1,3
1137,"Tank, Fighter","Mage, Assassin","Fighter, Assassin","Fighter, Assassin",2,1,3
2081,"Tank, Fighter","Support, Fighter","Tank, Fighter","Tank, Fighter",2,1,3
10202,"Assassin, Fighter",Mage,Fighter,"Mage, Marksman",2,1,3
1877,"Mage, Fighter","Mage, Marksman","Assassin, Fighter","Assassin, Mage",2,1,3
1300,"Fighter, Assassin",Fighter,"Fighter, Assassin","Mage, Fighter",1,2,3
1470,"Assassin, Fighter",Marksman,"Mage, Fighter",Mage,2,1,3
9621,"Assassin, Fighter","Assassin, Fighter","Fighter, Mage","Mage, Support",2,1,3
1482,"Tank, Fighter",Marksman,"Fighter, Mage",Marksman,1,2,3
1483,"Tank, Mage",Fighter,"Fighter, Assassin","Fighter, Mage",3,0,3
9624,"Assassin, Fighter","Mage, Assassin","Fighter, Mage","Mage, Support",2,1,3
1717,"Fighter, Mage","Support, Tank","Tank, Fighter","Tank, Support",2,1,3
1713,"Tank, Fighter",Support,"Tank, Fighter","Support, Mage",0,3,3
1500,"Marksman, Assassin","Tank, Fighter","Marksman, Support","Mage, Support",2,1,3
1710,"Assassin, Fighter","Mage, Fighter",Marksman,Marksman,2,1,3
1706,"Assassin, Fighter","Assassin, Mage","Fighter, Assassin",Marksman,2,1,3
1503,"Tank, Mage","Assassin, Fighter","Assassin, Fighter",Fighter,3,0,3
1705,"Marksman, Mage","Tank, Support","Marksman, Assassin","Mage, Support",1,2,3
1704,"Fighter, Assassin","Mage, Fighter","Mage, Fighter",Mage,2,1,3
1703,"Assassin, Fighter","Support, Mage",Fighter,"Support, Tank",2,1,3
1512,"Marksman, Mage",Mage,Marksman,"Mage, Support",3,0,3
1514,Marksman,"Mage, Support","Mage, Fighter","Mage, Fighter",1,2,3
1478,Fighter,"Mage, Marksman","Fighter, Mage","Marksman, Mage",1,2,3
1724,"Fighter, Assassin","Assassin, Fighter","Assassin, Fighter","Mage, Fighter",3,0,3
9422,"Tank, Fighter","Mage, Assassin","Tank, Fighter","Mage, Fighter",2,1,3
1469,"Marksman, Mage","Mage, Assassin","Marksman, Support","Support, Fighter",3,0,3
1750,Marksman,"Support, Tank","Mage, Fighter","Tank, Fighter",1,2,3
9585,"Tank, Fighter","Mage, Support","Fighter, Assassin","Assassin, Mage",2,1,3
1445,"Fighter, Assassin","Fighter, Tank","Mage, Fighter","Tank, Support",2,1,3
1447,"Assassin, Fighter","Tank, Mage","Fighter, Mage","Assassin, Mage",2,1,3
1748,"Marksman, Assassin","Tank, Support","Marksman, Mage","Support, Mage",1,2,3
1747,"Mage, Fighter",Marksman,"Assassin, Fighter",Marksman,2,1,3
1451,Marksman,"Fighter, Tank","Fighter, Mage","Tank, Support",3,0,3
1461,"Marksman, Mage","Support, Tank","Marksman, Assassin","Fighter, Tank",2,1,3
1739,Mage,"Mage, Support","Marksman, Mage","Support, Mage",2,1,3
1738,Fighter,"Mage, Fighter","Fighter, Assassin",Mage,2,1,3
1466,"Marksman, Support","Tank, Support","Marksman, Assassin","Support, Mage",1,2,3
1736,"Assassin, Fighter","Mage, Support","Assassin, Fighter","Tank, Fighter",3,0,3
9609,"Assassin, Fighter","Mage, Assassin","Fighter, Assassin","Assassin, Mage",0,3,3
1730,Marksman,"Mage, Tank","Fighter, Tank","Mage, Support",1,2,3
1728,"Marksman, Support","Mage, Assassin","Marksman, Assassin","Support, Mage",1,2,3
1515,"Fighter, Assassin","Tank, Support","Mage, Fighter","Support, Mage",1,2,3
1694,"Marksman, Support","Support, Fighter","Marksman, Mage","Support, Mage",1,2,3
1692,"Fighter, Mage","Assassin, Fighter","Tank, Fighter","Support, Mage",1,2,3
1689,Marksman,"Mage, Support","Fighter, Assassin",Marksman,2,1,3
1562,"Fighter, Mage",Mage,Fighter,Marksman,2,1,3
1563,"Marksman, Support","Mage, Support",Marksman,"Tank, Fighter",1,2,3
1631,Marksman,"Support, Fighter","Mage, Fighter","Tank, Fighter",1,2,3
1629,"Tank, Fighter","Assassin, Mage","Fighter, Assassin","Tank, Mage",2,1,3
9685,"Mage, Fighter","Assassin, Fighter","Assassin, Fighter",Mage,2,1,3
1572,Fighter,"Assassin, Fighter","Fighter, Tank","Tank, Fighter",2,1,3
1622,Marksman,Mage,"Mage, Fighter","Mage, Marksman",2,1,3
1585,"Mage, Fighter","Mage, Fighter","Assassin, Fighter",Mage,0,3,3
9693,"Mage, Fighter",Mage,"Tank, Fighter","Mage, Support",3,0,3
1586,"Fighter, Assassin","Fighter, Assassin","Mage, Fighter","Assassin, Fighter",1,2,3
1608,"Fighter, Mage","Mage, Support","Mage, Fighter","Mage, Tank",1,2,3
9737,"Fighter, Mage","Support, Mage",Fighter,"Assassin, Mage",1,2,3
1588,Marksman,Tank,"Marksman, Assassin","Support, Tank",1,2,3
9703,"Fighter, Mage","Mage, Support","Fighter, Tank","Mage, Support",3,0,3
1593,"Mage, Fighter","Mage, Support","Tank, Fighter","Support, Fighter",1,2,3
1638,"Fighter, Mage","Support, Fighter",Marksman,"Support, Tank",2,1,3
1639,Marksman,"Support, Tank","Fighter, Mage","Support, Fighter",2,1,3
1644,Marksman,"Mage, Support","Mage, Fighter","Marksman, Mage",2,1,3
1674,"Fighter, Tank","Fighter, Mage","Fighter, Tank","Assassin, Mage",2,1,3
1680,"Marksman, Support","Support, Tank","Marksman, Mage","Support, Tank",1,2,3
9641,"Mage, Fighter","Support, Mage",Fighter,Mage,3,0,3
1517,"Mage, Fighter","Tank, Support","Assassin, Fighter","Mage, Support",2,1,3
9855,"Mage, Fighter","Marksman, Mage","Fighter, Mage",Mage,2,1,3
1678,"Assassin, Fighter",Marksman,Marksman,Mage,3,0,3
9645,"Fighter, Mage","Mage, Support","Mage, Fighter",Mage,2,1,3
1672,"Mage, Fighter","Marksman, Mage",Fighter,Mage,1,2,3
1645,Tank,"Fighter, Assassin","Tank, Fighter",Marksman,1,2,3
1669,"Mage, Fighter","Mage, Tank",Fighter,Mage,2,1,3
1525,"Assassin, Fighter","Support, Fighter",Fighter,"Mage, Support",3,0,3
1530,"Tank, Mage",Marksman,"Fighter, Mage",Mage,1,2,3
1660,"Mage, Fighter","Mage, Fighter",Marksman,Mage,2,1,3
1658,"Fighter, Mage","Mage, Fighter",Fighter,"Mage, Marksman",1,2,3
1651,"Fighter, Tank","Tank, Fighter","Mage, Tank","Tank, Fighter",3,0,3
1751,Marksman,"Mage, Support","Support, Mage","Mage, Support",2,1,3
9582,"Tank, Fighter","Assassin, Mage","Tank, Fighter","Mage, Support",2,1,3
1439,"Mage, Fighter","Tank, Support",Fighter,"Support, Tank",2,1,3
1806,"Mage, Marksman","Tank, Fighter","Fighter, Tank","Fighter, Mage",1,2,3
9483,"Fighter, Mage",Mage,"Assassin, Fighter","Fighter, Marksman",2,1,3
1343,"Fighter, Tank",Fighter,"Tank, Mage",Marksman,3,0,3
9485,"Fighter, Assassin","Mage, Support","Mage, Fighter","Assassin, Mage",1,2,3
9495,"Tank, Fighter",Mage,"Tank, Fighter","Mage, Marksman",2,1,3
1827,"Marksman, Assassin","Mage, Assassin","Marksman, Mage","Support, Tank",2,1,3
1825,"Fighter, Tank",Fighter,"Fighter, Marksman","Fighter, Mage",0,3,3
1355,"Fighter, Mage",Marksman,Marksman,"Mage, Marksman",0,3,3
1821,"Fighter, Mage",Marksman,"Fighter, Tank","Fighter, Mage",1,2,3
1356,"Fighter, Mage","Mage, Marksman","Mage, Fighter","Assassin, Mage",1,2,3
1819,"Fighter, Tank","Fighter, Mage","Fighter, Assassin","Fighter, Assassin",3,0,3
9505,"Tank, Fighter","Mage, Support","Assassin, Fighter",Mage,1,2,3
10117,"Mage, Fighter",Mage,Marksman,"Assassin, Fighter",1,2,3
1813,"Fighter, Assassin","Support, Tank",Marksman,"Support, Fighter",2,1,3
1812,"Fighter, Mage","Support, Tank","Fighter, Assassin","Support, Tank",1,2,3
1811,"Tank, Fighter","Support, Tank","Assassin, Fighter","Support, Tank",3,0,3
1336,Fighter,Fighter,Tank,Marksman,2,1,3
1334,"Fighter, Tank","Assassin, Fighter",Tank,"Fighter, Mage",2,1,3
1847,"Fighter, Tank","Support, Fighter","Fighter, Assassin","Mage, Support",2,1,3
1858,"Fighter, Assassin","Support, Fighter",Fighter,"Support, Tank",3,0,3
1302,"Fighter, Assassin","Mage, Fighter","Assassin, Fighter",Marksman,0,3,3
1872,"Fighter, Mage","Mage, Tank","Mage, Fighter","Assassin, Mage",1,2,3
9443,"Assassin, Fighter",Mage,"Fighter, Tank","Mage, Support",2,1,3
1312,"Mage, Fighter","Mage, Assassin","Fighter, Mage","Assassin, Mage",0,3,3
1861,"Mage, Fighter","Mage, Tank",Fighter,"Mage, Fighter",1,2,3
9453,Fighter,Mage,Marksman,"Mage, Support",3,0,3
10150,Fighter,"Mage, Support","Fighter, Tank","Mage, Marksman",1,2,3
1849,"Fighter, Mage","Mage, Tank","Mage, Fighter",Mage,1,2,3
1855,Fighter,Mage,"Fighter, Mage","Mage, Fighter",0,3,3
1323,"Assassin, Fighter","Mage, Fighter","Fighter, Mage",Mage,1,2,3
1325,Fighter,"Fighter, Mage","Fighter, Tank","Fighter, Tank",3,0,3
10139,"Mage, Fighter",Mage,"Assassin, Fighter","Support, Mage",1,2,3
1851,"Fighter, Mage","Mage, Assassin","Mage, Fighter",Mage,3,0,3
1850,"Fighter, Mage","Assassin, Mage",Fighter,"Assassin, Mage",1,2,3
1807,Marksman,"Assassin, Fighter","Assassin, Fighter","Mage, Support",1,2,3
10070,"Mage, Fighter",Marksman,"Assassin, Fighter","Tank, Mage",1,2,3
1754,"Fighter, Mage","Support, Tank","Tank, Fighter","Support, Fighter",1,2,3
1801,Fighter,"Mage, Marksman","Fighter, Tank",Mage,1,2,3
9526,"Fighter, Assassin","Mage, Tank","Assassin, Fighter","Mage, Support",2,1,3
1777,"Marksman, Assassin","Support, Mage",Marksman,"Mage, Assassin",2,1,3
1775,Fighter,"Mage, Assassin","Fighter, Assassin","Mage, Support",3,0,3
1773,"Mage, Fighter","Support, Mage","Support, Mage","Mage, Support",1,2,3
1772,"Fighter, Tank","Mage, Fighter","Fighter, Assassin",Mage,1,2,3
9533,Marksman,Mage,"Assassin, Fighter","Mage, Assassin",1,2,3
1396,"Fighter, Mage","Support, Fighter","Fighter, Assassin","Tank, Fighter",1,2,3
9540,"Fighter, Mage",Mage,"Fighter, Assassin",Mage,1,2,3
1764,"Fighter, Assassin","Assassin, Fighter","Mage, Fighter","Mage, Support",1,2,3
1418,"Fighter, Marksman","Tank, Support",Marksman,"Tank, Fighter",1,2,3
1761,"Mage, Fighter","Support, Fighter","Fighter, Mage","Support, Mage",3,0,3
9547,Fighter,Mage,Marksman,"Mage, Fighter",3,0,3
1424,Marksman,"Fighter, Tank","Mage, Fighter","Tank, Support",2,1,3
9550,Marksman,"Mage, Marksman","Fighter, Mage",Mage,1,2,3
1437,"Fighter, Mage","Support, Tank","Fighter, Assassin","Tank, Support",2,1,3
1394,"Fighter, Mage","Mage, Support",Fighter,"Tank, Support",2,1,3
1785,"Fighter, Tank","Mage, Fighter","Fighter, Marksman","Fighter, Mage",0,3,3
10046,"Assassin, Fighter","Fighter, Marksman",Marksman,"Assassin, Fighter",1,2,3
1794,Marksman,"Mage, Assassin","Marksman, Support","Mage, Support",3,0,3
1367,Fighter,"Tank, Support","Assassin, Mage",Mage,2,1,3
1370,"Fighter, Mage","Mage, Tank",Fighter,"Assassin, Mage",3,0,3
10067,"Mage, Fighter","Mage, Tank","Fighter, Mage","Mage, Support",2,1,3
1373,"Tank, Fighter","Fighter, Mage","Tank, Mage","Fighter, Assassin",2,1,3
1378,Fighter,"Assassin, Mage","Fighter, Mage",Mage,3,0,3
1382,Fighter,"Assassin, Mage","Fighter, Mage","Marksman, Mage",2,1,3
1793,Mage,"Mage, Support","Marksman, Assassin","Mage, Assassin",1,2,3
10051,"Mage, Fighter","Mage, Tank","Assassin, Fighter","Mage, Support",1,2,3
10064,"Assassin, Fighter","Mage, Support","Fighter, Mage","Assassin, Mage",3,0,3
1791,Fighter,"Assassin, Mage","Fighter, Tank",Mage,1,2,3
1790,"Mage, Fighter","Mage, Support",Marksman,"Support, Fighter",1,2,3
1787,Tank,"Fighter, Mage","Fighter, Assassin","Tank, Fighter",0,3,3
1386,"Assassin, Fighter","Fighter, Tank","Fighter, Tank",Fighter,1,2,3
1786,"Tank, Fighter","Support, Fighter","Assassin, Fighter","Tank, Support",2,1,3
1049,"Tank, Fighter",Fighter,"Tank, Mage","Mage, Fighter",1,2,3
1184,"Assassin, Fighter","Mage, Marksman","Assassin, Fighter","Mage, Support",1,2,3
852,"Fighter, Assassin","Mage, Fighter",Fighter,Mage,3,0,3
543,"Assassin, Fighter","Fighter, Tank",Fighter,"Tank, Support",1,2,3
579,"Marksman, Support","Support, Fighter","Marksman, Mage","Tank, Fighter",2,1,3
2363,"Fighter, Tank",Fighter,Tank,Marksman,1,2,3
2361,Tank,"Mage, Fighter","Fighter, Assassin",Fighter,1,2,3
834,Marksman,"Support, Tank","Marksman, Support","Fighter, Tank",0,3,3
578,Fighter,Fighter,Tank,"Fighter, Mage",1,2,3
838,Fighter,"Tank, Fighter","Fighter, Mage","Tank, Support",0,3,3
844,"Mage, Fighter","Assassin, Mage","Assassin, Fighter","Mage, Fighter",1,2,3
848,"Fighter, Mage","Mage, Assassin",Fighter,"Mage, Tank",1,2,3
2352,"Fighter, Assassin","Support, Tank","Fighter, Mage","Support, Fighter",1,2,3
854,"Mage, Fighter",Marksman,Fighter,"Support, Mage",2,1,3
856,Marksman,"Mage, Support","Assassin, Fighter","Mage, Tank",1,2,3
860,Fighter,"Assassin, Fighter",Tank,"Assassin, Fighter",2,1,3
2345,"Support, Mage",Fighter,"Fighter, Tank","Mage, Fighter",2,1,3
2344,"Tank, Mage","Mage, Fighter","Fighter, Tank",Fighter,1,2,3
2343,Tank,Marksman,Fighter,Fighter,0,3,3
864,"Fighter, Mage",Mage,"Tank, Fighter",Marksman,0,3,3
2341,Marksman,"Support, Mage","Fighter, Mage",Marksman,1,2,3
2367,Tank,"Fighter, Mage","Fighter, Assassin",Fighter,1,2,3
830,"Mage, Fighter","Mage, Assassin","Fighter, Assassin","Mage, Support",0,3,3
821,"Mage, Fighter","Support, Fighter","Fighter, Assassin","Tank, Support",2,1,3
609,"Tank, Fighter",Mage,"Fighter, Assassin","Support, Fighter",3,0,3
2396,Fighter,"Tank, Support","Tank, Fighter","Support, Mage",2,1,3
2394,"Fighter, Tank",Fighter,"Tank, Mage","Fighter, Tank",2,1,3
785,Marksman,"Support, Tank","Fighter, Mage","Fighter, Tank",1,2,3
788,"Tank, Mage","Support, Mage",Tank,Marksman,1,2,3
2389,"Tank, Mage","Assassin, Fighter","Fighter, Assassin","Fighter, Assassin",2,1,3
789,"Tank, Mage","Support, Fighter","Fighter, Mage","Tank, Support",3,0,3
794,"Tank, Mage","Fighter, Assassin","Tank, Fighter",Marksman,2,1,3
2386,Marksman,"Mage, Assassin","Marksman, Mage","Support, Tank",2,1,3
817,"Assassin, Fighter","Support, Tank",Fighter,"Fighter, Tank",2,1,3
2382,"Tank, Fighter","Tank, Support","Mage, Fighter","Support, Fighter",2,1,3
807,"Marksman, Assassin","Support, Tank","Marksman, Mage","Fighter, Tank",3,0,3
8974,"Mage, Fighter",Mage,"Fighter, Mage","Assassin, Mage",1,2,3
593,"Mage, Fighter","Mage, Support",Marksman,Marksman,3,0,3
8975,Fighter,Mage,"Fighter, Mage",Marksman,1,2,3
2371,"Tank, Mage","Fighter, Tank","Fighter, Mage","Fighter, Assassin",2,1,3
2370,Tank,"Fighter, Assassin","Fighter, Tank","Mage, Fighter",2,1,3
569,Tank,"Fighter, Tank",Fighter,"Fighter, Mage",1,2,3
2334,"Tank, Fighter","Fighter, Assassin","Tank, Fighter",Fighter,0,3,3
9006,Fighter,"Mage, Support",Marksman,Mage,0,3,3
914,"Assassin, Fighter","Tank, Mage",Fighter,Marksman,1,2,3
2297,"Mage, Fighter","Tank, Support",Fighter,"Tank, Fighter",1,2,3
2296,"Assassin, Fighter","Tank, Support","Tank, Fighter",Mage,1,2,3
559,"Marksman, Mage",Marksman,"Marksman, Support","Mage, Support",2,1,3
2294,"Fighter, Mage","Assassin, Fighter","Fighter, Marksman","Mage, Fighter",2,1,3
558,"Fighter, Assassin","Support, Fighter","Assassin, Fighter","Tank, Fighter",3,0,3
913,"Fighter, Mage","Assassin, Fighter",Tank,"Assassin, Fighter",3,0,3
2292,"Tank, Mage","Tank, Fighter","Fighter, Mage","Fighter, Mage",1,2,3
922,"Mage, Fighter","Mage, Support","Support, Mage",Mage,3,0,3
900,"Fighter, Assassin","Mage, Assassin","Tank, Fighter","Fighter, Marksman",2,1,3
2288,"Fighter, Mage","Support, Mage","Mage, Fighter","Tank, Support",3,0,3
2286,"Tank, Mage","Fighter, Assassin",Tank,"Assassin, Fighter",0,3,3
549,Tank,"Fighter, Tank",Fighter,"Mage, Fighter",2,1,3
2285,"Mage, Fighter","Support, Tank","Assassin, Fighter","Tank, Support",1,2,3
547,"Fighter, Assassin","Support, Tank","Assassin, Fighter",Support,1,2,3
940,Tank,Fighter,"Tank, Mage","Fighter, Assassin",2,1,3
942,"Tank, Fighter","Assassin, Fighter","Tank, Mage","Fighter, Mage",1,2,3
2298,"Fighter, Mage","Tank, Support",Fighter,"Mage, Support",0,3,3
2299,"Tank, Fighter","Fighter, Assassin","Tank, Fighter","Assassin, Fighter",1,2,3
869,"Mage, Fighter","Support, Tank","Assassin, Fighter","Mage, Assassin",2,1,3
881,Fighter,"Tank, Support","Fighter, Mage",Mage,1,2,3
870,"Fighter, Mage","Assassin, Mage",Marksman,"Mage, Marksman",2,1,3
565,"Fighter, Mage","Tank, Mage","Mage, Fighter",Marksman,3,0,3
876,"Mage, Fighter","Mage, Tank",Fighter,"Mage, Marksman",2,1,3
564,"Marksman, Support","Mage, Assassin","Marksman, Assassin",Marksman,1,2,3
2324,Fighter,"Tank, Support","Assassin, Fighter","Support, Fighter",2,1,3
2321,"Assassin, Fighter","Tank, Fighter","Fighter, Mage","Support, Fighter",1,2,3
880,"Fighter, Assassin",Mage,Fighter,"Mage, Marksman",2,1,3
2320,Fighter,"Support, Tank","Fighter, Assassin","Tank, Support",2,1,3
9031,Fighter,Mage,"Fighter, Tank",Mage,2,1,3
2316,"Fighter, Tank","Tank, Fighter","Fighter, Mage","Fighter, Assassin",2,1,3
2312,"Assassin, Mage","Tank, Fighter","Fighter, Mage","Fighter, Assassin",3,0,3
2310,Fighter,"Mage, Fighter",Tank,"Assassin, Fighter",1,2,3
2308,Fighter,"Tank, Fighter","Fighter, Mage",Mage,1,2,3
887,Fighter,"Mage, Tank",Marksman,"Mage, Support",2,1,3
2306,"Assassin, Fighter","Tank, Support",Marksman,"Support, Mage",3,0,3
893,"Assassin, Fighter","Support, Mage",Marksman,"Tank, Support",3,0,3
623,"Fighter, Marksman","Tank, Support",Marksman,"Support, Fighter",2,1,3
765,"Tank, Mage","Fighter, Mage",Tank,Fighter,2,1,3
629,"Fighter, Assassin","Mage, Assassin","Mage, Fighter","Support, Mage",1,2,3
8887,"Fighter, Mage",Mage,"Fighter, Tank",Mage,2,1,3
2520,"Tank, Fighter","Mage, Support","Fighter, Mage","Mage, Assassin",2,1,3
692,Fighter,"Tank, Support","Fighter, Assassin","Fighter, Tank",1,2,3
8879,"Assassin, Fighter","Mage, Support","Fighter, Assassin","Assassin, Mage",2,1,3
2513,"Fighter, Mage","Fighter, Assassin","Tank, Fighter",Fighter,2,1,3
2509,"Mage, Fighter","Tank, Support","Fighter, Mage","Fighter, Tank",2,1,3
2508,"Fighter, Mage","Mage, Support","Fighter, Assassin","Mage, Assassin",3,0,3
2507,"Fighter, Tank","Tank, Fighter",Mage,"Fighter, Assassin",3,0,3
2500,"Fighter, Assassin","Fighter, Assassin","Assassin, Fighter","Mage, Support",2,1,3
2526,"Marksman, Mage","Support, Tank","Marksman, Support","Fighter, Tank",2,1,3
8888,"Tank, Mage","Assassin, Mage","Tank, Fighter","Mage, Support",0,3,3
2498,"Fighter, Mage",Fighter,"Fighter, Tank","Fighter, Assassin",2,1,3
693,Fighter,"Fighter, Tank","Assassin, Fighter","Tank, Support",1,2,3
2490,"Fighter, Tank",Fighter,"Fighter, Mage","Tank, Fighter",3,0,3
2489,"Fighter, Assassin","Support, Tank","Support, Mage","Support, Tank",2,1,3
2487,"Fighter, Assassin","Fighter, Mage","Assassin, Fighter",Fighter,2,1,3
2486,"Assassin, Fighter","Support, Mage","Mage, Fighter","Mage, Assassin",0,3,3
2524,"Fighter, Assassin","Mage, Assassin","Assassin, Fighter","Support, Mage",2,1,3
2527,"Fighter, Tank",Fighter,"Assassin, Fighter","Assassin, Fighter",2,1,3
2484,"Mage, Fighter","Assassin, Fighter","Fighter, Mage",Mage,2,1,3
2557,Marksman,"Tank, Support",Fighter,"Mage, Support",2,1,3
2566,"Tank, Mage","Tank, Support","Tank, Fighter","Support, Tank",1,2,3
2564,"Fighter, Assassin","Support, Mage","Fighter, Mage","Mage, Support",0,3,3
665,"Marksman, Support","Mage, Support","Marksman, Assassin",Marksman,2,1,3
2563,"Tank, Fighter","Support, Tank","Tank, Mage","Tank, Support",2,1,3
681,"Fighter, Mage",Support,Fighter,"Support, Tank",3,0,3
687,"Tank, Mage",Fighter,"Assassin, Fighter","Fighter, Assassin",3,0,3
2558,"Fighter, Assassin","Assassin, Fighter",Marksman,"Mage, Support",3,0,3
662,"Assassin, Fighter","Tank, Support",Fighter,Mage,2,1,3
2528,Marksman,"Support, Mage","Marksman, Mage",Support,2,1,3
2555,"Marksman, Assassin","Fighter, Tank","Marksman, Mage","Support, Tank",2,1,3
2553,"Tank, Fighter","Fighter, Tank","Tank, Mage",Fighter,2,1,3
2544,"Fighter, Tank","Assassin, Fighter","Tank, Mage","Fighter, Mage",0,3,3
8856,"Assassin, Fighter","Fighter, Marksman","Fighter, Assassin",Mage,3,0,3
2537,"Fighter, Mage","Tank, Fighter","Tank, Mage","Fighter, Mage",2,1,3
8859,"Tank, Fighter","Mage, Support","Assassin, Fighter","Assassin, Mage",1,2,3
2532,"Mage, Tank","Fighter, Mage","Fighter, Tank",Fighter,3,0,3
2485,Fighter,Mage,"Fighter, Mage","Support, Fighter",2,1,3
2479,"Tank, Mage","Tank, Fighter",Mage,"Fighter, Assassin",2,1,3
8951,Fighter,"Support, Mage",Marksman,"Assassin, Mage",2,1,3
2415,"Tank, Fighter","Tank, Support","Tank, Fighter","Tank, Fighter",3,0,3
653,"Marksman, Mage",Support,Marksman,"Tank, Support",0,3,3
649,"Marksman, Support",Marksman,"Marksman, Assassin","Mage, Assassin",2,1,3
735,"Marksman, Support","Mage, Assassin","Marksman, Mage","Support, Tank",2,1,3
642,Fighter,"Support, Tank","Mage, Fighter",Support,1,2,3
2422,"Tank, Mage","Assassin, Mage","Fighter, Mage","Fighter, Assassin",2,1,3
2418,"Tank, Fighter","Fighter, Assassin","Fighter, Assassin","Fighter, Mage",3,0,3
2417,"Tank, Fighter",Mage,"Mage, Fighter","Support, Mage",3,0,3
743,"Assassin, Fighter","Fighter, Tank","Mage, Fighter","Support, Tank",1,2,3
707,"Mage, Fighter","Support, Tank",Fighter,"Fighter, Tank",1,2,3
747,"Assassin, Fighter","Tank, Support","Fighter, Assassin","Support, Fighter",1,2,3
749,Marksman,Marksman,"Fighter, Assassin","Mage, Support",2,1,3
2410,Fighter,Marksman,"Fighter, Assassin","Mage, Support",1,2,3
630,"Mage, Fighter","Tank, Support","Fighter, Assassin","Support, Fighter",1,2,3
758,Mage,"Fighter, Assassin","Tank, Mage","Tank, Fighter",1,2,3
2408,"Fighter, Assassin","Support, Fighter","Mage, Fighter","Tank, Support",2,1,3
761,"Marksman, Assassin","Support, Tank","Marksman, Support","Mage, Assassin",1,2,3
2432,"Mage, Fighter","Mage, Fighter",Fighter,"Mage, Fighter",1,2,3
8922,"Fighter, Mage","Mage, Assassin","Assassin, Fighter",Mage,3,0,3
2478,"Tank, Fighter","Support, Mage","Fighter, Mage",Support,3,0,3
2457,Tank,"Fighter, Mage","Tank, Fighter","Mage, Fighter",1,2,3
2476,"Fighter, Mage","Support, Fighter","Tank, Fighter","Tank, Fighter",3,0,3
2469,"Fighter, Tank",Support,"Assassin, Fighter","Support, Fighter",2,1,3
2466,"Mage, Fighter","Mage, Support","Fighter, Assassin","Mage, Tank",1,2,3
694,Fighter,"Assassin, Mage","Assassin, Fighter","Mage, Tank",0,3,3
2459,"Tank, Fighter","Mage, Fighter","Fighter, Tank",Marksman,2,1,3
702,Fighter,"Mage, Marksman","Mage, Fighter","Assassin, Mage",2,1,3
8903,Fighter,"Marksman, Mage","Mage, Fighter",Mage,1,2,3
2453,"Tank, Mage","Assassin, Fighter","Assassin, Fighter","Fighter, Mage",2,1,3
654,"Marksman, Support","Mage, Support","Marksman, Assassin","Mage, Assassin",3,0,3
2450,"Fighter, Assassin","Fighter, Assassin","Tank, Fighter","Mage, Fighter",1,2,3
656,"Mage, Fighter","Support, Fighter","Fighter, Mage",Support,2,1,3
705,Fighter,"Tank, Fighter","Fighter, Mage","Support, Mage",2,1,3
672,"Fighter, Assassin",Mage,Fighter,"Support, Tank",2,1,3
2442,"Fighter, Marksman","Mage, Fighter","Fighter, Mage","Fighter, Assassin",2,1,3
2441,"Tank, Fighter","Support, Fighter",Fighter,"Support, Tank",3,0,3
8911,"Tank, Fighter",Mage,"Fighter, Mage",Marksman,0,3,3
2277,"Assassin, Fighter","Mage, Marksman",Marksman,"Mage, Support",3,0,3
1597,Tank,"Tank, Fighter","Fighter, Tank","Mage, Fighter",2,1,3
1021,Fighter,"Mage, Marksman","Fighter, Mage","Mage, Fighter",3,0,3
2223,Marksman,"Assassin, Mage","Fighter, Assassin","Mage, Support",1,2,3
998,"Fighter, Mage","Marksman, Mage","Mage, Fighter","Mage, Marksman",0,3,3
954,Fighter,"Support, Fighter","Fighter, Mage",Mage,1,2,3
530,"Tank, Support","Assassin, Fighter","Mage, Fighter","Fighter, Assassin",2,1,3
9094,Fighter,"Mage, Support","Fighter, Mage","Mage, Assassin",2,1,3
2247,"Tank, Mage",Fighter,Tank,"Assassin, Fighter",1,2,3
989,"Fighter, Mage","Fighter, Mage","Tank, Mage","Assassin, Mage",1,2,3
1029,Tank,"Fighter, Mage","Assassin, Fighter",Fighter,3,0,3
9067,"Mage, Fighter","Mage, Support","Fighter, Tank",Marksman,2,1,3
9068,"Fighter, Assassin",Marksman,"Mage, Fighter","Mage, Support",0,3,3
2248,Mage,"Fighter, Assassin","Fighter, Mage","Tank, Fighter",2,1,3
533,Tank,"Assassin, Fighter","Tank, Mage","Support, Mage",0,3,3
2227,"Fighter, Mage","Support, Tank","Fighter, Tank","Support, Fighter",1,2,3
970,"Fighter, Assassin","Mage, Fighter","Assassin, Fighter",Mage,0,3,3
2239,"Fighter, Tank","Assassin, Fighter","Assassin, Fighter","Fighter, Mage",1,2,3
969,Fighter,Mage,"Tank, Fighter","Support, Fighter",2,1,3
9066,Fighter,Marksman,"Fighter, Mage","Mage, Support",1,2,3
2251,"Tank, Mage",Fighter,"Assassin, Fighter","Tank, Fighter",2,1,3
1039,"Marksman, Mage","Support, Mage",Marksman,"Fighter, Tank",2,1,3
1003,"Fighter, Assassin",Marksman,"Assassin, Fighter",Mage,2,1,3
1012,Fighter,"Mage, Marksman","Assassin, Mage",Mage,2,1,3
9088,Fighter,Mage,"Fighter, Mage","Tank, Mage",2,1,3
968,Fighter,"Support, Fighter","Assassin, Mage","Tank, Support",1,2,3
2235,"Mage, Fighter","Fighter, Tank","Assassin, Fighter","Tank, Support",2,1,3
1036,"Mage, Fighter","Fighter, Marksman","Fighter, Assassin","Mage, Support",0,3,3
2218,"Fighter, Mage","Support, Tank","Tank, Mage",Support,3,0,3
9090,Fighter,"Mage, Assassin","Fighter, Mage",Mage,2,1,3
957,"Mage, Fighter","Marksman, Mage",Fighter,"Mage, Marksman",2,1,3
961,Tank,"Assassin, Fighter","Fighter, Tank",Marksman,2,1,3
9051,Fighter,Mage,"Fighter, Assassin","Assassin, Mage",2,1,3
1009,"Assassin, Fighter","Mage, Tank",Fighter,"Mage, Marksman",2,1,3
1017,Fighter,Marksman,"Assassin, Fighter","Mage, Support",3,0,3
2214,"Fighter, Tank","Mage, Fighter","Mage, Fighter",Marksman,2,1,3
9063,"Assassin, Fighter","Mage, Assassin","Tank, Fighter","Mage, Support",3,0,3
975,"Tank, Fighter","Tank, Support","Fighter, Mage","Tank, Fighter",1,2,3
1047,Marksman,"Mage, Support","Mage, Fighter",Marksman,2,1,3
980,"Assassin, Mage",Mage,Fighter,Mage,1,2,3
945,"Fighter, Assassin","Assassin, Mage","Mage, Fighter","Mage, Fighter",2,1,3
981,Mage,"Tank, Fighter","Fighter, Mage","Assassin, Fighter",2,1,3
2244,"Fighter, Tank","Fighter, Mage","Assassin, Fighter","Assassin, Fighter",2,1,3
526,"Marksman, Support",Support,"Marksman, Mage","Support, Tank",2,1,3
9061,Fighter,Mage,"Tank, Fighter","Mage, Assassin",1,2,3
2245,"Assassin, Fighter",Fighter,"Fighter, Assassin","Fighter, Mage",1,2,3
953,Fighter,"Mage, Marksman","Fighter, Mage","Assassin, Mage",2,1,3
1001,"Assassin, Fighter","Mage, Marksman","Mage, Fighter","Assassin, Mage",0,3,3
977,"Fighter, Tank","Support, Mage",Fighter,Mage,2,1,3
2226,"Tank, Fighter",Fighter,Marksman,"Assassin, Fighter",2,1,3
2224,"Fighter, Tank","Support, Tank",Fighter,"Support, Mage",1,2,3
1044,"Fighter, Tank","Fighter, Tank","Fighter, Tank","Mage, Fighter",2,1,3
2246,Fighter,"Support, Fighter","Tank, Fighter",Mage,2,1,3
4364,Fighter,"Support, Mage","Fighter, Assassin",Marksman,1,1,2
5784,Fighter,"Assassin, Fighter","Tank, Fighter",Marksman,1,1,2
4711,"Marksman, Mage","Tank, Support","Marksman, Assassin","Tank, Fighter",0,2,2
9954,"Fighter, Mage","Fighter, Assassin",Fighter,Mage,2,0,2
9964,"Fighter, Mage","Marksman, Mage","Assassin, Fighter",Mage,2,0,2
9968,"Fighter, Mage","Marksman, Mage","Fighter, Assassin",Mage,2,0,2
9974,"Tank, Fighter","Assassin, Fighter","Fighter, Assassin","Mage, Assassin",2,0,2
4736,Marksman,Tank,Marksman,"Support, Tank",2,0,2
4719,Marksman,"Tank, Fighter","Marksman, Assassin","Mage, Support",1,1,2
5829,"Tank, Mage","Fighter, Tank","Tank, Fighter",Marksman,0,2,2
4357,Fighter,"Tank, Fighter","Tank, Fighter","Support, Mage",1,1,2
10724,"Assassin, Mage","Mage, Marksman","Assassin, Fighter","Marksman, Mage",2,0,2
5785,"Fighter, Assassin",Marksman,"Tank, Fighter",Marksman,1,1,2
4723,"Marksman, Support","Support, Fighter","Marksman, Assassin","Tank, Fighter",2,0,2
5795,Mage,"Tank, Fighter","Fighter, Tank","Mage, Fighter",1,1,2
9930,"Tank, Fighter",Mage,"Fighter, Assassin","Mage, Assassin",1,1,2
5798,"Fighter, Assassin",Fighter,"Tank, Fighter","Fighter, Assassin",1,1,2
4730,"Mage, Marksman","Support, Fighter",Marksman,"Support, Tank",2,0,2
9948,"Assassin, Fighter",Mage,"Tank, Fighter","Mage, Assassin",1,1,2
4731,"Marksman, Assassin",Support,"Marksman, Assassin","Support, Mage",0,2,2
10729,Fighter,"Mage, Marksman","Tank, Fighter",Mage,0,2,2
5815,"Fighter, Marksman","Mage, Fighter","Fighter, Tank","Fighter, Assassin",2,0,2
5818,"Tank, Mage","Tank, Mage","Fighter, Tank","Fighter, Mage",1,1,2
4355,"Tank, Fighter","Mage, Support","Fighter, Mage","Tank, Support",1,1,2
9950,"Fighter, Assassin","Assassin, Mage",Fighter,"Mage, Assassin",2,0,2
9937,"Fighter, Assassin","Mage, Assassin","Tank, Fighter","Assassin, Fighter",2,0,2
4732,"Marksman, Support",Marksman,Marksman,"Mage, Support",2,0,2
9946,"Tank, Fighter","Fighter, Marksman","Assassin, Fighter","Mage, Assassin",1,1,2
5820,"Fighter, Marksman","Tank, Fighter",Tank,"Tank, Mage",1,1,2
5797,"Fighter, Tank","Fighter, Assassin","Fighter, Assassin",Fighter,0,2,2
5796,Mage,"Tank, Fighter","Fighter, Tank","Fighter, Assassin",1,1,2
5821,"Fighter, Tank","Tank, Mage","Tank, Fighter",Fighter,1,1,2
9945,"Assassin, Fighter","Mage, Assassin","Assassin, Fighter","Assassin, Mage",1,1,2
4347,"Fighter, Mage","Support, Mage",Marksman,"Support, Fighter",1,1,2
5025,Marksman,"Mage, Marksman",Marksman,"Support, Tank",1,1,2
10707,"Assassin, Mage",Mage,"Assassin, Fighter","Mage, Marksman",0,2,2
4755,Marksman,"Support, Fighter","Marksman, Mage",Support,1,1,2
4766,Marksman,"Support, Tank","Marksman, Mage","Tank, Fighter",2,0,2
4773,"Mage, Marksman","Mage, Support","Marksman, Mage","Mage, Support",0,2,2
10062,"Fighter, Assassin","Mage, Support","Tank, Fighter",Marksman,1,1,2
4402,Marksman,"Tank, Fighter","Fighter, Marksman","Tank, Support",1,1,2
10662,Fighter,"Tank, Mage","Tank, Fighter",Mage,1,1,2
10654,Fighter,Mage,"Assassin, Mage",Mage,1,1,2
10650,Fighter,"Fighter, Marksman","Tank, Fighter",Mage,1,1,2
4406,Marksman,"Support, Fighter","Marksman, Support","Tank, Fighter",2,0,2
4776,"Marksman, Mage",Tank,"Marksman, Assassin","Support, Tank",0,2,2
4409,"Marksman, Assassin",Mage,Marksman,"Tank, Support",1,1,2
5727,"Mage, Marksman","Fighter, Assassin","Fighter, Mage","Mage, Fighter",1,1,2
4411,"Marksman, Assassin","Tank, Support","Marksman, Mage","Mage, Support",2,0,2
10068,Marksman,"Mage, Support","Fighter, Mage",Marksman,0,2,2
4412,Marksman,"Support, Mage","Marksman, Support","Tank, Fighter",1,1,2
5718,"Fighter, Assassin","Tank, Fighter",Tank,"Fighter, Mage",2,0,2
4777,"Marksman, Mage","Support, Tank","Marksman, Mage","Support, Mage",2,0,2
5717,"Fighter, Tank","Mage, Fighter","Support, Tank","Fighter, Assassin",1,1,2
4413,Marksman,"Support, Tank","Marksman, Mage",Mage,1,1,2
10075,"Fighter, Mage","Assassin, Fighter","Tank, Mage","Mage, Support",1,1,2
5708,"Fighter, Mage","Tank, Fighter",Tank,"Fighter, Mage",1,1,2
4778,Marksman,"Tank, Support","Marksman, Assassin","Tank, Fighter",1,1,2
5706,"Fighter, Tank","Mage, Fighter","Tank, Mage","Fighter, Mage",0,2,2
4620,Marksman,"Support, Mage","Marksman, Mage","Mage, Assassin",1,1,2
10079,"Fighter, Mage","Mage, Support","Tank, Mage","Tank, Mage",2,0,2
4779,Marksman,"Support, Fighter","Marksman, Mage",Tank,2,0,2
4417,"Marksman, Assassin","Support, Tank","Marksman, Assassin","Fighter, Tank",1,1,2
5703,"Tank, Mage","Mage, Fighter","Fighter, Tank","Tank, Fighter",1,1,2
10053,"Mage, Fighter","Mage, Support",Marksman,"Assassin, Fighter",1,1,2
5745,"Tank, Fighter","Mage, Fighter",Fighter,"Assassin, Fighter",1,1,2
5782,"Tank, Fighter",Marksman,"Marksman, Fighter",Fighter,2,0,2
4752,"Marksman, Assassin","Support, Fighter","Marksman, Assassin","Support, Mage",2,0,2
5776,"Tank, Mage","Tank, Fighter",Tank,Fighter,2,0,2
5775,"Fighter, Tank","Tank, Fighter","Tank, Mage","Tank, Mage",0,2,2
5773,"Fighter, Tank","Tank, Fighter","Fighter, Assassin","Tank, Mage",2,0,2
10012,"Assassin, Fighter","Mage, Fighter","Mage, Fighter","Mage, Fighter",1,1,2
5769,"Tank, Fighter",Fighter,"Support, Mage",Marksman,2,0,2
5766,"Fighter, Tank",Marksman,"Fighter, Tank",Fighter,1,1,2
9927,"Tank, Fighter",Mage,Fighter,"Assassin, Mage",1,1,2
5764,"Tank, Fighter","Mage, Fighter",Tank,Fighter,1,1,2
4368,"Fighter, Mage","Tank, Support","Tank, Fighter","Support, Fighter",1,1,2
10013,Marksman,"Mage, Fighter","Mage, Fighter","Marksman, Mage",2,0,2
4381,"Assassin, Fighter","Tank, Fighter","Fighter, Mage","Tank, Support",1,1,2
10021,Marksman,"Mage, Fighter","Fighter, Assassin","Assassin, Mage",2,0,2
10026,"Mage, Fighter","Assassin, Mage","Fighter, Assassin","Support, Mage",2,0,2
10030,"Mage, Fighter",Marksman,"Assassin, Fighter","Assassin, Mage",2,0,2
10038,Marksman,"Assassin, Mage","Assassin, Fighter","Mage, Tank",2,0,2
5757,Tank,Fighter,"Tank, Mage","Assassin, Fighter",0,2,2
10043,"Assassin, Fighter",Mage,"Mage, Fighter",Mage,2,0,2
4390,"Marksman, Assassin","Tank, Support","Marksman, Mage","Tank, Fighter",1,1,2
10683,"Mage, Fighter",Mage,"Fighter, Tank","Support, Mage",2,0,2
4748,Mage,"Support, Mage","Marksman, Mage","Support, Mage",1,1,2
10044,Marksman,"Mage, Fighter","Assassin, Fighter","Mage, Marksman",1,1,2
4394,Marksman,"Fighter, Tank","Marksman, Mage","Support, Mage",1,1,2
5754,"Assassin, Fighter","Mage, Fighter","Tank, Mage",Marksman,0,2,2
4630,"Marksman, Support","Tank, Support","Marksman, Mage","Support, Mage",2,0,2
5753,"Assassin, Fighter","Fighter, Assassin","Tank, Mage","Assassin, Fighter",1,1,2
5752,"Fighter, Assassin",Marksman,"Tank, Mage",Marksman,1,1,2
5748,"Mage, Fighter","Assassin, Fighter","Assassin, Fighter","Fighter, Mage",1,1,2
5765,"Support, Mage","Mage, Fighter","Fighter, Tank",Fighter,0,2,2
4333,"Fighter, Mage","Mage, Support",Marksman,"Mage, Support",2,0,2
5837,Tank,"Fighter, Tank","Tank, Fighter",Marksman,1,1,2
5922,"Tank, Fighter","Fighter, Assassin","Tank, Mage","Fighter, Tank",1,1,2
5963,"Fighter, Tank","Assassin, Fighter","Fighter, Tank","Tank, Fighter",1,1,2
10875,Marksman,Mage,Fighter,"Mage, Tank",0,2,2
5956,"Fighter, Tank","Fighter, Tank","Fighter, Assassin","Assassin, Fighter",0,2,2
9798,"Assassin, Fighter","Mage, Tank","Mage, Fighter","Mage, Support",1,1,2
5951,"Fighter, Tank","Mage, Fighter","Fighter, Assassin","Fighter, Tank",2,0,2
10971,"Assassin, Fighter","Marksman, Mage","Mage, Fighter","Mage, Marksman",1,1,2
9803,"Assassin, Fighter","Fighter, Marksman","Tank, Fighter","Mage, Support",0,2,2
4245,"Tank, Fighter","Tank, Fighter","Fighter, Assassin","Fighter, Tank",1,1,2
4652,"Marksman, Assassin","Mage, Support","Marksman, Assassin","Mage, Support",0,2,2
9806,Marksman,"Mage, Support",Fighter,"Mage, Fighter",0,2,2
9813,"Fighter, Mage",Mage,"Fighter, Tank","Mage, Tank",2,0,2
9824,"Fighter, Assassin",Mage,"Tank, Fighter","Marksman, Mage",2,0,2
5941,"Tank, Fighter","Mage, Fighter","Fighter, Tank","Tank, Fighter",1,1,2
9825,"Mage, Fighter",Mage,"Fighter, Assassin","Mage, Assassin",0,2,2
5939,"Tank, Mage","Tank, Fighter","Fighter, Assassin","Tank, Mage",1,1,2
5938,"Tank, Mage","Tank, Fighter","Fighter, Tank","Fighter, Tank",2,0,2
10828,"Tank, Fighter",Mage,"Tank, Fighter","Tank, Mage",1,1,2
5937,"Fighter, Tank","Tank, Fighter","Assassin, Fighter",Fighter,0,2,2
9832,"Mage, Fighter","Support, Mage",Fighter,"Mage, Fighter",1,1,2
9837,Fighter,"Mage, Assassin",Marksman,Mage,1,1,2
9845,"Mage, Fighter","Mage, Fighter",Marksman,"Mage, Assassin",0,2,2
9846,"Assassin, Mage",Mage,"Mage, Fighter",Mage,0,2,2
9848,"Assassin, Fighter","Assassin, Mage",Fighter,"Assassin, Mage",1,1,2
4253,"Fighter, Tank",Mage,"Fighter, Mage","Support, Mage",2,0,2
4648,"Marksman, Mage","Support, Mage","Marksman, Support","Tank, Support",1,1,2
9850,"Fighter, Assassin","Mage, Support","Fighter, Tank","Marksman, Mage",1,1,2
5924,"Assassin, Fighter",Fighter,"Tank, Mage","Fighter, Assassin",0,2,2
4238,Marksman,"Fighter, Tank","Mage, Fighter","Support, Fighter",1,1,2
10961,"Assassin, Fighter","Fighter, Marksman",Marksman,"Support, Mage",0,2,2
9792,"Mage, Fighter","Mage, Assassin",Fighter,"Mage, Tank",2,0,2
4667,Marksman,"Tank, Fighter","Fighter, Marksman","Support, Mage",0,2,2
9720,"Mage, Fighter","Mage, Support","Assassin, Fighter","Fighter, Marksman",1,1,2
10908,Fighter,"Mage, Fighter","Assassin, Fighter","Mage, Assassin",0,2,2
4681,"Marksman, Support","Tank, Fighter",Marksman,"Support, Fighter",1,1,2
6023,"Assassin, Fighter","Assassin, Fighter","Fighter, Tank",Fighter,1,1,2
6021,"Mage, Fighter","Assassin, Fighter","Assassin, Fighter",Fighter,0,2,2
9723,Fighter,"Support, Mage","Fighter, Assassin","Assassin, Mage",0,2,2
6019,"Fighter, Mage","Fighter, Assassin","Fighter, Assassin","Mage, Fighter",1,1,2
6014,"Fighter, Tank","Assassin, Fighter","Fighter, Tank","Fighter, Tank",2,0,2
4674,"Fighter, Marksman","Tank, Fighter",Marksman,"Support, Mage",2,0,2
4668,"Fighter, Marksman","Tank, Fighter",Marksman,"Tank, Support",1,1,2
6004,"Tank, Mage",Fighter,"Mage, Tank","Tank, Fighter",1,1,2
4225,Fighter,"Tank, Support","Fighter, Assassin",Mage,2,0,2
4685,"Marksman, Mage","Tank, Support","Marksman, Assassin","Support, Mage",1,1,2
9790,Fighter,"Tank, Mage","Tank, Fighter","Mage, Assassin",0,2,2
10882,"Assassin, Fighter","Marksman, Mage",Fighter,Mage,1,1,2
5997,Mage,Fighter,"Fighter, Tank","Tank, Fighter",1,1,2
9747,"Fighter, Tank",Mage,"Fighter, Mage","Mage, Marksman",1,1,2
5991,"Fighter, Tank",Fighter,"Fighter, Assassin",Marksman,1,1,2
9748,"Fighter, Tank","Mage, Tank","Assassin, Fighter",Mage,2,0,2
9759,Fighter,"Marksman, Mage","Assassin, Fighter",Mage,1,1,2
9761,Fighter,"Mage, Support","Fighter, Mage","Mage, Marksman",0,2,2
4687,"Marksman, Support","Fighter, Tank",Marksman,"Mage, Support",1,1,2
9769,"Fighter, Mage",Mage,"Tank, Fighter","Support, Mage",1,1,2
4688,Marksman,"Tank, Support","Marksman, Assassin","Tank, Support",1,1,2
9780,Marksman,"Assassin, Mage",Marksman,"Mage, Marksman",1,1,2
5976,"Fighter, Tank",Fighter,"Assassin, Fighter","Fighter, Assassin",1,1,2
5923,"Fighter, Tank","Tank, Fighter","Tank, Mage","Fighter, Tank",2,0,2
4647,"Marksman, Support","Support, Fighter",Marksman,"Tank, Fighter",1,1,2
9921,"Fighter, Mage","Mage, Assassin","Assassin, Fighter","Assassin, Mage",1,1,2
4265,"Mage, Fighter","Tank, Support","Fighter, Assassin","Mage, Support",0,2,2
9889,"Mage, Fighter","Assassin, Mage",Marksman,"Mage, Support",2,0,2
9890,"Mage, Fighter","Mage, Support","Fighter, Mage","Marksman, Mage",0,2,2
5881,"Fighter, Mage","Assassin, Fighter","Tank, Mage","Fighter, Mage",2,0,2
9898,"Assassin, Fighter",Mage,"Fighter, Mage","Mage, Assassin",1,1,2
5877,"Fighter, Tank","Mage, Fighter","Tank, Mage","Tank, Fighter",1,1,2
10741,"Fighter, Assassin",Mage,"Tank, Fighter","Assassin, Mage",1,1,2
5872,"Fighter, Assassin","Assassin, Fighter","Fighter, Tank","Fighter, Tank",0,2,2
10737,"Tank, Fighter","Mage, Marksman",Fighter,"Assassin, Mage",2,0,2
5869,"Fighter, Mage","Assassin, Fighter","Assassin, Fighter","Assassin, Fighter",1,1,2
4640,"Marksman, Mage",Marksman,Marksman,"Mage, Assassin",0,2,2
5862,"Assassin, Fighter","Assassin, Fighter","Tank, Fighter","Fighter, Assassin",0,2,2
5861,"Fighter, Mage","Tank, Fighter","Tank, Mage","Mage, Fighter",1,1,2
9902,"Fighter, Mage",Mage,"Fighter, Assassin","Mage, Tank",2,0,2
5855,"Fighter, Tank",Fighter,"Fighter, Assassin","Assassin, Fighter",0,2,2
9916,"Assassin, Fighter",Mage,Fighter,"Marksman, Mage",1,1,2
9917,Fighter,"Assassin, Fighter","Tank, Fighter","Assassin, Mage",1,1,2
4331,Marksman,"Tank, Support",Fighter,"Tank, Fighter",0,2,2
4332,"Fighter, Mage","Tank, Fighter","Mage, Fighter","Support, Tank",0,2,2
5847,"Tank, Fighter","Fighter, Assassin","Fighter, Mage",Marksman,1,1,2
4420,Marksman,"Fighter, Tank","Marksman, Support","Support, Mage",1,1,2
5846,"Tank, Mage",Marksman,"Fighter, Mage","Fighter, Assassin",0,2,2
4705,"Marksman, Support","Support, Tank","Marksman, Mage","Tank, Mage",1,1,2
5845,"Fighter, Marksman","Mage, Fighter","Fighter, Mage",Marksman,2,0,2
4707,"Marksman, Assassin",Tank,Marksman,"Tank, Support",2,0,2
4340,"Mage, Fighter","Support, Fighter","Fighter, Tank","Support, Mage",2,0,2
5840,"Tank, Fighter","Fighter, Assassin",Tank,Marksman,1,1,2
5839,Marksman,"Fighter, Mage","Tank, Mage",Marksman,1,1,2
10750,Fighter,Mage,"Fighter, Assassin","Mage, Assassin",1,1,2
9888,"Assassin, Fighter","Assassin, Fighter",Marksman,"Assassin, Mage",2,0,2
9887,"Mage, Fighter",Mage,"Assassin, Fighter","Assassin, Fighter",2,0,2
9865,"Mage, Fighter",Mage,Marksman,"Mage, Assassin",1,1,2
4267,"Fighter, Assassin","Tank, Fighter","Mage, Fighter","Support, Tank",1,1,2
4275,"Fighter, Mage","Support, Fighter","Tank, Fighter","Support, Mage",0,2,2
5919,"Fighter, Tank","Tank, Fighter","Fighter, Assassin","Assassin, Fighter",2,0,2
5914,"Fighter, Mage",Fighter,"Fighter, Assassin","Tank, Fighter",1,1,2
4692,Marksman,"Tank, Support","Marksman, Support","Mage, Support",1,1,2
9853,"Tank, Fighter","Assassin, Mage","Fighter, Assassin","Mage, Support",2,0,2
4286,Fighter,"Support, Mage","Fighter, Tank",Mage,1,1,2
10817,"Fighter, Assassin","Assassin, Mage","Tank, Fighter","Support, Mage",0,2,2
4291,"Fighter, Mage","Support, Mage","Fighter, Assassin","Mage, Marksman",0,2,2
4693,Marksman,"Tank, Support","Marksman, Support","Fighter, Tank",1,1,2
4694,"Marksman, Mage","Mage, Support",Marksman,"Fighter, Tank",1,1,2
5906,Mage,Fighter,"Fighter, Assassin","Fighter, Assassin",2,0,2
4300,"Mage, Fighter","Tank, Fighter",Fighter,"Fighter, Tank",1,1,2
10768,"Mage, Fighter","Support, Mage","Fighter, Assassin",Mage,1,1,2
5902,Fighter,"Mage, Fighter","Marksman, Fighter","Tank, Fighter",1,1,2
5901,Mage,Fighter,"Fighter, Assassin",Marksman,1,1,2
5900,"Tank, Mage","Assassin, Fighter","Mage, Fighter","Mage, Fighter",1,1,2
4308,"Fighter, Tank","Mage, Support","Mage, Fighter","Tank, Support",0,2,2
5891,"Fighter, Marksman","Mage, Fighter","Fighter, Assassin",Marksman,0,2,2
4309,Marksman,"Tank, Fighter","Mage, Fighter","Support, Fighter",0,2,2
4317,"Tank, Fighter","Tank, Support","Assassin, Fighter","Support, Tank",1,1,2
4319,"Fighter, Tank","Mage, Support","Fighter, Tank","Tank, Support",1,1,2
4324,Fighter,"Tank, Support",Marksman,"Fighter, Tank",2,0,2
9870,"Assassin, Fighter","Mage, Tank",Fighter,"Fighter, Assassin",2,0,2
4695,Marksman,"Tank, Support","Marksman, Mage","Tank, Support",1,1,2
4642,"Marksman, Assassin",Support,Marksman,"Tank, Fighter",2,0,2
10091,"Fighter, Assassin","Assassin, Mage","Mage, Fighter","Mage, Support",0,2,2
4797,Marksman,Tank,"Marksman, Assassin","Support, Fighter",1,1,2
5699,Tank,"Mage, Fighter","Fighter, Tank","Tank, Fighter",1,1,2
10481,"Assassin, Fighter","Marksman, Mage","Fighter, Assassin",Mage,1,1,2
4509,"Marksman, Mage","Mage, Support",Marksman,Mage,0,2,2
4909,"Fighter, Assassin","Mage, Support","Fighter, Assassin","Support, Fighter",1,1,2
10360,"Fighter, Mage",Mage,Fighter,"Tank, Mage",1,1,2
5482,"Fighter, Tank","Fighter, Mage","Fighter, Assassin","Assassin, Fighter",1,1,2
5481,"Fighter, Marksman","Fighter, Mage","Fighter, Tank","Tank, Fighter",1,1,2
4519,Marksman,"Mage, Assassin","Marksman, Assassin","Support, Tank",2,0,2
4521,"Marksman, Mage","Mage, Support","Marksman, Mage",Marksman,2,0,2
4917,"Tank, Fighter","Tank, Fighter","Fighter, Assassin","Support, Tank",0,2,2
4923,"Fighter, Assassin","Support, Mage","Tank, Fighter","Mage, Support",1,1,2
10377,"Assassin, Fighter","Fighter, Marksman","Fighter, Assassin","Assassin, Mage",0,2,2
10381,"Assassin, Fighter",Mage,"Support, Mage","Mage, Support",0,2,2
10385,"Assassin, Fighter","Mage, Fighter","Mage, Fighter",Marksman,2,0,2
10400,"Assassin, Fighter","Assassin, Mage","Assassin, Fighter","Assassin, Mage",0,2,2
5472,"Tank, Fighter","Tank, Mage","Fighter, Mage","Tank, Fighter",2,0,2
4930,"Tank, Fighter","Support, Tank","Fighter, Mage","Tank, Fighter",1,1,2
5471,"Tank, Fighter",Fighter,"Fighter, Mage","Fighter, Assassin",0,2,2
4523,Marksman,"Fighter, Tank","Marksman, Assassin","Support, Mage",0,2,2
5466,"Tank, Fighter","Fighter, Mage","Fighter, Mage","Support, Mage",1,1,2
5465,"Tank, Mage","Mage, Fighter","Fighter, Assassin","Fighter, Mage",2,0,2
10462,"Assassin, Fighter","Tank, Mage",Marksman,"Mage, Support",2,0,2
10463,Fighter,"Mage, Support","Mage, Fighter","Assassin, Fighter",2,0,2
10472,Fighter,"Marksman, Mage","Assassin, Fighter","Mage, Assassin",2,0,2
5457,"Fighter, Mage","Tank, Fighter","Tank, Fighter","Fighter, Assassin",1,1,2
10476,"Tank, Fighter","Mage, Assassin","Fighter, Assassin",Mage,2,0,2
5453,"Tank, Fighter","Assassin, Mage","Tank, Fighter","Assassin, Mage",0,2,2
5440,"Marksman, Assassin","Support, Mage","Marksman, Assassin","Mage, Support",1,1,2
5438,"Marksman, Assassin","Support, Mage",Marksman,"Mage, Marksman",2,0,2
4507,Marksman,"Mage, Support","Marksman, Support","Support, Fighter",0,2,2
10348,"Fighter, Mage","Assassin, Mage","Mage, Fighter","Assassin, Mage",0,2,2
5491,"Fighter, Tank","Assassin, Fighter","Fighter, Assassin",Marksman,2,0,2
5521,"Fighter, Tank","Fighter, Assassin","Fighter, Marksman","Mage, Fighter",2,0,2
5536,"Fighter, Tank","Support, Mage","Tank, Fighter","Assassin, Fighter",2,0,2
4590,"Marksman, Support","Support, Fighter","Marksman, Assassin","Tank, Support",1,1,2
10297,"Fighter, Assassin","Assassin, Mage","Fighter, Tank",Marksman,0,2,2
10300,Marksman,Marksman,"Fighter, Mage","Support, Mage",1,1,2
5528,"Tank, Fighter","Mage, Fighter",Fighter,"Support, Mage",1,1,2
10304,Marksman,"Mage, Marksman","Fighter, Mage","Assassin, Fighter",1,1,2
5526,"Fighter, Marksman","Mage, Fighter","Tank, Fighter","Fighter, Assassin",0,2,2
10319,Marksman,Marksman,"Mage, Fighter","Assassin, Mage",1,1,2
4485,"Marksman, Assassin","Mage, Support",Mage,"Support, Tank",2,0,2
5525,"Tank, Fighter","Assassin, Fighter","Fighter, Marksman","Mage, Fighter",1,1,2
5523,"Tank, Mage","Fighter, Mage","Fighter, Marksman","Tank, Fighter",1,1,2
4886,"Marksman, Assassin","Mage, Support",Marksman,"Mage, Marksman",0,2,2
4896,"Marksman, Assassin","Mage, Support","Marksman, Mage",Mage,0,2,2
10336,"Fighter, Mage",Mage,"Assassin, Fighter",Marksman,2,0,2
5516,"Fighter, Marksman","Fighter, Tank","Fighter, Assassin","Assassin, Fighter",1,1,2
5513,"Fighter, Marksman",Fighter,"Fighter, Tank","Assassin, Fighter",2,0,2
5510,"Fighter, Mage",Marksman,Tank,"Fighter, Assassin",1,1,2
4496,Marksman,"Tank, Fighter","Marksman, Mage","Fighter, Tank",1,1,2
5508,"Fighter, Mage","Mage, Fighter",Tank,"Assassin, Fighter",1,1,2
5506,Fighter,"Assassin, Fighter",Tank,"Fighter, Assassin",0,2,2
4505,Marksman,"Tank, Fighter","Marksman, Support","Mage, Support",1,1,2
5501,"Assassin, Fighter","Fighter, Assassin","Fighter, Tank","Fighter, Mage",2,0,2
10328,"Fighter, Tank","Tank, Mage",Fighter,Mage,1,1,2
4506,"Marksman, Mage",Support,Marksman,"Support, Tank",1,1,2
10329,"Fighter, Mage","Tank, Mage","Tank, Fighter",Mage,0,2,2
5495,"Fighter, Mage","Support, Mage","Mage, Marksman","Assassin, Fighter",2,0,2
4939,"Assassin, Fighter","Support, Tank","Assassin, Fighter","Support, Fighter",1,1,2
10490,"Fighter, Tank","Mage, Support","Fighter, Assassin","Tank, Mage",0,2,2
5539,"Fighter, Marksman","Support, Mage","Tank, Fighter","Assassin, Fighter",1,1,2
5379,Marksman,"Tank, Support","Marksman, Assassin",Mage,2,0,2
4568,Marksman,"Support, Mage","Support, Mage",Marksman,1,1,2
5114,"Support, Mage","Mage, Support","Assassin, Fighter",Mage,1,1,2
10507,Marksman,"Mage, Fighter","Fighter, Mage","Assassin, Fighter",1,1,2
6029,"Tank, Fighter","Assassin, Fighter",Mage,"Mage, Fighter",1,1,2
5102,"Fighter, Tank","Tank, Mage","Assassin, Fighter","Mage, Support",0,2,2
5096,"Support, Mage","Mage, Support",Marksman,"Mage, Assassin",1,1,2
5095,"Mage, Fighter","Support, Mage","Assassin, Fighter",Marksman,1,1,2
5091,"Fighter, Tank","Mage, Support",Fighter,Mage,0,2,2
5001,"Assassin, Fighter","Support, Tank","Support, Mage","Support, Tank",0,2,2
5069,"Tank, Fighter","Tank, Fighter","Fighter, Mage","Support, Tank",0,2,2
5068,"Fighter, Mage","Support, Fighter","Assassin, Fighter","Mage, Support",2,0,2
5065,"Fighter, Tank","Support, Mage","Fighter, Mage",Mage,0,2,2
5060,"Fighter, Tank","Support, Tank","Tank, Fighter","Tank, Support",1,1,2
5056,"Fighter, Tank","Support, Fighter","Tank, Fighter","Support, Tank",1,1,2
5044,"Fighter, Tank","Support, Tank","Assassin, Fighter","Support, Tank",1,1,2
5042,Marksman,"Mage, Support","Fighter, Marksman","Support, Mage",1,1,2
5041,"Tank, Fighter","Mage, Support","Tank, Mage","Support, Mage",0,2,2
5037,"Assassin, Fighter","Support, Tank","Tank, Fighter","Tank, Fighter",1,1,2
5004,"Tank, Fighter","Support, Tank","Fighter, Assassin",Support,1,1,2
5035,"Tank, Fighter","Support, Tank","Fighter, Tank","Support, Fighter",2,0,2
10513,"Assassin, Fighter",Mage,Fighter,Marksman,1,1,2
4539,"Marksman, Mage","Support, Fighter","Marksman, Mage",Support,1,1,2
5005,"Tank, Fighter",Tank,"Tank, Fighter","Tank, Support",1,1,2
4545,"Marksman, Mage","Support, Mage",Marksman,Support,0,2,2
5029,Marksman,Tank,Marksman,"Support, Fighter",1,1,2
5012,Marksman,"Tank, Fighter","Fighter, Assassin","Support, Tank",1,1,2
10543,Marksman,"Mage, Fighter","Mage, Fighter","Assassin, Fighter",1,1,2
4537,"Marksman, Mage","Fighter, Tank",Marksman,"Tank, Fighter",2,0,2
10503,"Fighter, Assassin","Assassin, Mage","Assassin, Fighter","Mage, Fighter",0,2,2
4570,"Marksman, Support","Tank, Support",Marksman,Support,1,1,2
10570,Marksman,"Mage, Tank","Fighter, Tank",Mage,1,1,2
10494,"Assassin, Fighter","Assassin, Fighter","Tank, Fighter",Mage,2,0,2
5361,Marksman,Mage,"Marksman, Support","Tank, Support",0,2,2
4943,"Tank, Fighter","Support, Mage","Mage, Fighter","Support, Fighter",0,2,2
5359,Marksman,Mage,"Marksman, Mage","Support, Fighter",0,2,2
5353,Marksman,"Support, Mage",Marksman,Tank,1,1,2
4968,Fighter,"Support, Fighter","Fighter, Tank","Tank, Support",1,1,2
5324,"Marksman, Assassin","Mage, Support",Marksman,"Fighter, Tank",1,1,2
10576,"Mage, Fighter",Fighter,"Fighter, Mage",Mage,0,2,2
5305,Marksman,"Mage, Support","Marksman, Support","Tank, Fighter",1,1,2
5295,"Marksman, Assassin","Support, Fighter","Marksman, Mage","Mage, Assassin",2,0,2
4973,Marksman,"Support, Mage","Fighter, Assassin","Tank, Support",0,2,2
10496,Marksman,Marksman,"Mage, Fighter","Mage, Support",2,0,2
5264,"Mage, Fighter",Tank,"Fighter, Mage","Support, Tank",2,0,2
10500,"Assassin, Fighter",Marksman,Marksman,"Mage, Assassin",1,1,2
5240,"Fighter, Tank","Support, Mage","Mage, Fighter","Tank, Fighter",1,1,2
5229,"Fighter, Assassin","Mage, Support",Marksman,Marksman,0,2,2
5213,"Fighter, Assassin",Mage,"Assassin, Fighter","Support, Mage",1,1,2
4977,"Support, Mage",Marksman,Fighter,"Mage, Support",1,1,2
5193,"Assassin, Fighter",Marksman,"Fighter, Tank","Mage, Support",2,0,2
5191,"Tank, Fighter","Support, Mage","Marksman, Mage","Support, Mage",0,2,2
5181,"Fighter, Mage","Support, Mage","Fighter, Tank","Assassin, Fighter",0,2,2
10569,"Fighter, Mage","Mage, Tank",Marksman,"Mage, Support",1,1,2
5177,Fighter,"Mage, Assassin","Mage, Fighter","Mage, Support",1,1,2
5175,"Assassin, Fighter","Mage, Support",Fighter,"Mage, Assassin",1,1,2
4986,"Fighter, Tank","Support, Mage","Tank, Fighter","Support, Tank",1,1,2
5131,Fighter,"Mage, Support","Fighter, Tank","Support, Fighter",0,2,2
10294,Marksman,"Support, Mage","Fighter, Mage",Mage,1,1,2
10292,"Fighter, Assassin","Assassin, Fighter",Fighter,Mage,1,1,2
10104,"Fighter, Assassin","Mage, Assassin","Fighter, Tank",Mage,0,2,2
5611,Fighter,Fighter,"Tank, Fighter","Fighter, Mage",1,1,2
5657,"Tank, Mage",Marksman,"Fighter, Assassin",Fighter,0,2,2
5656,Tank,"Support, Mage","Tank, Mage","Assassin, Fighter",1,1,2
4443,Marksman,"Support, Tank","Marksman, Support",Support,1,1,2
4812,"Marksman, Support","Support, Mage","Mage, Marksman","Mage, Support",2,0,2
10143,"Mage, Fighter","Mage, Assassin","Fighter, Assassin",Mage,1,1,2
4814,Marksman,"Support, Tank","Marksman, Mage",Support,2,0,2
5649,"Tank, Fighter","Assassin, Fighter",Tank,"Mage, Fighter",0,2,2
4819,Marksman,"Mage, Assassin","Marksman, Mage",Marksman,1,1,2
5645,Tank,"Assassin, Fighter","Fighter, Assassin",Fighter,1,1,2
10145,"Fighter, Tank","Mage, Support",Fighter,"Mage, Marksman",2,0,2
4616,Marksman,"Support, Mage",Marksman,"Mage, Assassin",2,0,2
10149,"Fighter, Tank","Mage, Assassin","Fighter, Mage","Mage, Tank",1,1,2
4610,"Marksman, Mage","Support, Mage","Marksman, Mage","Mage, Assassin",1,1,2
4448,"Marksman, Assassin","Mage, Support","Marksman, Mage","Tank, Support",2,0,2
4449,"Marksman, Assassin","Tank, Support","Marksman, Assassin","Support, Mage",1,1,2
4820,Mage,"Mage, Support","Marksman, Mage","Mage, Support",1,1,2
4451,"Marksman, Assassin","Mage, Support","Marksman, Assassin","Support, Mage",0,2,2
10166,"Mage, Fighter","Assassin, Fighter",Marksman,"Assassin, Fighter",2,0,2
5639,"Tank, Mage","Support, Mage",Tank,"Assassin, Fighter",2,0,2
5633,"Tank, Fighter","Support, Mage","Fighter, Mage",Marksman,2,0,2
5632,"Fighter, Assassin","Tank, Fighter","Tank, Mage","Mage, Fighter",2,0,2
5625,"Tank, Fighter","Fighter, Mage","Tank, Mage","Mage, Fighter",1,1,2
10180,"Fighter, Mage","Assassin, Mage","Assassin, Fighter","Mage, Support",0,2,2
10187,"Assassin, Fighter","Mage, Support","Support, Mage","Assassin, Mage",0,2,2
5622,Fighter,"Mage, Fighter","Mage, Fighter","Fighter, Mage",2,0,2
10199,Fighter,"Mage, Tank",Marksman,"Mage, Marksman",1,1,2
5616,"Fighter, Assassin","Mage, Fighter","Tank, Fighter","Tank, Fighter",1,1,2
10138,"Tank, Fighter","Mage, Support","Mage, Fighter","Mage, Tank",1,1,2
5661,"Fighter, Assassin",Fighter,"Support, Tank","Mage, Fighter",1,1,2
10137,"Assassin, Fighter","Mage, Support","Fighter, Mage","Mage, Marksman",1,1,2
5684,"Fighter, Mage",Marksman,"Fighter, Tank",Fighter,0,2,2
10114,Marksman,Mage,"Fighter, Mage","Mage, Marksman",1,1,2
4780,"Marksman, Mage","Support, Mage","Marksman, Mage","Support, Fighter",0,2,2
5694,"Fighter, Tank",Fighter,"Fighter, Assassin","Fighter, Assassin",2,0,2
4792,"Marksman, Mage","Tank, Fighter","Marksman, Mage","Support, Tank",0,2,2
4794,"Marksman, Mage","Fighter, Tank","Marksman, Mage","Tank, Support",1,1,2
4619,Marksman,"Support, Fighter",Marksman,"Mage, Marksman",2,0,2
5692,"Fighter, Tank","Tank, Fighter","Fighter, Marksman",Fighter,2,0,2
4796,"Marksman, Mage","Tank, Support",Marksman,Tank,1,1,2
5687,Tank,"Fighter, Mage","Fighter, Tank","Tank, Mage",2,0,2
10120,Marksman,"Mage, Fighter",Marksman,Mage,2,0,2
4800,"Marksman, Mage",Tank,"Marksman, Mage","Support, Tank",0,2,2
4802,"Marksman, Assassin","Mage, Support","Marksman, Mage","Fighter, Tank",2,0,2
10121,Marksman,Mage,Marksman,"Mage, Fighter",0,2,2
5665,"Fighter, Mage","Fighter, Tank","Fighter, Tank",Fighter,1,1,2
4433,Marksman,Support,Marksman,"Support, Mage",1,1,2
10126,Marksman,Mage,"Mage, Fighter",Fighter,1,1,2
10649,"Fighter, Assassin","Mage, Assassin","Tank, Fighter","Marksman, Mage",2,0,2
10128,Marksman,"Assassin, Mage","Mage, Fighter","Assassin, Fighter",0,2,2
5677,"Fighter, Assassin","Assassin, Fighter","Fighter, Assassin","Mage, Fighter",1,1,2
5676,"Fighter, Mage",Fighter,"Fighter, Assassin","Mage, Fighter",0,2,2
5671,"Tank, Mage",Fighter,"Fighter, Assassin","Mage, Fighter",1,1,2
10129,"Fighter, Tank","Assassin, Mage","Assassin, Fighter",Mage,0,2,2
10132,"Fighter, Mage","Mage, Fighter",Fighter,"Mage, Tank",2,0,2
4440,"Marksman, Mage","Support, Tank",Marksman,"Fighter, Mage",2,0,2
4805,Marksman,"Fighter, Tank","Marksman, Assassin","Mage, Support",2,0,2
10133,Fighter,"Mage, Marksman",Marksman,Mage,2,0,2
5615,"Support, Mage",Fighter,Mage,"Assassin, Fighter",1,1,2
5607,"Fighter, Assassin",Marksman,"Tank, Fighter","Assassin, Fighter",0,2,2
5544,"Fighter, Mage","Fighter, Assassin",Tank,"Tank, Fighter",1,1,2
5606,"Tank, Fighter","Assassin, Fighter","Support, Mage",Fighter,2,0,2
10237,"Mage, Fighter","Mage, Marksman",Marksman,"Support, Mage",1,1,2
10242,"Fighter, Tank","Mage, Tank",Fighter,Mage,2,0,2
5568,"Fighter, Tank","Mage, Fighter","Fighter, Mage","Tank, Fighter",2,0,2
4860,"Marksman, Assassin",Mage,Marksman,"Support, Fighter",1,1,2
4862,"Marksman, Mage","Tank, Fighter","Marksman, Assassin","Support, Mage",1,1,2
4601,"Marksman, Mage","Mage, Support","Marksman, Support","Tank, Fighter",1,1,2
4471,Marksman,"Tank, Mage",Marksman,"Tank, Support",1,1,2
10599,"Fighter, Mage",Mage,"Fighter, Assassin","Mage, Assassin",0,2,2
4474,"Marksman, Mage","Fighter, Tank",Marksman,"Mage, Support",1,1,2
10254,"Mage, Fighter","Mage, Marksman","Assassin, Fighter",Mage,2,0,2
5558,Tank,Fighter,"Fighter, Tank","Tank, Fighter",1,1,2
5557,"Fighter, Tank","Tank, Mage","Fighter, Assassin","Tank, Fighter",1,1,2
5556,"Tank, Fighter","Tank, Mage",Tank,"Fighter, Mage",1,1,2
5555,"Fighter, Tank","Tank, Fighter",Tank,"Fighter, Mage",2,0,2
10272,"Fighter, Mage","Mage, Assassin","Tank, Fighter","Assassin, Mage",1,1,2
10273,"Fighter, Mage","Mage, Support",Fighter,"Assassin, Fighter",2,0,2
4476,"Marksman, Mage","Support, Mage",Marksman,"Fighter, Support",2,0,2
5548,"Tank, Mage","Tank, Fighter","Fighter, Assassin","Fighter, Mage",1,1,2
10593,"Fighter, Mage","Mage, Assassin","Assassin, Fighter","Marksman, Mage",2,0,2
5547,"Fighter, Mage","Tank, Fighter","Tank, Fighter","Tank, Fighter",0,2,2
10281,"Fighter, Mage","Mage, Support",Fighter,"Mage, Marksman",0,2,2
4480,"Marksman, Assassin",Mage,"Marksman, Mage","Mage, Support",2,0,2
5546,"Fighter, Marksman","Mage, Fighter","Tank, Fighter","Assassin, Fighter",2,0,2
4482,"Marksman, Support","Fighter, Tank","Marksman, Assassin","Mage, Assassin",1,1,2
4591,"Marksman, Assassin","Support, Mage","Marksman, Support","Support, Fighter",0,2,2
5545,"Fighter, Tank","Fighter, Mage","Fighter, Assassin","Tank, Fighter",1,1,2
10288,"Fighter, Assassin","Mage, Tank",Fighter,"Mage, Support",2,0,2
10632,"Assassin, Fighter",Mage,"Fighter, Mage","Fighter, Marksman",0,2,2
4844,"Marksman, Assassin","Tank, Mage",Marksman,"Support, Tank",2,0,2
5573,Fighter,"Mage, Fighter","Tank, Fighter","Assassin, Fighter",1,1,2
5589,"Tank, Mage","Assassin, Fighter","Mage, Fighter",Marksman,0,2,2
10643,"Tank, Fighter",Mage,"Fighter, Mage","Assassin, Fighter",1,1,2
4835,Marksman,"Support, Tank",Marksman,"Mage, Marksman",2,0,2
5605,"Support, Mage","Fighter, Tank","Tank, Fighter","Fighter, Mage",1,1,2
4453,Marksman,Tank,"Marksman, Mage","Support, Tank",1,1,2
4838,Marksman,"Mage, Support","Marksman, Mage","Mage, Assassin",1,1,2
10637,"Assassin, Fighter","Mage, Assassin","Fighter, Mage","Assassin, Fighter",0,2,2
4460,"Marksman, Support","Support, Tank","Marksman, Assassin","Fighter, Tank",2,0,2
10205,"Mage, Fighter","Mage, Fighter",Marksman,"Mage, Support",1,1,2
4463,"Marksman, Assassin","Fighter, Tank","Marksman, Assassin","Tank, Support",1,1,2
10215,Marksman,"Mage, Tank","Mage, Fighter","Mage, Marksman",1,1,2
5594,"Assassin, Fighter",Fighter,"Assassin, Fighter","Assassin, Fighter",1,1,2
5590,"Assassin, Fighter","Assassin, Fighter","Tank, Mage",Fighter,1,1,2
10218,Marksman,"Assassin, Fighter","Assassin, Fighter",Marksman,2,0,2
5574,"Assassin, Fighter","Mage, Fighter","Tank, Fighter","Fighter, Mage",1,1,2
5588,"Fighter, Tank","Assassin, Fighter","Assassin, Fighter",Marksman,0,2,2
4464,"Marksman, Assassin","Tank, Support","Marksman, Mage","Fighter, Tank",2,0,2
10219,"Fighter, Mage","Mage, Fighter",Marksman,Mage,1,1,2
10225,"Fighter, Tank","Support, Mage",Fighter,"Mage, Tank",0,2,2
4603,"Marksman, Assassin","Support, Tank","Marksman, Mage",Mage,1,1,2
10633,Fighter,Mage,"Fighter, Mage","Fighter, Marksman",2,0,2
5582,"Tank, Fighter",Fighter,"Tank, Fighter",Marksman,0,2,2
4675,"Marksman, Mage",Mage,Marksman,"Support, Fighter",0,2,2
10227,"Mage, Fighter","Support, Mage",Marksman,Marksman,1,1,2
10234,"Fighter, Mage",Mage,Fighter,"Fighter, Marksman",2,0,2
4467,Marksman,"Mage, Support",Marksman,"Mage, Marksman",0,2,2
5575,"Fighter, Tank",Marksman,"Assassin, Fighter","Fighter, Mage",2,0,2
10922,Marksman,Mage,"Assassin, Fighter","Marksman, Mage",2,0,2
6366,"Assassin, Fighter","Fighter, Assassin","Tank, Fighter","Assassin, Fighter",2,0,2
9705,"Tank, Fighter","Mage, Marksman","Assassin, Mage",Mage,1,1,2
8169,Fighter,"Assassin, Fighter","Mage, Fighter",Fighter,1,1,2
8185,Fighter,"Fighter, Mage","Fighter, Tank",Marksman,2,0,2
8196,"Mage, Fighter",Marksman,"Assassin, Fighter","Mage, Fighter",0,2,2
8250,"Fighter, Assassin",Marksman,Fighter,"Mage, Fighter",1,1,2
8286,"Mage, Fighter","Assassin, Fighter","Tank, Fighter",Fighter,1,1,2
9182,Fighter,Marksman,"Fighter, Tank","Mage, Support",1,1,2
8316,Fighter,Marksman,Marksman,"Fighter, Mage",2,0,2
8333,"Fighter, Mage","Mage, Marksman","Fighter, Assassin","Marksman, Mage",2,0,2
9181,"Tank, Fighter",Mage,"Fighter, Mage","Tank, Mage",1,1,2
8339,"Mage, Fighter",Mage,"Assassin, Fighter",Marksman,2,0,2
8341,"Mage, Fighter",Marksman,Marksman,Mage,2,0,2
8347,"Mage, Fighter","Support, Mage",Marksman,"Assassin, Mage",2,0,2
8348,"Mage, Fighter","Assassin, Mage",Fighter,"Assassin, Mage",0,2,2
9176,"Fighter, Assassin","Mage, Support","Fighter, Tank","Assassin, Mage",1,1,2
8351,"Fighter, Mage",Marksman,"Assassin, Fighter",Mage,1,1,2
8352,"Assassin, Fighter","Support, Mage","Fighter, Mage",Marksman,1,1,2
8355,Fighter,"Assassin, Mage","Fighter, Mage",Marksman,1,1,2
8356,"Assassin, Fighter","Support, Mage","Fighter, Mage","Assassin, Mage",1,1,2
8182,"Fighter, Mage",Marksman,"Assassin, Fighter",Fighter,0,2,2
8125,"Fighter, Tank","Fighter, Mage","Fighter, Mage",Marksman,2,0,2
8357,"Assassin, Fighter",Fighter,"Mage, Fighter",Mage,0,2,2
8085,"Fighter, Mage","Assassin, Mage","Tank, Mage","Assassin, Fighter",2,0,2
7929,"Fighter, Assassin","Fighter, Mage","Tank, Mage","Assassin, Fighter",1,1,2
7943,"Fighter, Mage","Tank, Fighter","Fighter, Assassin",Fighter,1,1,2
7947,"Tank, Fighter",Fighter,"Fighter, Assassin","Assassin, Fighter",1,1,2
7950,Mage,Marksman,"Tank, Fighter","Assassin, Fighter",0,2,2
7976,"Mage, Fighter",Fighter,"Tank, Fighter",Marksman,2,0,2
9185,Fighter,"Assassin, Fighter","Fighter, Mage","Assassin, Mage",2,0,2
8003,"Assassin, Fighter",Fighter,Fighter,Marksman,1,1,2
8014,"Tank, Fighter",Marksman,Fighter,"Fighter, Assassin",2,0,2
8018,"Assassin, Fighter",Fighter,"Mage, Fighter",Marksman,2,0,2
8023,"Assassin, Fighter",Marksman,"Mage, Fighter",Marksman,2,0,2
8045,"Fighter, Assassin",Fighter,"Fighter, Mage","Fighter, Mage",2,0,2
8047,"Tank, Mage","Assassin, Fighter","Fighter, Tank","Assassin, Mage",2,0,2
8048,"Mage, Fighter","Assassin, Fighter","Fighter, Mage","Assassin, Mage",1,1,2
8057,"Fighter, Tank","Assassin, Mage","Fighter, Mage","Tank, Fighter",0,2,2
8060,"Tank, Mage","Fighter, Mage","Fighter, Tank",Fighter,1,1,2
8061,"Fighter, Tank",Fighter,Tank,"Assassin, Mage",2,0,2
8076,"Fighter, Mage",Fighter,"Assassin, Fighter","Mage, Fighter",1,1,2
9175,"Fighter, Assassin","Assassin, Mage","Tank, Fighter","Mage, Marksman",2,0,2
8360,"Fighter, Mage",Marksman,"Fighter, Mage","Mage, Support",2,0,2
7886,"Fighter, Tank",Marksman,"Tank, Fighter","Fighter, Mage",1,1,2
8429,Marksman,"Mage, Marksman","Assassin, Fighter","Assassin, Mage",0,2,2
9118,Fighter,"Mage, Assassin","Fighter, Assassin",Mage,2,0,2
8434,"Assassin, Fighter","Assassin, Fighter","Fighter, Mage","Mage, Assassin",2,0,2
9117,"Tank, Fighter","Assassin, Fighter","Fighter, Mage","Assassin, Mage",2,0,2
8440,Marksman,"Mage, Support",Fighter,"Assassin, Mage",1,1,2
9112,"Tank, Fighter","Assassin, Mage","Fighter, Mage","Mage, Assassin",0,2,2
9109,"Fighter, Mage",Mage,"Assassin, Fighter","Mage, Marksman",2,0,2
9106,Fighter,Mage,"Assassin, Fighter","Marksman, Mage",2,0,2
9104,Fighter,"Marksman, Mage","Fighter, Mage","Fighter, Assassin",0,2,2
9099,"Assassin, Fighter","Marksman, Mage","Tank, Fighter","Mage, Marksman",1,1,2
9095,"Fighter, Mage",Mage,"Assassin, Fighter","Marksman, Mage",0,2,2
8452,Marksman,"Mage, Marksman","Fighter, Mage",Marksman,2,0,2
8459,"Fighter, Assassin","Mage, Fighter","Mage, Fighter","Mage, Support",2,0,2
8461,Marksman,"Mage, Fighter","Assassin, Fighter","Fighter, Marksman",2,0,2
8462,"Assassin, Fighter","Mage, Assassin","Fighter, Mage",Mage,0,2,2
9093,"Tank, Fighter","Mage, Assassin",Fighter,"Marksman, Mage",2,0,2
8465,"Fighter, Assassin","Mage, Support",Marksman,Mage,1,1,2
8474,"Assassin, Fighter","Mage, Support","Fighter, Tank",Mage,2,0,2
9130,Fighter,"Fighter, Mage","Tank, Fighter","Mage, Assassin",1,1,2
8428,Marksman,"Mage, Marksman","Assassin, Fighter",Mage,1,1,2
9167,"Assassin, Fighter","Marksman, Mage","Fighter, Assassin","Assassin, Mage",0,2,2
9131,"Tank, Fighter","Support, Mage","Fighter, Mage","Mage, Marksman",2,0,2
8367,"Fighter, Mage","Mage, Fighter","Tank, Fighter","Mage, Support",2,0,2
8368,"Fighter, Mage","Mage, Support","Tank, Fighter","Assassin, Fighter",2,0,2
9166,Fighter,"Marksman, Mage","Fighter, Assassin","Assassin, Mage",2,0,2
8382,"Fighter, Assassin","Assassin, Mage",Fighter,"Assassin, Fighter",1,1,2
8386,"Tank, Fighter","Assassin, Mage","Mage, Fighter",Marksman,2,0,2
9161,"Assassin, Fighter","Support, Mage",Marksman,"Assassin, Mage",2,0,2
8390,"Mage, Fighter","Mage, Support",Marksman,"Assassin, Mage",1,1,2
8398,Fighter,"Mage, Tank","Fighter, Tank",Mage,0,2,2
9148,Fighter,Mage,"Tank, Fighter","Fighter, Mage",2,0,2
8401,"Fighter, Tank",Mage,Fighter,"Mage, Assassin",1,1,2
8404,"Mage, Fighter",Mage,"Fighter, Mage","Mage, Marksman",1,1,2
9143,"Fighter, Mage",Marksman,"Fighter, Assassin","Assassin, Mage",2,0,2
8413,"Assassin, Fighter","Mage, Fighter",Marksman,"Mage, Fighter",1,1,2
8417,"Assassin, Fighter","Mage, Fighter",Fighter,"Mage, Tank",1,1,2
9136,Fighter,Mage,"Fighter, Tank","Marksman, Mage",0,2,2
9135,"Fighter, Assassin","Mage, Assassin",Fighter,"Assassin, Mage",2,0,2
8427,"Fighter, Assassin","Mage, Fighter","Assassin, Fighter","Mage, Marksman",0,2,2
9197,"Fighter, Assassin",Mage,Fighter,"Mage, Fighter",2,0,2
7881,"Fighter, Mage","Support, Mage","Tank, Fighter",Marksman,0,2,2
9279,Marksman,"Assassin, Mage",Marksman,"Support, Mage",1,1,2
7435,"Fighter, Assassin","Fighter, Mage",Tank,Fighter,1,1,2
7449,"Mage, Fighter",Marksman,"Tank, Mage","Assassin, Fighter",0,2,2
7474,"Tank, Fighter",Marksman,"Tank, Mage","Assassin, Mage",1,1,2
7476,Tank,Fighter,"Fighter, Assassin","Mage, Fighter",0,2,2
7477,"Tank, Fighter","Fighter, Assassin",Fighter,"Mage, Fighter",2,0,2
7486,"Fighter, Mage","Tank, Mage","Fighter, Tank","Fighter, Mage",0,2,2
7500,Tank,"Fighter, Tank","Fighter, Assassin","Assassin, Fighter",1,1,2
9267,"Fighter, Assassin","Mage, Fighter","Fighter, Tank","Mage, Fighter",1,1,2
9264,"Assassin, Fighter",Mage,"Fighter, Tank","Mage, Fighter",1,1,2
9259,"Mage, Fighter",Mage,"Fighter, Tank","Mage, Assassin",1,1,2
9257,Fighter,"Mage, Fighter","Mage, Fighter","Mage, Assassin",1,1,2
7507,"Fighter, Assassin",Fighter,"Tank, Mage",Marksman,2,0,2
7515,Tank,Marksman,"Tank, Fighter",Fighter,1,1,2
9255,"Mage, Fighter",Mage,"Fighter, Tank","Mage, Tank",0,2,2
7520,"Tank, Fighter",Marksman,Fighter,"Fighter, Mage",1,1,2
7523,"Tank, Fighter","Fighter, Assassin","Fighter, Tank","Fighter, Mage",2,0,2
7535,"Assassin, Fighter",Marksman,"Fighter, Tank",Fighter,1,1,2
9252,"Fighter, Assassin",Mage,"Fighter, Tank",Mage,1,1,2
7447,"Mage, Fighter","Assassin, Fighter","Fighter, Assassin",Marksman,1,1,2
7434,"Fighter, Mage","Fighter, Tank",Tank,Fighter,1,1,2
7565,"Tank, Fighter",Fighter,"Support, Mage","Assassin, Fighter",1,1,2
7429,"Fighter, Tank","Tank, Fighter","Fighter, Assassin","Mage, Fighter",0,2,2
7331,"Fighter, Tank","Fighter, Mage",Tank,"Support, Mage",2,0,2
7333,"Mage, Marksman",Marksman,"Fighter, Mage","Assassin, Fighter",1,1,2
7340,"Tank, Mage","Fighter, Tank","Tank, Fighter","Fighter, Assassin",2,0,2
7341,"Fighter, Assassin","Support, Mage","Fighter, Mage",Marksman,2,0,2
7342,"Tank, Fighter","Mage, Fighter","Fighter, Mage","Fighter, Tank",1,1,2
7356,"Assassin, Fighter",Marksman,"Fighter, Mage","Assassin, Fighter",1,1,2
9274,Fighter,"Mage, Support","Mage, Fighter","Mage, Tank",2,0,2
7374,"Fighter, Tank","Fighter, Mage","Assassin, Fighter",Marksman,2,0,2
7377,"Fighter, Tank","Assassin, Fighter","Assassin, Fighter",Fighter,1,1,2
7381,Tank,Marksman,"Fighter, Tank","Fighter, Tank",0,2,2
9273,"Fighter, Tank",Mage,"Tank, Fighter","Mage, Support",2,0,2
7391,"Fighter, Assassin",Fighter,"Assassin, Fighter","Fighter, Mage",1,1,2
7397,"Assassin, Fighter","Fighter, Assassin","Fighter, Tank","Mage, Fighter",2,0,2
7399,"Assassin, Fighter",Marksman,"Fighter, Assassin","Assassin, Fighter",1,1,2
7403,"Tank, Fighter",Marksman,"Fighter, Mage","Mage, Fighter",1,1,2
7411,"Fighter, Mage","Mage, Fighter","Assassin, Fighter",Marksman,1,1,2
7420,Tank,"Fighter, Tank","Fighter, Assassin","Fighter, Tank",2,0,2
7560,"Fighter, Tank",Fighter,"Fighter, Assassin","Assassin, Mage",0,2,2
7569,"Fighter, Tank","Assassin, Mage","Fighter, Tank","Tank, Fighter",0,2,2
7875,"Fighter, Mage","Fighter, Assassin","Fighter, Marksman","Mage, Fighter",1,1,2
7680,"Fighter, Mage","Fighter, Tank","Mage, Marksman","Fighter, Assassin",1,1,2
7700,"Fighter, Mage","Mage, Fighter","Tank, Mage",Marksman,2,0,2
7711,"Fighter, Assassin","Assassin, Fighter","Fighter, Tank",Marksman,2,0,2
7714,"Tank, Mage",Marksman,"Fighter, Assassin","Assassin, Fighter",1,1,2
7735,"Fighter, Tank","Assassin, Fighter","Tank, Fighter","Support, Mage",2,0,2
7740,"Fighter, Assassin",Fighter,"Tank, Mage","Assassin, Fighter",1,1,2
7743,"Tank, Fighter",Fighter,"Tank, Mage","Assassin, Fighter",1,1,2
7757,"Tank, Fighter","Assassin, Fighter",Fighter,Fighter,2,0,2
7758,"Mage, Fighter","Assassin, Fighter","Tank, Mage",Fighter,1,1,2
7760,"Tank, Mage","Assassin, Fighter","Fighter, Assassin",Fighter,0,2,2
7767,"Fighter, Tank","Tank, Fighter","Assassin, Mage","Fighter, Assassin",0,2,2
7773,"Fighter, Tank","Mage, Fighter","Fighter, Tank","Tank, Fighter",2,0,2
7776,Fighter,"Assassin, Fighter","Tank, Mage","Fighter, Assassin",1,1,2
7778,"Fighter, Tank","Mage, Fighter","Tank, Fighter","Tank, Mage",0,2,2
7795,"Assassin, Fighter","Assassin, Fighter","Tank, Mage","Tank, Fighter",2,0,2
7832,"Fighter, Mage","Fighter, Assassin","Tank, Fighter","Mage, Fighter",0,2,2
7835,"Fighter, Mage","Assassin, Fighter","Mage, Marksman","Fighter, Assassin",2,0,2
7868,"Fighter, Mage","Assassin, Fighter","Fighter, Assassin","Fighter, Mage",0,2,2
7685,Tank,Fighter,"Fighter, Mage","Assassin, Fighter",1,1,2
7679,Tank,"Assassin, Fighter","Fighter, Marksman","Support, Mage",2,0,2
7572,Mage,"Tank, Fighter","Fighter, Tank","Tank, Fighter",2,0,2
7671,"Fighter, Assassin","Fighter, Mage","Fighter, Mage","Fighter, Assassin",1,1,2
9239,"Fighter, Assassin","Tank, Mage","Tank, Fighter","Mage, Support",2,0,2
9235,"Assassin, Fighter",Mage,"Fighter, Tank",Mage,1,1,2
7586,Mage,"Fighter, Assassin","Tank, Mage",Fighter,1,1,2
9234,"Fighter, Assassin","Mage, Fighter","Fighter, Tank",Mage,0,2,2
7587,"Fighter, Assassin",Fighter,"Tank, Fighter","Tank, Fighter",0,2,2
7591,"Fighter, Mage","Tank, Fighter","Fighter, Tank","Assassin, Mage",2,0,2
9233,"Fighter, Tank",Mage,"Mage, Fighter","Mage, Fighter",1,1,2
7598,"Tank, Mage","Assassin, Fighter",Tank,"Fighter, Mage",1,1,2
9229,"Tank, Fighter","Assassin, Fighter","Fighter, Mage","Mage, Support",1,1,2
7608,"Support, Mage","Assassin, Fighter","Fighter, Tank","Tank, Fighter",1,1,2
7632,"Tank, Fighter","Fighter, Mage",Tank,"Assassin, Fighter",2,0,2
7633,"Fighter, Mage","Fighter, Tank","Tank, Fighter","Assassin, Fighter",1,1,2
7636,"Tank, Fighter","Assassin, Fighter","Assassin, Fighter","Assassin, Fighter",0,2,2
7641,"Tank, Fighter",Marksman,"Fighter, Mage","Support, Mage",1,1,2
9228,Marksman,"Mage, Support","Tank, Fighter",Marksman,2,0,2
7647,"Mage, Fighter",Marksman,"Tank, Fighter","Assassin, Fighter",1,1,2
9218,"Support, Mage","Fighter, Marksman","Assassin, Fighter","Mage, Support",1,1,2
8481,"Mage, Fighter","Fighter, Marksman",Marksman,"Mage, Support",1,1,2
8485,"Fighter, Tank",Mage,"Support, Mage",Marksman,1,1,2
8487,Fighter,"Assassin, Mage","Fighter, Assassin","Mage, Support",1,1,2
8958,"Fighter, Mage","Assassin, Fighter",Fighter,Mage,1,1,2
8727,"Mage, Fighter","Mage, Support","Tank, Fighter","Mage, Assassin",0,2,2
8728,"Tank, Fighter","Assassin, Mage","Mage, Fighter","Mage, Support",1,1,2
8954,"Assassin, Fighter","Mage, Marksman",Fighter,"Mage, Fighter",1,1,2
8953,"Fighter, Mage","Mage, Fighter",Fighter,"Mage, Support",0,2,2
8952,Marksman,"Assassin, Mage",Fighter,"Support, Mage",1,1,2
8949,"Mage, Fighter","Mage, Marksman",Marksman,"Mage, Fighter",1,1,2
8948,Marksman,"Mage, Tank","Fighter, Mage","Mage, Fighter",2,0,2
8733,Fighter,"Assassin, Fighter","Tank, Fighter","Mage, Support",1,1,2
8734,"Fighter, Mage","Fighter, Marksman","Tank, Fighter","Mage, Support",1,1,2
8735,"Tank, Fighter","Mage, Support","Fighter, Mage","Fighter, Marksman",0,2,2
8740,"Fighter, Assassin",Mage,"Fighter, Mage","Assassin, Fighter",1,1,2
8946,"Fighter, Mage","Mage, Marksman",Marksman,"Mage, Support",0,2,2
8742,"Support, Mage","Mage, Support","Assassin, Fighter","Assassin, Fighter",2,0,2
8743,"Mage, Fighter","Assassin, Fighter","Fighter, Mage","Mage, Support",0,2,2
8945,"Mage, Fighter",Marksman,"Fighter, Assassin","Assassin, Mage",1,1,2
8745,"Mage, Fighter","Assassin, Fighter","Assassin, Fighter","Mage, Tank",1,1,2
8935,"Fighter, Mage",Marksman,"Tank, Fighter","Assassin, Mage",1,1,2
8724,"Tank, Mage","Tank, Mage","Tank, Fighter",Marksman,2,0,2
8961,Fighter,"Mage, Support","Mage, Fighter","Assassin, Mage",2,0,2
8925,Fighter,Marksman,"Tank, Fighter",Mage,1,1,2
8716,"Tank, Mage","Mage, Support","Tank, Fighter","Assassin, Mage",1,1,2
8675,"Fighter, Assassin","Assassin, Fighter","Assassin, Fighter",Mage,2,0,2
8676,"Assassin, Fighter","Mage, Assassin","Mage, Fighter","Assassin, Fighter",1,1,2
8679,"Fighter, Assassin","Mage, Support","Fighter, Mage","Assassin, Fighter",1,1,2
8689,"Assassin, Fighter",Marksman,"Mage, Fighter","Assassin, Fighter",0,2,2
8690,Marksman,"Mage, Fighter","Mage, Fighter","Mage, Support",1,1,2
8691,"Support, Mage","Mage, Fighter",Fighter,"Mage, Support",2,0,2
8692,"Fighter, Mage","Assassin, Mage","Assassin, Fighter",Mage,1,1,2
8983,Marksman,"Mage, Fighter",Fighter,"Mage, Marksman",1,1,2
8694,"Assassin, Fighter","Mage, Tank",Fighter,Mage,2,0,2
8978,Fighter,Mage,Marksman,"Mage, Assassin",1,1,2
8703,"Mage, Fighter","Mage, Assassin","Assassin, Fighter","Mage, Assassin",2,0,2
8705,Marksman,"Mage, Fighter","Mage, Fighter",Marksman,2,0,2
8708,"Fighter, Assassin","Fighter, Marksman",Fighter,"Mage, Support",2,0,2
8973,"Fighter, Mage","Mage, Assassin",Fighter,"Support, Mage",2,0,2
8964,Fighter,Marksman,Marksman,Mage,1,1,2
8711,"Assassin, Fighter","Mage, Assassin","Mage, Fighter","Fighter, Marksman",1,1,2
8713,"Tank, Mage","Mage, Support","Tank, Mage",Mage,2,0,2
8933,"Mage, Fighter","Assassin, Mage","Tank, Fighter",Marksman,2,0,2
8753,"Fighter, Mage","Assassin, Mage","Assassin, Fighter",Marksman,1,1,2
9084,"Assassin, Mage","Mage, Marksman","Fighter, Mage","Assassin, Fighter",2,0,2
8885,"Assassin, Fighter","Mage, Tank",Marksman,Mage,1,1,2
8814,"Assassin, Fighter","Assassin, Fighter",Fighter,"Support, Mage",1,1,2
8815,"Mage, Fighter",Mage,Fighter,Marksman,1,1,2
8817,"Fighter, Mage",Mage,"Assassin, Fighter","Mage, Fighter",2,0,2
8881,"Fighter, Assassin","Mage, Fighter",Marksman,"Mage, Support",2,0,2
8878,"Fighter, Assassin","Mage, Tank",Marksman,"Mage, Support",1,1,2
8870,"Fighter, Mage","Assassin, Mage","Fighter, Assassin","Mage, Support",2,0,2
8867,"Tank, Fighter","Assassin, Fighter","Mage, Fighter","Mage, Support",2,0,2
8864,"Tank, Fighter","Mage, Assassin","Mage, Fighter","Assassin, Mage",0,2,2
8824,"Assassin, Fighter","Fighter, Marksman",Marksman,Marksman,2,0,2
8833,"Mage, Fighter","Assassin, Mage","Assassin, Fighter","Assassin, Mage",1,1,2
8860,"Fighter, Assassin","Mage, Support",Marksman,"Assassin, Mage",2,0,2
8855,"Assassin, Fighter",Marksman,"Assassin, Fighter",Mage,1,1,2
8852,"Assassin, Fighter","Assassin, Fighter",Fighter,"Mage, Support",0,2,2
8836,Fighter,"Mage, Fighter","Fighter, Mage","Mage, Tank",1,1,2
8851,Marksman,"Mage, Support",Fighter,"Fighter, Marksman",2,0,2
8847,"Assassin, Fighter","Mage, Tank","Fighter, Mage","Mage, Support",1,1,2
8839,Marksman,"Mage, Support","Assassin, Fighter","Assassin, Mage",1,1,2
8882,"Assassin, Fighter",Mage,"Fighter, Assassin","Mage, Assassin",2,0,2
8812,"Fighter, Mage","Support, Mage","Mage, Fighter","Mage, Assassin",2,0,2
8754,Fighter,"Assassin, Mage","Fighter, Assassin","Mage, Tank",2,0,2
8804,Marksman,Mage,"Mage, Fighter","Mage, Assassin",1,1,2
8757,"Tank, Fighter","Mage, Support","Fighter, Assassin","Assassin, Fighter",1,1,2
8758,"Tank, Fighter","Mage, Support",Marksman,"Mage, Support",2,0,2
8759,"Fighter, Assassin",Marksman,"Assassin, Fighter","Assassin, Mage",1,1,2
8924,Fighter,"Tank, Mage","Mage, Fighter",Mage,0,2,2
8918,"Tank, Fighter","Tank, Mage","Fighter, Mage",Mage,0,2,2
8917,Fighter,Mage,"Fighter, Assassin",Marksman,1,1,2
8760,Fighter,"Mage, Assassin","Assassin, Fighter","Mage, Fighter",1,1,2
8910,"Tank, Fighter",Marksman,"Tank, Mage","Mage, Tank",0,2,2
8909,"Fighter, Mage",Mage,"Tank, Fighter","Mage, Assassin",2,0,2
8907,"Tank, Fighter","Mage, Assassin","Mage, Fighter",Mage,2,0,2
8904,"Fighter, Tank","Assassin, Mage",Fighter,"Mage, Support",2,0,2
8775,Marksman,"Mage, Support","Fighter, Mage","Mage, Tank",1,1,2
8782,"Mage, Fighter","Mage, Marksman",Marksman,Mage,1,1,2
8896,"Fighter, Assassin",Marksman,"Fighter, Mage",Mage,1,1,2
8793,"Assassin, Fighter",Mage,"Mage, Fighter","Assassin, Fighter",1,1,2
8894,"Fighter, Mage","Mage, Assassin","Tank, Fighter",Marksman,2,0,2
8891,"Assassin, Fighter",Mage,Marksman,"Mage, Marksman",2,0,2
8987,Fighter,"Assassin, Fighter","Assassin, Fighter","Mage, Assassin",1,1,2
8669,"Assassin, Fighter","Mage, Fighter","Assassin, Fighter","Mage, Assassin",0,2,2
8996,Fighter,"Mage, Support","Fighter, Tank","Mage, Tank",1,1,2
8543,"Fighter, Mage","Mage, Support","Support, Mage",Mage,2,0,2
8546,"Fighter, Mage","Mage, Assassin","Fighter, Tank","Mage, Support",2,0,2
9055,"Fighter, Assassin","Mage, Assassin",Fighter,"Mage, Assassin",0,2,2
9054,"Assassin, Fighter","Assassin, Mage","Tank, Fighter",Mage,0,2,2
8548,"Fighter, Assassin","Mage, Support","Tank, Fighter","Assassin, Fighter",1,1,2
8551,"Mage, Fighter","Mage, Support","Fighter, Mage","Mage, Assassin",1,1,2
8553,"Fighter, Tank","Mage, Support","Fighter, Mage",Marksman,1,1,2
8556,"Fighter, Mage","Assassin, Fighter","Fighter, Assassin","Mage, Support",1,1,2
8559,"Fighter, Tank","Mage, Fighter","Fighter, Mage","Mage, Support",2,0,2
9045,"Assassin, Fighter","Assassin, Mage","Tank, Fighter","Mage, Support",2,0,2
8561,Fighter,Mage,"Fighter, Mage","Mage, Tank",0,2,2
8562,"Tank, Fighter",Marksman,"Mage, Fighter",Mage,0,2,2
8563,"Assassin, Fighter","Mage, Tank","Assassin, Fighter","Mage, Support",0,2,2
9044,Fighter,"Mage, Assassin","Fighter, Assassin","Mage, Assassin",2,0,2
9043,"Fighter, Assassin","Mage, Support","Tank, Fighter","Assassin, Mage",1,1,2
9041,"Tank, Fighter","Assassin, Fighter","Assassin, Fighter",Mage,2,0,2
8575,"Fighter, Mage","Mage, Support","Fighter, Assassin",Mage,2,0,2
8577,Marksman,"Mage, Support","Fighter, Mage","Assassin, Fighter",2,0,2
8544,"Fighter, Mage","Assassin, Mage","Mage, Fighter","Mage, Support",0,2,2
8541,"Tank, Fighter","Mage, Support","Support, Mage","Mage, Support",2,0,2
8997,Marksman,"Mage, Tank","Fighter, Mage","Mage, Support",0,2,2
8540,"Fighter, Tank",Mage,"Fighter, Mage","Assassin, Mage",0,2,2
8493,Marksman,Marksman,Fighter,"Mage, Support",2,0,2
9078,"Assassin, Fighter","Mage, Support","Tank, Fighter","Assassin, Mage",1,1,2
9071,"Tank, Fighter","Fighter, Marksman","Assassin, Fighter","Mage, Support",0,2,2
8499,"Assassin, Fighter","Mage, Support",Marksman,"Assassin, Mage",2,0,2
8500,"Assassin, Fighter","Mage, Support","Mage, Fighter","Mage, Marksman",1,1,2
8509,"Mage, Fighter","Mage, Support",Marksman,"Mage, Fighter",1,1,2
8510,"Assassin, Fighter","Assassin, Fighter",Marksman,"Assassin, Fighter",0,2,2
8514,"Tank, Fighter","Mage, Support","Assassin, Fighter","Mage, Tank",2,0,2
8518,"Fighter, Assassin","Assassin, Mage","Mage, Fighter","Assassin, Mage",1,1,2
8524,"Fighter, Mage",Marksman,"Assassin, Fighter","Mage, Support",1,1,2
9064,"Mage, Fighter","Tank, Mage","Fighter, Assassin",Mage,1,1,2
8529,"Tank, Mage","Assassin, Mage","Tank, Fighter","Fighter, Marksman",0,2,2
8530,"Tank, Fighter","Fighter, Marksman","Tank, Mage",Mage,1,1,2
8536,"Fighter, Tank","Assassin, Mage","Assassin, Fighter","Assassin, Mage",1,1,2
9060,"Tank, Fighter","Assassin, Mage","Assassin, Fighter","Mage, Assassin",2,0,2
9059,"Fighter, Assassin","Mage, Assassin",Fighter,Mage,2,0,2
8538,Marksman,"Mage, Fighter","Fighter, Mage","Mage, Support",0,2,2
8578,"Fighter, Assassin",Mage,"Fighter, Mage",Marksman,2,0,2
8579,Marksman,"Tank, Mage","Fighter, Mage","Mage, Support",1,1,2
8580,Marksman,Mage,"Fighter, Assassin",Mage,0,2,2
8586,"Support, Mage","Mage, Fighter","Assassin, Fighter","Mage, Support",1,1,2
8638,"Assassin, Fighter","Tank, Mage",Fighter,"Mage, Support",1,1,2
9018,Marksman,"Support, Mage","Mage, Fighter",Mage,1,1,2
8640,Fighter,"Assassin, Mage","Fighter, Mage","Mage, Support",0,2,2
8643,"Fighter, Mage","Tank, Mage","Assassin, Fighter",Mage,0,2,2
8645,"Fighter, Assassin","Mage, Support",Fighter,"Tank, Mage",2,0,2
9012,"Fighter, Mage","Mage, Fighter","Fighter, Tank",Mage,1,1,2
8647,Marksman,"Tank, Mage","Fighter, Mage",Mage,1,1,2
9004,"Assassin, Fighter","Mage, Fighter","Fighter, Tank",Mage,2,0,2
8652,"Fighter, Tank","Mage, Support","Mage, Fighter","Assassin, Fighter",1,1,2
8655,Fighter,"Mage, Support","Assassin, Fighter","Assassin, Mage",1,1,2
8657,"Fighter, Mage","Mage, Support","Fighter, Tank",Mage,2,0,2
9003,"Fighter, Tank","Mage, Support","Assassin, Fighter",Marksman,1,1,2
9002,"Fighter, Tank","Mage, Support","Support, Mage","Assassin, Mage",1,1,2
8661,"Tank, Fighter","Assassin, Mage","Fighter, Mage",Mage,0,2,2
9001,"Mage, Fighter","Mage, Support",Fighter,"Mage, Fighter",0,2,2
8664,"Support, Mage","Assassin, Fighter","Assassin, Fighter","Mage, Support",2,0,2
8998,"Mage, Fighter","Assassin, Mage","Assassin, Fighter","Marksman, Mage",2,0,2
9020,"Fighter, Mage","Mage, Fighter","Fighter, Tank","Mage, Fighter",1,1,2
9021,Fighter,"Mage, Fighter","Mage, Fighter",Mage,1,1,2
8637,Fighter,"Mage, Fighter","Fighter, Assassin","Mage, Support",2,0,2
8608,"Mage, Fighter",Mage,"Fighter, Assassin",Marksman,1,1,2
8587,Fighter,"Assassin, Mage","Assassin, Fighter","Mage, Support",1,1,2
8592,"Tank, Fighter",Mage,"Tank, Fighter","Marksman, Mage",1,1,2
9035,"Fighter, Mage",Mage,"Assassin, Mage","Marksman, Mage",1,1,2
8593,"Tank, Fighter",Mage,"Tank, Mage","Assassin, Fighter",1,1,2
8598,"Tank, Mage",Marksman,"Tank, Fighter","Mage, Support",1,1,2
9033,"Assassin, Fighter","Mage, Marksman","Mage, Fighter",Mage,2,0,2
9029,"Mage, Fighter","Assassin, Mage",Marksman,Mage,1,1,2
8611,Marksman,"Mage, Assassin","Fighter, Mage",Mage,1,1,2
8626,"Assassin, Fighter","Mage, Fighter","Fighter, Assassin","Assassin, Mage",1,1,2
8613,Fighter,Mage,"Tank, Fighter",Marksman,1,1,2
8615,Fighter,Marksman,"Fighter, Assassin",Mage,1,1,2
8616,"Fighter, Tank","Mage, Support","Support, Mage","Mage, Support",0,2,2
9025,"Assassin, Fighter",Mage,Fighter,"Assassin, Mage",1,1,2
8620,Marksman,"Assassin, Mage","Assassin, Fighter",Marksman,0,2,2
9024,"Fighter, Tank","Mage, Tank",Marksman,Mage,1,1,2
8623,"Support, Mage","Mage, Fighter","Fighter, Assassin",Mage,2,0,2
7330,"Fighter, Mage",Fighter,Tank,Marksman,1,1,2
7320,"Tank, Mage","Assassin, Fighter","Fighter, Tank","Support, Mage",1,1,2
6031,Tank,"Assassin, Mage","Fighter, Assassin",Fighter,1,1,2
6357,"Fighter, Assassin","Tank, Fighter","Tank, Fighter","Fighter, Assassin",2,0,2
6363,"Tank, Mage","Tank, Fighter","Tank, Fighter","Assassin, Fighter",0,2,2
8845,"Fighter, Mage","Mage, Tank",Fighter,"Mage, Fighter",1,1,2
6369,"Support, Mage","Fighter, Assassin","Tank, Mage","Assassin, Fighter",2,0,2
6376,"Fighter, Tank",Fighter,Tank,"Fighter, Tank",1,1,2
6378,"Fighter, Assassin","Fighter, Mage",Fighter,"Mage, Fighter",1,1,2
9581,"Fighter, Tank",Mage,"Mage, Fighter",Mage,1,1,2
6392,"Assassin, Fighter","Assassin, Fighter","Tank, Fighter","Assassin, Fighter",0,2,2
6393,"Assassin, Fighter","Assassin, Fighter","Fighter, Tank","Fighter, Assassin",1,1,2
6398,"Fighter, Assassin","Tank, Fighter","Tank, Mage","Assassin, Fighter",2,0,2
6402,"Tank, Mage","Assassin, Fighter","Fighter, Assassin","Tank, Fighter",1,1,2
6414,"Fighter, Tank","Tank, Fighter","Fighter, Assassin",Fighter,1,1,2
6415,"Fighter, Assassin","Tank, Fighter","Tank, Mage","Fighter, Assassin",2,0,2
9565,"Mage, Fighter","Assassin, Mage","Fighter, Assassin",Mage,1,1,2
9548,"Mage, Fighter",Mage,"Fighter, Assassin",Mage,1,1,2
6427,"Fighter, Mage","Tank, Fighter",Tank,"Assassin, Fighter",2,0,2
6428,"Fighter, Tank","Fighter, Mage","Fighter, Tank","Support, Mage",0,2,2
6430,"Tank, Fighter","Fighter, Tank","Mage, Marksman",Fighter,2,0,2
6359,"Fighter, Assassin","Tank, Fighter","Tank, Fighter","Assassin, Fighter",0,2,2
9587,"Assassin, Fighter",Marksman,"Fighter, Mage",Mage,2,0,2
6436,"Fighter, Marksman","Fighter, Assassin","Tank, Fighter",Fighter,1,1,2
6355,"Tank, Fighter","Tank, Fighter","Mage, Tank","Tank, Fighter",2,0,2
9618,"Fighter, Mage",Mage,"Mage, Fighter","Mage, Tank",2,0,2
6316,"Tank, Mage","Fighter, Assassin",Mage,"Tank, Fighter",1,1,2
6320,"Fighter, Mage","Fighter, Assassin","Fighter, Assassin","Tank, Fighter",0,2,2
9610,"Mage, Fighter",Mage,Marksman,"Mage, Tank",0,2,2
6335,"Mage, Fighter","Assassin, Fighter","Tank, Mage","Assassin, Fighter",2,0,2
9608,"Fighter, Mage","Mage, Tank","Fighter, Assassin","Assassin, Mage",1,1,2
6338,"Fighter, Tank","Assassin, Fighter","Mage, Fighter","Mage, Fighter",2,0,2
6339,"Tank, Mage","Fighter, Mage","Assassin, Fighter","Tank, Fighter",1,1,2
9605,"Mage, Fighter","Tank, Mage","Fighter, Mage","Mage, Support",0,2,2
6341,"Fighter, Tank","Assassin, Fighter","Fighter, Mage","Tank, Fighter",2,0,2
6346,"Mage, Marksman","Fighter, Tank","Fighter, Tank","Tank, Fighter",1,1,2
9603,"Mage, Fighter","Assassin, Mage","Fighter, Mage","Mage, Support",2,0,2
9591,"Fighter, Mage",Mage,Marksman,"Mage, Support",1,1,2
6351,"Fighter, Marksman","Fighter, Assassin","Fighter, Tank","Tank, Fighter",1,1,2
6352,"Fighter, Tank","Tank, Fighter","Mage, Tank","Fighter, Assassin",0,2,2
9588,Marksman,"Mage, Support","Fighter, Assassin","Assassin, Mage",0,2,2
6354,"Mage, Tank","Tank, Fighter","Fighter, Tank","Tank, Fighter",0,2,2
9545,Fighter,"Mage, Tank","Assassin, Fighter","Mage, Fighter",1,1,2
6439,"Mage, Marksman","Fighter, Assassin","Tank, Fighter",Fighter,2,0,2
6314,"Fighter, Tank","Mage, Fighter","Support, Tank",Marksman,0,2,2
6518,Fighter,"Mage, Assassin","Tank, Fighter",Mage,1,1,2
6526,"Fighter, Assassin","Assassin, Mage","Fighter, Assassin","Mage, Support",2,0,2
6529,"Fighter, Assassin","Assassin, Mage",Fighter,"Assassin, Mage",2,0,2
6532,Fighter,Mage,"Fighter, Assassin","Marksman, Mage",2,0,2
6533,Fighter,"Assassin, Mage","Tank, Fighter","Marksman, Mage",2,0,2
6534,"Tank, Fighter","Mage, Support",Fighter,"Assassin, Fighter",1,1,2
6540,Fighter,"Tank, Fighter","Fighter, Tank","Assassin, Fighter",2,0,2
9521,"Assassin, Fighter","Mage, Support","Fighter, Assassin","Fighter, Assassin",2,0,2
6543,Fighter,"Tank, Fighter","Mage, Tank","Tank, Fighter",2,0,2
6550,"Tank, Fighter","Assassin, Mage",Fighter,"Mage, Assassin",1,1,2
9519,Marksman,"Mage, Tank","Assassin, Fighter",Mage,1,1,2
6553,"Assassin, Fighter","Mage, Support","Assassin, Fighter","Assassin, Mage",2,0,2
6554,"Tank, Fighter","Mage, Marksman","Assassin, Fighter","Assassin, Mage",1,1,2
6558,"Assassin, Fighter","Mage, Assassin","Tank, Fighter","Mage, Marksman",0,2,2
6560,Fighter,"Tank, Fighter","Tank, Fighter","Tank, Fighter",0,2,2
9517,Fighter,"Mage, Support",Marksman,"Mage, Fighter",2,0,2
6565,"Fighter, Assassin","Mage, Assassin","Fighter, Assassin","Assassin, Mage",1,1,2
6566,"Tank, Fighter",Mage,Fighter,"Assassin, Fighter",0,2,2
6523,"Tank, Fighter","Mage, Marksman","Fighter, Assassin","Assassin, Fighter",1,1,2
9522,Marksman,"Assassin, Mage","Fighter, Assassin","Mage, Assassin",0,2,2
6441,"Tank, Mage","Fighter, Tank","Tank, Fighter",Fighter,2,0,2
9523,Marksman,"Mage, Assassin","Assassin, Fighter","Assassin, Fighter",2,0,2
6443,"Tank, Fighter",Fighter,"Fighter, Tank","Assassin, Fighter",1,1,2
6448,"Fighter, Marksman","Fighter, Assassin","Tank, Mage",Fighter,1,1,2
9543,"Fighter, Assassin",Mage,"Assassin, Fighter","Mage, Fighter",0,2,2
6455,Tank,Fighter,"Fighter, Tank","Assassin, Fighter",1,1,2
6457,"Fighter, Tank","Tank, Fighter",Fighter,"Assassin, Fighter",1,1,2
6460,"Tank, Mage","Tank, Fighter","Mage, Tank","Tank, Fighter",0,2,2
6469,"Fighter, Tank","Assassin, Fighter",Fighter,"Tank, Fighter",2,0,2
6472,"Tank, Fighter","Assassin, Fighter",Fighter,"Tank, Fighter",1,1,2
9538,Marksman,"Mage, Assassin","Fighter, Mage","Assassin, Fighter",2,0,2
6479,"Tank, Mage","Fighter, Tank","Fighter, Tank","Tank, Fighter",1,1,2
6481,"Fighter, Tank","Tank, Fighter","Tank, Fighter","Fighter, Tank",2,0,2
6499,"Tank, Fighter","Mage, Fighter","Tank, Mage","Support, Mage",1,1,2
6500,"Tank, Fighter","Fighter, Tank","Fighter, Assassin","Mage, Fighter",0,2,2
6501,"Tank, Fighter","Fighter, Mage",Tank,"Fighter, Assassin",1,1,2
9529,Fighter,"Mage, Marksman",Marksman,"Mage, Fighter",2,0,2
9528,"Fighter, Assassin",Mage,"Fighter, Tank",Marksman,0,2,2
6512,Fighter,"Assassin, Mage","Tank, Fighter","Assassin, Fighter",1,1,2
6315,"Fighter, Mage","Fighter, Assassin","Tank, Mage","Fighter, Assassin",1,1,2
6306,"Fighter, Tank",Fighter,"Fighter, Mage",Marksman,2,0,2
9284,Marksman,"Mage, Fighter","Fighter, Mage","Mage, Marksman",1,1,2
9681,"Assassin, Fighter","Assassin, Fighter","Assassin, Fighter","Assassin, Fighter",2,0,2
6097,"Fighter, Tank","Fighter, Tank",Tank,Fighter,1,1,2
6098,Tank,"Fighter, Tank","Fighter, Tank",Fighter,1,1,2
9680,"Assassin, Fighter","Assassin, Fighter","Fighter, Assassin","Assassin, Fighter",2,0,2
6106,"Mage, Fighter",Marksman,Tank,"Assassin, Fighter",0,2,2
6108,"Tank, Mage","Assassin, Fighter",Tank,"Fighter, Tank",0,2,2
6111,"Fighter, Assassin",Fighter,"Tank, Mage","Fighter, Tank",0,2,2
6118,"Tank, Fighter","Fighter, Assassin","Fighter, Marksman","Mage, Fighter",0,2,2
6130,Tank,Marksman,"Tank, Fighter","Fighter, Mage",1,1,2
9679,"Fighter, Assassin",Mage,"Assassin, Fighter","Assassin, Mage",1,1,2
6145,"Tank, Fighter","Assassin, Fighter",Tank,"Support, Mage",0,2,2
6146,Tank,Marksman,"Fighter, Mage","Assassin, Fighter",1,1,2
6147,Tank,"Assassin, Fighter","Fighter, Mage","Fighter, Mage",1,1,2
6149,"Fighter, Tank","Assassin, Fighter","Fighter, Mage","Mage, Fighter",2,0,2
6152,Fighter,"Assassin, Fighter",Tank,Fighter,2,0,2
9677,"Fighter, Assassin","Fighter, Marksman","Assassin, Fighter","Support, Mage",0,2,2
6161,Tank,"Assassin, Fighter","Fighter, Mage","Fighter, Tank",2,0,2
9670,"Mage, Fighter",Fighter,Fighter,Mage,1,1,2
6095,"Fighter, Tank","Mage, Fighter",Assassin,Fighter,2,0,2
6093,"Assassin, Fighter","Assassin, Fighter","Fighter, Mage",Marksman,2,0,2
6164,"Tank, Fighter","Assassin, Fighter","Assassin, Fighter","Fighter, Assassin",0,2,2
9684,"Fighter, Assassin","Fighter, Marksman","Assassin, Fighter","Mage, Support",2,0,2
9700,"Fighter, Assassin","Fighter, Assassin","Assassin, Fighter",Mage,1,1,2
6035,Fighter,"Mage, Fighter","Tank, Fighter",Fighter,1,1,2
6037,"Mage, Fighter","Fighter, Mage","Fighter, Assassin",Fighter,1,1,2
6045,"Fighter, Tank",Fighter,Mage,"Mage, Fighter",1,1,2
6047,Mage,"Mage, Fighter","Tank, Fighter",Fighter,0,2,2
9699,"Assassin, Fighter","Support, Mage","Mage, Fighter","Assassin, Fighter",1,1,2
9697,"Fighter, Tank","Mage, Support","Tank, Fighter",Marksman,2,0,2
9694,Fighter,"Mage, Support","Fighter, Mage","Tank, Mage",1,1,2
6065,Fighter,"Assassin, Fighter","Fighter, Assassin","Mage, Fighter",1,1,2
6068,"Tank, Fighter","Fighter, Mage",Fighter,"Mage, Fighter",1,1,2
9690,"Tank, Fighter","Assassin, Fighter","Fighter, Assassin",Mage,0,2,2
9689,"Mage, Fighter","Mage, Assassin","Assassin, Fighter","Assassin, Fighter",2,0,2
6075,"Fighter, Mage",Marksman,"Tank, Mage","Fighter, Assassin",2,0,2
6079,"Fighter, Mage",Fighter,"Tank, Fighter",Marksman,2,0,2
6082,"Fighter, Assassin","Fighter, Assassin","Fighter, Mage","Assassin, Fighter",2,0,2
9688,"Mage, Fighter","Fighter, Marksman","Assassin, Fighter","Assassin, Fighter",2,0,2
6084,"Tank, Fighter","Support, Mage","Fighter, Tank","Assassin, Fighter",1,1,2
9662,"Fighter, Assassin","Mage, Tank","Mage, Fighter","Mage, Support",0,2,2
9655,"Mage, Fighter","Mage, Tank","Fighter, Assassin","Mage, Support",1,1,2
6305,"Tank, Fighter","Fighter, Tank",Tank,"Assassin, Fighter",2,0,2
9629,Marksman,Mage,"Assassin, Fighter","Mage, Tank",0,2,2
6242,"Fighter, Tank","Fighter, Mage","Tank, Fighter","Fighter, Mage",2,0,2
6248,"Mage, Fighter",Fighter,"Fighter, Assassin","Fighter, Mage",2,0,2
6251,"Tank, Fighter","Fighter, Mage",Marksman,Fighter,1,1,2
9625,"Assassin, Fighter",Mage,"Fighter, Assassin","Assassin, Fighter",1,1,2
6270,Tank,"Mage, Fighter","Tank, Fighter",Fighter,2,0,2
6271,"Fighter, Assassin","Assassin, Fighter","Fighter, Tank","Assassin, Fighter",2,0,2
6273,"Tank, Mage","Assassin, Fighter","Tank, Fighter","Fighter, Tank",2,0,2
6281,"Tank, Mage",Fighter,"Tank, Fighter","Fighter, Assassin",1,1,2
6285,"Tank, Mage","Mage, Fighter",Tank,"Assassin, Fighter",2,0,2
6286,"Tank, Mage","Fighter, Tank","Fighter, Mage","Assassin, Fighter",0,2,2
6288,Tank,"Mage, Fighter","Tank, Fighter",Marksman,0,2,2
6290,"Tank, Fighter","Assassin, Fighter","Tank, Fighter","Support, Mage",0,2,2
6294,"Fighter, Tank","Assassin, Fighter",Tank,"Fighter, Tank",2,0,2
6295,"Fighter, Tank","Fighter, Tank","Fighter, Tank","Fighter, Mage",0,2,2
6299,"Fighter, Assassin",Fighter,"Fighter, Tank","Fighter, Tank",2,0,2
6304,"Mage, Marksman","Tank, Fighter","Fighter, Tank","Fighter, Tank",0,2,2
9620,"Assassin, Fighter","Mage, Support",Marksman,"Mage, Fighter",1,1,2
6241,"Tank, Fighter","Mage, Fighter",Marksman,"Fighter, Mage",0,2,2
9631,Fighter,Mage,"Mage, Fighter","Mage, Assassin",0,2,2
6174,"Fighter, Mage",Fighter,"Tank, Fighter","Tank, Fighter",0,2,2
6228,"Fighter, Tank","Assassin, Fighter","Fighter, Assassin","Mage, Fighter",1,1,2
6182,"Tank, Fighter",Fighter,"Fighter, Assassin",Marksman,1,1,2
6183,"Fighter, Assassin",Fighter,"Tank, Fighter",Marksman,1,1,2
6188,"Fighter, Tank",Marksman,Mage,"Mage, Fighter",1,1,2
6189,"Support, Tank","Mage, Fighter","Fighter, Tank",Fighter,1,1,2
9653,"Mage, Fighter",Mage,"Assassin, Fighter","Tank, Mage",0,2,2
6191,"Support, Mage","Tank, Fighter","Fighter, Assassin","Mage, Fighter",1,1,2
9646,Marksman,Mage,"Fighter, Mage","Support, Mage",2,0,2
6201,Tank,Fighter,"Tank, Fighter","Assassin, Fighter",1,1,2
6202,Tank,"Assassin, Fighter","Fighter, Assassin","Fighter, Tank",1,1,2
6204,"Fighter, Assassin",Fighter,"Fighter, Assassin","Fighter, Tank",2,0,2
6207,"Fighter, Marksman","Fighter, Mage","Tank, Fighter","Tank, Mage",2,0,2
6213,"Fighter, Mage",Fighter,"Tank, Fighter","Assassin, Fighter",2,0,2
9637,Marksman,"Marksman, Mage","Mage, Fighter",Marksman,1,1,2
9634,Fighter,Marksman,"Assassin, Fighter",Mage,0,2,2
6219,"Fighter, Assassin",Marksman,"Assassin, Fighter",Fighter,0,2,2
6220,"Fighter, Assassin","Mage, Fighter","Tank, Mage",Fighter,1,1,2
6223,"Fighter, Tank",Marksman,"Tank, Mage",Fighter,2,0,2
6568,Fighter,"Marksman, Mage","Assassin, Fighter","Mage, Marksman",2,0,2
6572,"Tank, Fighter","Fighter, Marksman",Fighter,"Mage, Marksman",0,2,2
6573,"Fighter, Assassin",Mage,Fighter,"Marksman, Mage",2,0,2
7004,"Fighter, Tank","Mage, Fighter",Mage,"Fighter, Mage",2,0,2
7008,"Mage, Fighter","Assassin, Fighter","Tank, Mage","Tank, Fighter",1,1,2
9368,"Mage, Fighter","Assassin, Fighter","Assassin, Fighter","Mage, Assassin",1,1,2
7010,"Fighter, Tank","Fighter, Assassin","Fighter, Assassin","Fighter, Mage",1,1,2
7034,"Mage, Fighter","Assassin, Fighter","Assassin, Fighter","Assassin, Fighter",2,0,2
7046,"Fighter, Tank","Fighter, Mage","Support, Mage","Tank, Fighter",2,0,2
7056,"Fighter, Mage",Fighter,"Mage, Marksman","Fighter, Tank",2,0,2
9366,"Fighter, Mage","Assassin, Mage",Fighter,"Mage, Tank",2,0,2
7069,"Tank, Mage","Tank, Fighter","Tank, Fighter",Fighter,2,0,2
7070,"Tank, Fighter","Fighter, Tank","Fighter, Tank","Fighter, Assassin",1,1,2
9355,"Tank, Fighter","Mage, Assassin","Assassin, Fighter","Assassin, Fighter",0,2,2
7071,"Fighter, Tank","Tank, Fighter","Mage, Marksman","Fighter, Assassin",0,2,2
7076,"Fighter, Tank","Assassin, Fighter","Fighter, Mage","Fighter, Tank",1,1,2
7079,"Tank, Fighter","Mage, Fighter","Fighter, Tank","Fighter, Tank",1,1,2
7085,"Fighter, Assassin",Fighter,"Fighter, Mage","Tank, Fighter",1,1,2
7086,"Fighter, Mage",Fighter,"Fighter, Assassin","Fighter, Assassin",1,1,2
7101,"Fighter, Mage","Fighter, Tank","Tank, Fighter","Fighter, Assassin",1,1,2
7133,"Fighter, Assassin",Fighter,"Tank, Mage","Fighter, Mage",1,1,2
7007,"Tank, Mage","Tank, Fighter","Tank, Fighter","Tank, Fighter",1,1,2
6999,"Tank, Mage","Fighter, Assassin","Fighter, Mage","Fighter, Tank",1,1,2
7139,"Fighter, Tank","Fighter, Mage","Tank, Mage","Assassin, Mage",1,1,2
6998,"Fighter, Tank","Assassin, Fighter","Tank, Mage",Fighter,0,2,2
6915,"Assassin, Fighter",Marksman,"Tank, Mage","Fighter, Assassin",1,1,2
6919,"Fighter, Tank","Tank, Fighter","Tank, Mage","Assassin, Mage",0,2,2
6920,"Fighter, Tank","Tank, Fighter",Tank,"Tank, Fighter",1,1,2
9401,Marksman,"Fighter, Marksman","Assassin, Fighter","Assassin, Fighter",1,1,2
9400,"Assassin, Fighter",Marksman,"Tank, Fighter",Mage,1,1,2
9397,"Tank, Mage","Mage, Support",Fighter,Mage,2,0,2
6944,"Fighter, Mage",Marksman,"Assassin, Fighter","Fighter, Assassin",1,1,2
6946,"Tank, Mage","Tank, Fighter","Tank, Mage",Marksman,2,0,2
9390,"Tank, Fighter",Mage,"Fighter, Assassin","Assassin, Mage",0,2,2
6952,"Tank, Fighter","Assassin, Fighter","Mage, Fighter",Marksman,1,1,2
9386,"Fighter, Tank","Mage, Tank","Fighter, Tank","Mage, Fighter",1,1,2
6955,"Mage, Fighter","Assassin, Fighter","Fighter, Tank",Fighter,1,1,2
6962,Mage,"Fighter, Assassin","Fighter, Tank",Fighter,1,1,2
6965,"Tank, Fighter","Mage, Fighter","Fighter, Assassin","Fighter, Assassin",2,0,2
9375,"Assassin, Fighter","Assassin, Fighter","Fighter, Assassin","Mage, Assassin",1,1,2
6970,"Tank, Fighter",Marksman,"Fighter, Assassin","Fighter, Assassin",0,2,2
9373,"Fighter, Assassin","Assassin, Fighter","Tank, Fighter","Mage, Assassin",1,1,2
7136,"Tank, Mage","Fighter, Mage",Tank,"Assassin, Fighter",1,1,2
7154,Tank,"Fighter, Assassin","Fighter, Tank","Fighter, Tank",0,2,2
9515,"Fighter, Tank",Mage,Fighter,Mage,1,1,2
9315,"Fighter, Mage","Tank, Mage",Fighter,"Assassin, Fighter",0,2,2
7268,"Fighter, Assassin","Fighter, Assassin","Fighter, Tank","Tank, Fighter",1,1,2
9308,"Fighter, Mage","Mage, Support","Tank, Fighter","Mage, Fighter",1,1,2
9307,"Tank, Fighter","Mage, Assassin","Tank, Fighter","Tank, Mage",2,0,2
7278,"Fighter, Tank","Assassin, Fighter","Assassin, Fighter","Tank, Fighter",2,0,2
7289,Fighter,"Assassin, Fighter","Tank, Fighter","Fighter, Assassin",0,2,2
7290,"Fighter, Mage","Fighter, Assassin","Tank, Fighter","Support, Mage",1,1,2
7294,"Fighter, Assassin","Fighter, Assassin","Tank, Fighter","Assassin, Fighter",1,1,2
7295,"Fighter, Tank",Marksman,"Fighter, Tank","Mage, Fighter",1,1,2
9302,Marksman,"Mage, Marksman","Mage, Fighter","Assassin, Fighter",1,1,2
9295,"Mage, Fighter","Mage, Support","Fighter, Assassin","Mage, Fighter",1,1,2
7302,"Fighter, Mage","Mage, Fighter","Fighter, Mage","Fighter, Assassin",0,2,2
9293,Marksman,"Mage, Marksman",Marksman,"Assassin, Mage",2,0,2
7305,"Assassin, Fighter","Assassin, Fighter","Fighter, Mage","Assassin, Fighter",2,0,2
9292,"Assassin, Fighter","Assassin, Fighter",Marksman,"Mage, Fighter",1,1,2
9290,Fighter,"Marksman, Mage","Fighter, Mage","Assassin, Mage",1,1,2
9289,Fighter,"Mage, Marksman","Fighter, Mage","Assassin, Fighter",2,0,2
7317,"Fighter, Mage","Assassin, Fighter","Fighter, Marksman","Tank, Fighter",1,1,2
9309,"Fighter, Mage","Mage, Support","Support, Mage","Mage, Support",0,2,2
7262,"Fighter, Tank",Fighter,"Support, Mage","Tank, Fighter",0,2,2
7155,"Assassin, Fighter","Tank, Fighter","Fighter, Tank",Fighter,1,1,2
7254,"Fighter, Tank","Assassin, Fighter","Fighter, Mage","Assassin, Fighter",2,0,2
7156,"Fighter, Tank",Fighter,Tank,"Assassin, Fighter",0,2,2
7162,"Tank, Mage","Assassin, Fighter","Fighter, Mage","Fighter, Mage",1,1,2
7181,"Fighter, Assassin",Fighter,"Tank, Fighter","Assassin, Fighter",1,1,2
9340,"Fighter, Mage","Support, Mage","Assassin, Fighter","Mage, Marksman",0,2,2
7187,"Fighter, Assassin",Marksman,"Tank, Fighter","Marksman, Fighter",0,2,2
7190,"Tank, Fighter",Marksman,"Support, Tank","Mage, Fighter",2,0,2
9337,"Tank, Fighter","Mage, Marksman",Fighter,Mage,1,1,2
7201,"Fighter, Tank","Assassin, Mage","Assassin, Fighter","Mage, Fighter",0,2,2
7209,Fighter,"Fighter, Mage",Tank,"Assassin, Fighter",2,0,2
7212,"Assassin, Fighter","Mage, Fighter","Fighter, Tank","Fighter, Mage",1,1,2
9329,Marksman,"Mage, Fighter",Marksman,"Mage, Support",1,1,2
7214,Fighter,"Assassin, Mage","Fighter, Tank","Mage, Fighter",1,1,2
7220,"Fighter, Tank","Tank, Mage","Fighter, Tank","Fighter, Mage",0,2,2
7230,"Tank, Fighter","Tank, Fighter","Fighter, Marksman","Mage, Fighter",2,0,2
9327,"Support, Mage","Mage, Fighter","Assassin, Fighter","Assassin, Mage",1,1,2
9320,"Tank, Fighter","Mage, Assassin","Fighter, Mage","Mage, Support",2,0,2
7241,"Mage, Marksman",Fighter,"Fighter, Tank","Assassin, Fighter",2,0,2
9405,"Fighter, Mage","Tank, Mage",Fighter,"Mage, Support",1,1,2
6903,"Fighter, Tank","Tank, Fighter","Fighter, Assassin","Fighter, Mage",1,1,2
6898,"Tank, Mage","Assassin, Fighter","Assassin, Fighter","Tank, Fighter",2,0,2
9482,"Tank, Fighter","Assassin, Fighter","Tank, Fighter","Mage, Assassin",2,0,2
9481,"Tank, Fighter","Support, Mage","Fighter, Mage","Assassin, Mage",2,0,2
6644,"Fighter, Mage","Mage, Fighter","Assassin, Fighter","Fighter, Assassin",1,1,2
6645,"Assassin, Fighter","Mage, Fighter",Fighter,Marksman,2,0,2
9479,"Fighter, Mage",Marksman,Fighter,"Assassin, Mage",2,0,2
6651,"Fighter, Mage","Tank, Mage","Fighter, Tank","Tank, Fighter",0,2,2
6652,"Assassin, Fighter","Assassin, Fighter","Fighter, Tank",Marksman,2,0,2
6656,"Fighter, Assassin","Fighter, Mage","Assassin, Fighter","Fighter, Tank",0,2,2
6658,Marksman,"Assassin, Fighter","Tank, Fighter","Fighter, Mage",1,1,2
6662,"Fighter, Tank","Tank, Mage",Tank,"Fighter, Mage",0,2,2
6663,"Tank, Fighter","Tank, Fighter","Fighter, Assassin","Mage, Fighter",2,0,2
6671,"Fighter, Assassin","Fighter, Mage","Tank, Fighter","Tank, Fighter",0,2,2
6675,Fighter,"Assassin, Fighter","Fighter, Tank","Fighter, Assassin",1,1,2
6699,"Fighter, Tank",Marksman,"Tank, Mage",Marksman,1,1,2
6701,Tank,"Tank, Fighter","Fighter, Mage","Tank, Fighter",1,1,2
6702,"Tank, Mage","Tank, Fighter","Fighter, Assassin","Tank, Fighter",1,1,2
9477,"Fighter, Mage",Mage,"Tank, Fighter","Assassin, Mage",1,1,2
6708,"Fighter, Marksman","Tank, Fighter","Tank, Mage","Tank, Fighter",1,1,2
6641,"Fighter, Tank","Fighter, Assassin",Tank,"Tank, Fighter",1,1,2
6639,"Fighter, Tank","Tank, Mage","Fighter, Assassin","Fighter, Mage",2,0,2
6896,Tank,"Fighter, Mage","Tank, Fighter",Fighter,2,0,2
6638,"Fighter, Assassin","Tank, Fighter","Tank, Mage","Fighter, Mage",1,1,2
6580,"Fighter, Mage","Assassin, Fighter",Fighter,"Marksman, Mage",0,2,2
6582,Fighter,"Mage, Marksman","Tank, Fighter","Marksman, Mage",1,1,2
6594,"Tank, Fighter","Mage, Marksman","Assassin, Mage","Marksman, Mage",2,0,2
6596,"Tank, Fighter","Mage, Marksman","Assassin, Fighter",Mage,2,0,2
9513,Fighter,"Mage, Support","Mage, Fighter","Fighter, Marksman",2,0,2
6601,Fighter,Mage,"Assassin, Fighter","Fighter, Marksman",1,1,2
6604,"Tank, Fighter","Mage, Assassin","Tank, Fighter","Assassin, Fighter",1,1,2
6613,Fighter,"Assassin, Mage","Tank, Fighter","Assassin, Mage",0,2,2
9503,"Tank, Fighter","Mage, Support","Assassin, Fighter","Assassin, Fighter",1,1,2
6616,"Tank, Fighter",Mage,Fighter,"Marksman, Mage",0,2,2
9502,"Tank, Fighter","Assassin, Fighter","Fighter, Assassin","Fighter, Marksman",2,0,2
6617,Fighter,"Assassin, Mage","Fighter, Assassin","Mage, Marksman",2,0,2
6622,"Tank, Fighter",Mage,"Tank, Fighter","Mage, Tank",1,1,2
9491,"Tank, Fighter","Mage, Marksman","Fighter, Assassin","Mage, Fighter",0,2,2
6628,"Tank, Fighter","Mage, Tank",Fighter,Mage,1,1,2
6629,"Tank, Fighter","Fighter, Mage","Tank, Fighter",Mage,0,2,2
6636,"Fighter, Tank","Fighter, Assassin","Mage, Marksman","Fighter, Mage",0,2,2
6710,"Fighter, Assassin","Tank, Fighter",Tank,"Tank, Fighter",1,1,2
6713,"Mage, Marksman","Fighter, Tank","Tank, Fighter","Fighter, Assassin",1,1,2
6721,"Fighter, Tank",Fighter,Fighter,"Assassin, Fighter",1,1,2
6727,Mage,Fighter,"Fighter, Tank","Fighter, Mage",1,1,2
6807,"Fighter, Mage","Support, Mage","Tank, Fighter","Assassin, Fighter",0,2,2
6812,"Fighter, Assassin","Fighter, Mage",Tank,"Assassin, Fighter",2,0,2
6816,"Tank, Mage",Marksman,"Fighter, Assassin","Tank, Fighter",1,1,2
6817,"Mage, Marksman","Support, Mage","Fighter, Tank","Fighter, Assassin",1,1,2
9417,Marksman,"Mage, Assassin","Fighter, Mage","Mage, Marksman",1,1,2
9409,"Fighter, Mage","Mage, Assassin","Fighter, Tank","Mage, Fighter",1,1,2
6826,"Fighter, Tank","Mage, Fighter","Mage, Marksman","Fighter, Mage",1,1,2
6829,"Tank, Mage","Fighter, Tank","Tank, Fighter","Assassin, Fighter",0,2,2
6832,"Fighter, Tank",Fighter,"Tank, Fighter","Fighter, Assassin",1,1,2
6840,"Fighter, Assassin",Fighter,"Tank, Mage","Fighter, Assassin",0,2,2
6842,"Tank, Mage",Fighter,"Fighter, Assassin","Assassin, Fighter",1,1,2
6855,Fighter,Marksman,"Fighter, Assassin","Mage, Fighter",1,1,2
6863,"Fighter, Assassin","Mage, Fighter","Fighter, Tank","Fighter, Assassin",1,1,2
9406,"Fighter, Mage","Assassin, Mage","Fighter, Tank","Mage, Support",1,1,2
6891,"Tank, Mage",Fighter,"Tank, Mage","Tank, Fighter",1,1,2
6892,"Tank, Mage","Tank, Mage",Tank,"Tank, Fighter",2,0,2
6893,"Tank, Mage","Assassin, Fighter",Tank,"Tank, Fighter",1,1,2
6806,Tank,Fighter,"Tank, Fighter","Fighter, Assassin",0,2,2
6803,"Assassin, Fighter","Fighter, Assassin","Fighter, Tank","Fighter, Assassin",1,1,2
6792,Tank,"Fighter, Mage","Fighter, Tank","Assassin, Fighter",2,0,2
6747,"Assassin, Fighter","Fighter, Mage","Tank, Mage",Marksman,1,1,2
9435,"Tank, Fighter","Mage, Fighter","Tank, Fighter",Mage,1,1,2
9430,"Tank, Fighter","Mage, Support","Tank, Fighter","Assassin, Mage",0,2,2
6729,"Mage, Fighter",Fighter,"Fighter, Assassin","Assassin, Fighter",2,0,2
6731,"Fighter, Mage","Assassin, Fighter","Tank, Fighter","Tank, Fighter",1,1,2
6735,"Fighter, Tank",Marksman,"Fighter, Assassin","Assassin, Fighter",1,1,2
9427,"Assassin, Fighter","Mage, Assassin","Fighter, Assassin","Mage, Fighter",1,1,2
6743,"Fighter, Tank","Assassin, Fighter","Mage, Fighter",Fighter,0,2,2
9426,"Tank, Fighter","Mage, Support","Assassin, Fighter","Mage, Fighter",1,1,2
9418,"Mage, Fighter","Marksman, Mage","Fighter, Mage","Mage, Marksman",1,1,2
9424,"Fighter, Assassin","Mage, Marksman","Assassin, Fighter",Mage,1,1,2
6750,Tank,"Fighter, Tank","Mage, Fighter",Fighter,1,1,2
6751,"Fighter, Assassin",Marksman,"Tank, Mage",Fighter,1,1,2
6752,"Tank, Mage","Fighter, Tank","Fighter, Tank",Marksman,1,1,2
6760,"Assassin, Fighter","Fighter, Mage","Fighter, Assassin","Mage, Fighter",0,2,2
9423,"Tank, Fighter","Mage, Assassin","Tank, Fighter","Mage, Marksman",1,1,2
6776,"Fighter, Mage","Fighter, Assassin","Tank, Fighter","Tank, Fighter",1,1,2
4222,"Tank, Fighter","Support, Fighter","Assassin, Mage","Tank, Support",1,1,2
5498,Tank,"Assassin, Fighter","Assassin, Fighter",Marksman,1,1,2
1936,Fighter,"Assassin, Fighter","Fighter, Mage","Mage, Assassin",0,2,2
2660,"Fighter, Marksman","Fighter, Assassin","Fighter, Mage","Fighter, Tank",2,0,2
3821,"Tank, Fighter","Tank, Support","Assassin, Fighter","Support, Fighter",1,1,2
2650,"Mage, Support","Tank, Fighter","Tank, Mage",Fighter,1,1,2
3824,"Tank, Fighter","Tank, Fighter","Fighter, Mage","Tank, Support",0,2,2
2658,Tank,"Fighter, Assassin","Tank, Mage",Fighter,2,0,2
3266,Fighter,"Tank, Fighter",Marksman,"Mage, Support",1,1,2
2659,"Marksman, Assassin",Support,Marksman,"Support, Tank",2,0,2
1584,"Tank, Mage","Fighter, Assassin","Assassin, Fighter","Assassin, Fighter",1,1,2
1583,"Tank, Mage","Tank, Fighter","Fighter, Mage","Assassin, Fighter",1,1,2
3828,Fighter,"Tank, Fighter","Assassin, Fighter","Support, Fighter",2,0,2
3270,"Mage, Fighter","Fighter, Marksman",Marksman,Mage,0,2,2
2661,"Fighter, Mage",Marksman,"Assassin, Fighter",Marksman,0,2,2
2662,Tank,Fighter,"Tank, Mage","Fighter, Mage",0,2,2
2663,"Fighter, Mage","Mage, Fighter","Fighter, Assassin","Fighter, Assassin",2,0,2
3263,"Tank, Fighter","Mage, Support","Fighter, Assassin","Tank, Support",2,0,2
2670,"Mage, Fighter","Assassin, Mage","Fighter, Mage","Assassin, Fighter",2,0,2
3834,"Tank, Fighter","Support, Fighter","Mage, Fighter","Support, Tank",2,0,2
1582,"Mage, Fighter","Mage, Tank",Fighter,"Mage, Support",0,2,2
1576,"Mage, Fighter","Mage, Tank",Fighter,"Assassin, Mage",0,2,2
2647,Marksman,"Support, Fighter","Fighter, Mage","Support, Tank",0,2,2
1587,"Mage, Fighter","Mage, Fighter","Fighter, Support","Assassin, Fighter",1,1,2
2673,"Assassin, Mage","Support, Mage","Mage, Fighter","Mage, Support",0,2,2
3803,"Tank, Fighter",Mage,"Tank, Fighter","Support, Fighter",0,2,2
3285,"Fighter, Assassin","Mage, Assassin","Fighter, Tank","Mage, Support",2,0,2
3284,"Tank, Mage",Marksman,"Fighter, Mage","Mage, Support",0,2,2
3790,Fighter,"Support, Fighter","Assassin, Fighter",Mage,2,0,2
3792,"Fighter, Assassin","Tank, Support","Tank, Fighter","Support, Mage",2,0,2
2638,"Mage, Fighter","Mage, Support","Fighter, Mage","Tank, Fighter",0,2,2
3798,"Fighter, Assassin","Support, Tank","Tank, Fighter","Support, Fighter",1,1,2
3802,Fighter,"Tank, Support","Tank, Fighter","Support, Fighter",1,1,2
1596,"Fighter, Mage",Mage,"Fighter, Assassin","Assassin, Mage",1,1,2
2640,"Assassin, Fighter","Support, Tank","Assassin, Fighter","Mage, Assassin",1,1,2
2646,"Mage, Fighter","Support, Mage","Fighter, Assassin",Marksman,2,0,2
1589,"Fighter, Assassin","Fighter, Tank","Fighter, Mage","Fighter, Tank",1,1,2
3279,"Tank, Fighter",Mage,"Assassin, Fighter","Mage, Support",1,1,2
2645,"Tank, Fighter","Mage, Fighter","Mage, Marksman",Marksman,1,1,2
3807,"Assassin, Fighter","Support, Fighter","Tank, Fighter","Mage, Support",1,1,2
3274,"Assassin, Fighter","Mage, Assassin","Support, Mage","Support, Mage",1,1,2
3273,Marksman,"Mage, Support","Fighter, Tank","Mage, Support",0,2,2
3812,"Tank, Fighter",Mage,"Fighter, Assassin","Support, Mage",2,0,2
3817,"Fighter, Assassin","Support, Mage","Tank, Fighter","Tank, Support",1,1,2
2671,"Fighter, Assassin","Mage, Support",Marksman,"Support, Fighter",1,1,2
2674,Tank,"Assassin, Mage","Tank, Mage",Fighter,1,1,2
3286,"Assassin, Fighter","Mage, Support","Fighter, Mage","Tank, Support",2,0,2
1552,"Tank, Fighter","Assassin, Mage",Fighter,Mage,0,2,2
1554,"Assassin, Fighter","Mage, Support",Fighter,"Mage, Tank",1,1,2
2702,"Fighter, Tank",Marksman,Fighter,"Mage, Support",1,1,2
2703,Fighter,Marksman,Marksman,"Mage, Support",2,0,2
3252,"Assassin, Fighter","Mage, Support","Fighter, Mage","Tank, Fighter",0,2,2
2704,"Assassin, Fighter","Support, Mage","Fighter, Mage","Support, Tank",1,1,2
1553,"Tank, Mage","Tank, Fighter","Mage, Fighter","Assassin, Fighter",2,0,2
2706,"Fighter, Tank","Mage, Support","Mage, Fighter","Support, Tank",1,1,2
2707,Marksman,"Support, Tank","Fighter, Mage","Mage, Support",0,2,2
1551,"Mage, Fighter","Mage, Assassin","Fighter, Assassin","Support, Mage",0,2,2
1556,"Tank, Mage","Assassin, Fighter","Support, Mage","Fighter, Assassin",1,1,2
2711,Fighter,"Support, Mage","Fighter, Tank","Tank, Support",1,1,2
1548,"Fighter, Assassin","Mage, Fighter","Mage, Fighter","Mage, Tank",2,0,2
3242,Fighter,"Support, Mage","Mage, Fighter","Mage, Assassin",1,1,2
2716,"Support, Mage","Mage, Support","Mage, Fighter","Support, Fighter",0,2,2
1545,Tank,"Support, Mage",Fighter,"Assassin, Fighter",1,1,2
2719,"Mage, Fighter","Support, Mage",Marksman,"Fighter, Tank",1,1,2
1539,"Marksman, Support","Mage, Assassin","Marksman, Assassin","Support, Tank",1,1,2
1537,"Marksman, Mage","Support, Mage",Mage,"Mage, Support",2,0,2
3255,Marksman,"Mage, Support","Fighter, Mage","Support, Fighter",1,1,2
3256,"Fighter, Assassin","Support, Mage",Fighter,"Support, Tank",2,0,2
3838,"Fighter, Mage","Support, Mage","Tank, Fighter","Tank, Fighter",0,2,2
2687,Marksman,"Tank, Support","Assassin, Fighter","Mage, Support",2,0,2
2675,"Mage, Fighter","Mage, Marksman","Fighter, Mage","Assassin, Mage",2,0,2
1570,"Mage, Fighter","Fighter, Assassin","Fighter, Tank","Assassin, Fighter",2,0,2
2677,"Assassin, Fighter","Assassin, Fighter","Mage, Fighter","Mage, Assassin",2,0,2
3842,"Tank, Fighter","Mage, Marksman","Tank, Fighter","Support, Mage",0,2,2
2678,Mage,"Tank, Fighter","Tank, Mage",Fighter,0,2,2
2680,"Fighter, Mage","Assassin, Mage","Tank, Mage","Fighter, Mage",1,1,2
2681,"Mage, Marksman","Fighter, Assassin",Tank,"Mage, Fighter",0,2,2
1568,"Assassin, Fighter","Tank, Fighter","Fighter, Assassin","Mage, Support",1,1,2
3847,"Fighter, Mage","Mage, Support","Tank, Fighter","Support, Fighter",1,1,2
3862,Marksman,"Tank, Support","Mage, Fighter","Tank, Fighter",0,2,2
3849,"Tank, Mage",Support,"Tank, Fighter","Support, Fighter",1,1,2
3852,"Assassin, Fighter","Support, Tank",Marksman,"Fighter, Tank",1,1,2
1567,"Mage, Fighter","Mage, Fighter","Support, Mage","Assassin, Fighter",2,0,2
1564,"Fighter, Mage","Assassin, Fighter","Fighter, Support","Mage, Fighter",2,0,2
2694,"Assassin, Fighter","Support, Fighter",Fighter,"Mage, Assassin",0,2,2
3859,"Mage, Fighter","Tank, Fighter",Marksman,"Support, Tank",2,0,2
1558,Fighter,"Tank, Mage","Fighter, Mage",Marksman,0,2,2
3861,"Fighter, Assassin","Tank, Support","Mage, Fighter","Support, Tank",1,1,2
3787,"Assassin, Mage","Mage, Marksman","Fighter, Mage",Mage,1,1,2
1599,"Mage, Fighter","Mage, Assassin","Fighter, Tank",Mage,2,0,2
1527,Fighter,Mage,"Tank, Fighter","Mage, Marksman",1,1,2
2583,"Assassin, Fighter","Mage, Assassin",Fighter,"Support, Fighter",2,0,2
2578,"Fighter, Mage",Fighter,"Mage, Support","Fighter, Assassin",2,0,2
3316,"Fighter, Mage","Mage, Support","Tank, Fighter","Mage, Marksman",0,2,2
1727,"Marksman, Assassin","Mage, Assassin","Marksman, Mage","Support, Fighter",2,0,2
3314,"Fighter, Assassin",Support,"Tank, Fighter","Support, Mage",0,2,2
1721,"Mage, Marksman","Fighter, Tank","Assassin, Fighter","Fighter, Assassin",2,0,2
3736,Fighter,Mage,"Assassin, Mage","Mage, Support",1,1,2
1720,"Assassin, Fighter","Mage, Support","Fighter, Mage","Mage, Fighter",1,1,2
2582,Fighter,Mage,"Assassin, Fighter","Fighter, Mage",1,1,2
1719,"Mage, Fighter","Assassin, Mage",Marksman,Marksman,1,1,2
2576,"Fighter, Assassin","Assassin, Fighter","Mage, Fighter","Assassin, Fighter",1,1,2
1716,"Assassin, Fighter","Mage, Tank","Mage, Fighter","Mage, Assassin",2,0,2
3738,"Assassin, Fighter","Tank, Support","Fighter, Mage","Support, Fighter",2,0,2
2596,"Tank, Fighter","Assassin, Fighter","Mage, Fighter","Mage, Assassin",1,1,2
1702,"Tank, Fighter","Fighter, Mage","Fighter, Assassin","Fighter, Assassin",1,1,2
1699,"Tank, Mage","Tank, Fighter",Fighter,"Tank, Fighter",1,1,2
2599,"Fighter, Mage","Fighter, Tank","Assassin, Fighter","Support, Tank",1,1,2
1698,"Marksman, Support","Mage, Assassin","Marksman, Assassin","Support, Fighter",1,1,2
1691,"Mage, Fighter","Fighter, Tank",Fighter,"Support, Fighter",1,1,2
3730,"Assassin, Fighter","Tank, Support",Fighter,"Tank, Fighter",0,2,2
1729,"Tank, Fighter","Fighter, Assassin","Fighter, Tank","Fighter, Tank",0,2,2
1679,"Marksman, Support","Support, Tank","Marksman, Mage","Fighter, Tank",1,1,2
2562,"Assassin, Fighter","Tank, Support","Fighter, Mage","Mage, Support",1,1,2
1743,Fighter,"Tank, Mage","Fighter, Assassin",Mage,1,1,2
2539,"Tank, Mage","Fighter, Assassin","Fighter, Mage","Mage, Fighter",1,1,2
2541,"Support, Mage",Fighter,"Fighter, Tank","Tank, Fighter",1,1,2
1742,"Fighter, Tank","Mage, Fighter","Tank, Fighter","Fighter, Tank",1,1,2
2548,"Marksman, Assassin","Support, Mage","Marksman, Support","Mage, Assassin",0,2,2
2556,"Fighter, Mage","Tank, Fighter","Mage, Marksman","Fighter, Assassin",2,0,2
2561,"Marksman, Support","Support, Mage","Marksman, Assassin","Mage, Assassin",0,2,2
3719,"Assassin, Mage","Tank, Fighter","Assassin, Fighter",Mage,2,0,2
2565,"Tank, Fighter","Fighter, Tank","Fighter, Mage","Support, Tank",0,2,2
1733,Mage,"Mage, Assassin","Marksman, Assassin","Mage, Support",2,0,2
1741,"Fighter, Mage","Tank, Mage","Fighter, Assassin","Mage, Support",2,0,2
2569,"Marksman, Support","Tank, Fighter",Marksman,"Support, Mage",2,0,2
1740,"Support, Mage","Mage, Assassin","Assassin, Fighter",Marksman,1,1,2
1737,"Assassin, Fighter","Fighter, Tank","Fighter, Mage",Fighter,2,0,2
3725,"Fighter, Assassin","Tank, Fighter","Assassin, Fighter","Support, Mage",1,1,2
2570,"Assassin, Mage","Fighter, Assassin","Mage, Support","Tank, Fighter",0,2,2
3319,"Fighter, Mage","Support, Fighter","Tank, Mage","Support, Tank",1,1,2
1734,"Fighter, Marksman","Fighter, Assassin","Fighter, Tank","Fighter, Tank",2,0,2
3307,"Assassin, Fighter","Support, Fighter","Mage, Fighter","Tank, Support",2,0,2
3305,"Tank, Mage","Support, Fighter","Tank, Fighter","Support, Mage",0,2,2
1600,"Mage, Fighter","Mage, Tank","Fighter, Tank","Mage, Support",0,2,2
1617,Marksman,"Tank, Support","Marksman, Assassin",Support,0,2,2
1630,"Assassin, Fighter",Mage,"Mage, Fighter","Marksman, Mage",0,2,2
1628,Fighter,"Mage, Marksman","Mage, Fighter","Marksman, Mage",2,0,2
1627,Marksman,"Support, Tank",Fighter,"Fighter, Tank",0,2,2
3775,"Assassin, Fighter","Tank, Support","Tank, Fighter","Support, Fighter",2,0,2
2631,"Marksman, Mage",Marksman,"Marksman, Assassin","Mage, Assassin",1,1,2
1625,"Marksman, Assassin","Tank, Support","Marksman, Mage","Support, Fighter",0,2,2
1624,"Assassin, Fighter",Mage,Marksman,"Mage, Fighter",1,1,2
1623,"Mage, Fighter","Tank, Support",Fighter,"Mage, Support",0,2,2
1612,"Assassin, Fighter","Mage, Support","Support, Mage","Mage, Assassin",1,1,2
1649,Tank,"Mage, Fighter","Fighter, Mage","Fighter, Assassin",2,0,2
3779,"Tank, Fighter","Support, Tank","Tank, Mage","Support, Fighter",1,1,2
3292,"Assassin, Fighter",Mage,Marksman,"Mage, Assassin",1,1,2
3289,"Mage, Fighter","Mage, Assassin",Fighter,"Mage, Support",1,1,2
1607,"Fighter, Tank","Mage, Tank","Fighter, Mage","Mage, Assassin",0,2,2
3288,Fighter,"Tank, Support","Assassin, Fighter","Mage, Support",2,0,2
1603,"Assassin, Fighter","Marksman, Mage","Mage, Fighter",Mage,0,2,2
1602,"Fighter, Assassin","Mage, Tank","Fighter, Mage","Mage, Assassin",1,1,2
2633,"Tank, Fighter","Mage, Support","Assassin, Fighter","Mage, Marksman",1,1,2
1633,"Assassin, Fighter","Support, Tank","Assassin, Fighter","Support, Tank",0,2,2
2630,"Support, Mage","Tank, Fighter","Tank, Mage","Fighter, Mage",1,1,2
2600,"Fighter, Tank",Mage,"Fighter, Assassin",Mage,1,1,2
2612,"Marksman, Mage","Mage, Support","Marksman, Support",Mage,1,1,2
1677,"Marksman, Mage","Support, Fighter","Marksman, Support","Mage, Assassin",2,0,2
1676,"Mage, Fighter","Support, Fighter",Marksman,"Support, Mage",2,0,2
3753,"Tank, Fighter","Tank, Support","Tank, Fighter","Fighter, Tank",2,0,2
3755,"Tank, Fighter","Support, Tank","Tank, Mage",Support,1,1,2
3758,"Tank, Mage","Support, Mage","Fighter, Mage","Support, Tank",0,2,2
2611,"Fighter, Assassin","Mage, Support","Support, Mage","Mage, Assassin",2,0,2
1667,"Mage, Fighter","Assassin, Mage","Fighter, Mage",Marksman,0,2,2
1655,"Mage, Fighter","Mage, Marksman","Fighter, Mage","Marksman, Mage",0,2,2
2613,Fighter,"Fighter, Mage","Fighter, Tank",Fighter,1,1,2
1650,"Fighter, Assassin","Support, Tank","Assassin, Fighter","Mage, Assassin",0,2,2
2617,"Fighter, Assassin","Mage, Assassin",Marksman,"Support, Mage",2,0,2
1653,"Fighter, Assassin","Mage, Support","Fighter, Tank",Marksman,1,1,2
3301,"Tank, Mage",Support,Fighter,"Support, Tank",0,2,2
2622,"Fighter, Assassin","Support, Tank","Fighter, Mage","Support, Tank",1,1,2
1652,"Assassin, Fighter",Marksman,Fighter,"Mage, Assassin",1,1,2
3767,"Fighter, Mage","Support, Mage","Assassin, Fighter",Mage,0,2,2
2623,Tank,"Mage, Fighter",Fighter,Fighter,2,0,2
2629,"Tank, Mage","Assassin, Mage","Fighter, Mage","Tank, Fighter",0,2,2
1532,"Tank, Mage","Tank, Support","Fighter, Mage",Support,1,1,2
1523,Fighter,Mage,"Fighter, Tank","Mage, Marksman",1,1,2
1244,"Fighter, Tank","Support, Tank","Fighter, Assassin","Support, Tank",0,2,2
3167,Marksman,"Support, Mage","Fighter, Mage","Support, Fighter",1,1,2
1319,"Mage, Fighter","Mage, Assassin","Fighter, Mage","Mage, Support",0,2,2
1313,"Assassin, Mage","Tank, Support","Fighter, Mage","Mage, Marksman",2,0,2
3904,"Mage, Fighter","Mage, Marksman",Marksman,"Tank, Fighter",1,1,2
2866,"Tank, Fighter","Tank, Support","Assassin, Fighter","Support, Mage",0,2,2
2869,"Tank, Fighter",Mage,Fighter,"Tank, Support",0,2,2
3906,"Fighter, Assassin","Mage, Assassin","Fighter, Mage","Mage, Support",2,0,2
1310,"Assassin, Fighter","Support, Fighter","Assassin, Mage","Tank, Support",2,0,2
3168,Marksman,"Assassin, Mage","Mage, Fighter","Support, Mage",2,0,2
3165,"Tank, Fighter","Mage, Support","Mage, Fighter","Tank, Mage",2,0,2
1326,"Fighter, Assassin","Fighter, Mage","Tank, Mage",Marksman,1,1,2
1306,"Assassin, Mage","Mage, Marksman","Tank, Fighter","Mage, Tank",0,2,2
2881,"Assassin, Fighter","Support, Tank","Fighter, Tank","Mage, Support",2,0,2
2882,"Fighter, Mage","Mage, Support","Assassin, Fighter","Tank, Support",2,0,2
1304,"Mage, Fighter","Assassin, Fighter","Support, Mage",Marksman,0,2,2
2887,"Tank, Fighter","Support, Mage","Fighter, Tank","Support, Fighter",2,0,2
3911,Fighter,"Support, Tank","Fighter, Tank","Support, Mage",1,1,2
3912,"Mage, Fighter","Mage, Support","Fighter, Mage","Fighter, Tank",1,1,2
2888,"Fighter, Tank","Support, Mage",Marksman,"Mage, Support",2,0,2
1321,"Fighter, Mage","Assassin, Mage",Fighter,"Mage, Assassin",2,0,2
2863,"Fighter, Mage","Support, Tank","Mage, Fighter","Fighter, Tank",0,2,2
1299,"Mage, Fighter",Fighter,"Tank, Fighter","Assassin, Fighter",0,2,2
1340,Marksman,"Tank, Support","Fighter, Marksman","Support, Fighter",2,0,2
3184,"Fighter, Mage","Tank, Fighter","Fighter, Tank","Support, Fighter",2,0,2
3183,"Mage, Fighter","Support, Tank","Support, Mage","Support, Fighter",1,1,2
1360,Marksman,"Mage, Marksman","Fighter, Mage","Marksman, Mage",0,2,2
1359,"Support, Mage",Marksman,Marksman,Mage,0,2,2
1357,"Assassin, Fighter","Mage, Marksman","Fighter, Assassin",Mage,1,1,2
1353,Fighter,"Mage, Fighter","Fighter, Mage","Support, Mage",1,1,2
1349,"Fighter, Assassin",Fighter,"Tank, Fighter","Mage, Fighter",1,1,2
1344,"Assassin, Fighter","Marksman, Fighter","Fighter, Mage",Mage,2,0,2
1339,Fighter,"Assassin, Mage","Assassin, Fighter","Mage, Marksman",1,1,2
3171,"Fighter, Assassin","Support, Mage","Fighter, Mage","Mage, Assassin",1,1,2
3173,"Assassin, Fighter","Support, Fighter","Fighter, Mage","Support, Mage",0,2,2
1338,"Fighter, Assassin","Marksman, Fighter","Fighter, Mage",Mage,2,0,2
3898,"Assassin, Fighter","Mage, Support","Fighter, Tank","Support, Fighter",0,2,2
1333,"Tank, Fighter","Tank, Support",Fighter,"Tank, Fighter",0,2,2
2860,Fighter,"Mage, Support","Fighter, Assassin","Support, Fighter",2,0,2
1331,Tank,Fighter,Fighter,"Mage, Fighter",1,1,2
1330,"Support, Mage",Marksman,"Mage, Fighter","Mage, Support",1,1,2
1327,"Support, Mage",Marksman,"Assassin, Fighter","Assassin, Fighter",2,0,2
1303,"Assassin, Fighter","Assassin, Mage","Fighter, Assassin","Mage, Fighter",1,1,2
1298,"Fighter, Assassin","Mage, Fighter","Fighter, Assassin",Fighter,1,1,2
3897,"Mage, Fighter","Support, Fighter",Marksman,"Tank, Support",1,1,2
1260,"Mage, Fighter","Mage, Marksman","Fighter, Mage","Mage, Fighter",2,0,2
1267,"Fighter, Tank",Fighter,Fighter,"Mage, Fighter",1,1,2
3147,Marksman,"Mage, Support","Fighter, Mage","Mage, Support",2,0,2
2920,Fighter,"Fighter, Tank","Fighter, Mage","Support, Mage",1,1,2
2923,Marksman,"Tank, Support","Fighter, Mage","Mage, Support",1,1,2
1265,"Assassin, Mage","Tank, Support",Fighter,"Tank, Fighter",2,0,2
2924,"Fighter, Assassin","Support, Mage",Fighter,"Support, Mage",0,2,2
2927,Fighter,"Mage, Assassin","Mage, Fighter","Support, Mage",0,2,2
1263,"Marksman, Mage","Mage, Support",Marksman,Support,1,1,2
1259,Tank,Fighter,"Tank, Fighter","Mage, Fighter",1,1,2
3148,"Fighter, Assassin","Mage, Support","Assassin, Fighter","Tank, Fighter",1,1,2
1257,"Fighter, Mage","Support, Tank",Fighter,"Tank, Fighter",1,1,2
2930,"Fighter, Tank","Support, Mage","Fighter, Mage","Support, Tank",1,1,2
1255,"Fighter, Mage","Fighter, Marksman",Fighter,"Mage, Marksman",1,1,2
1251,Fighter,"Assassin, Mage","Mage, Fighter","Mage, Fighter",1,1,2
3938,"Tank, Fighter","Support, Tank","Fighter, Mage","Tank, Support",1,1,2
1250,Fighter,"Mage, Marksman","Mage, Fighter","Assassin, Fighter",1,1,2
1249,Fighter,"Fighter, Marksman","Fighter, Mage","Mage, Assassin",0,2,2
1248,Fighter,"Tank, Support","Assassin, Mage","Support, Mage",1,1,2
1268,Marksman,Mage,Marksman,"Assassin, Mage",1,1,2
1269,Fighter,"Tank, Support","Fighter, Mage","Mage, Marksman",1,1,2
1294,"Mage, Fighter","Fighter, Marksman","Assassin, Fighter",Marksman,2,0,2
3160,"Tank, Fighter","Support, Mage","Support, Mage","Support, Mage",2,0,2
2896,"Fighter, Mage","Support, Tank",Marksman,"Support, Mage",0,2,2
1293,"Support, Mage","Mage, Fighter",Marksman,Marksman,1,1,2
3918,"Mage, Fighter","Support, Fighter",Fighter,"Mage, Support",1,1,2
1292,Fighter,"Tank, Support","Fighter, Assassin","Support, Tank",1,1,2
1291,"Assassin, Mage","Support, Tank",Fighter,"Support, Fighter",1,1,2
2900,"Fighter, Mage","Support, Mage",Marksman,"Support, Mage",1,1,2
1290,"Fighter, Assassin","Support, Fighter","Assassin, Mage","Tank, Support",2,0,2
1288,"Support, Tank",Fighter,"Fighter, Assassin","Mage, Fighter",2,0,2
2903,"Fighter, Assassin","Mage, Support","Fighter, Mage","Support, Fighter",0,2,2
3150,"Tank, Fighter","Support, Tank","Mage, Fighter","Support, Tank",0,2,2
3924,"Fighter, Mage","Support, Mage","Assassin, Fighter","Support, Tank",1,1,2
1287,Fighter,"Mage, Assassin","Fighter, Mage",Marksman,0,2,2
2908,"Support, Mage",Marksman,"Assassin, Fighter","Mage, Assassin",1,1,2
1283,Fighter,"Mage, Assassin","Mage, Fighter","Mage, Tank",1,1,2
1282,"Fighter, Assassin","Tank, Support","Fighter, Mage","Support, Mage",1,1,2
1276,"Mage, Fighter",Mage,"Fighter, Mage","Marksman, Mage",0,2,2
1270,"Fighter, Mage","Support, Fighter","Assassin, Mage","Tank, Fighter",0,2,2
2914,"Mage, Fighter","Tank, Fighter","Fighter, Mage","Tank, Support",0,2,2
1361,Fighter,"Mage, Fighter","Mage, Fighter","Mage, Tank",1,1,2
2845,Fighter,"Tank, Fighter","Tank, Fighter","Tank, Support",0,2,2
1521,"Mage, Marksman","Mage, Fighter","Tank, Mage","Fighter, Assassin",1,1,2
1456,Marksman,"Tank, Fighter","Mage, Fighter","Tank, Support",1,1,2
2756,"Fighter, Mage","Mage, Support",Marksman,Mage,2,0,2
1467,"Marksman, Support","Fighter, Tank","Marksman, Mage","Tank, Support",1,1,2
2757,"Mage, Fighter","Support, Mage","Fighter, Mage","Tank, Fighter",1,1,2
1462,"Tank, Mage","Fighter, Mage","Support, Mage",Fighter,1,1,2
3222,"Fighter, Assassin","Mage, Support",Fighter,"Tank, Fighter",2,0,2
1457,"Marksman, Assassin","Fighter, Tank","Marksman, Support","Support, Mage",2,0,2
2764,Marksman,"Support, Mage","Fighter, Mage","Tank, Fighter",0,2,2
3220,"Fighter, Assassin","Mage, Support","Fighter, Mage","Support, Tank",1,1,2
3219,"Assassin, Fighter","Marksman, Mage",Fighter,"Mage, Support",2,0,2
1473,"Support, Mage","Mage, Support",Marksman,"Support, Fighter",0,2,2
2770,Fighter,"Mage, Assassin","Assassin, Fighter","Mage, Support",1,1,2
1455,"Assassin, Fighter","Mage, Support","Fighter, Mage","Mage, Tank",1,1,2
1454,"Mage, Fighter","Mage, Support","Fighter, Mage","Mage, Tank",1,1,2
1448,Marksman,"Tank, Fighter","Fighter, Assassin","Support, Mage",2,0,2
1441,Marksman,"Support, Tank","Fighter, Assassin","Tank, Support",1,1,2
1434,"Mage, Fighter","Tank, Support","Assassin, Fighter","Fighter, Tank",2,0,2
2776,"Fighter, Tank","Support, Tank","Fighter, Mage","Support, Mage",2,0,2
2780,"Fighter, Assassin","Support, Mage","Mage, Fighter","Tank, Support",1,1,2
1471,"Marksman, Assassin","Support, Fighter","Marksman, Support","Mage, Support",1,1,2
2753,"Mage, Fighter","Mage, Assassin","Assassin, Fighter",Mage,2,0,2
1428,Fighter,"Support, Fighter",Marksman,"Support, Mage",1,1,2
1497,"Fighter, Assassin","Mage, Assassin",Marksman,Mage,0,2,2
3235,"Fighter, Mage","Support, Fighter","Fighter, Tank","Support, Tank",1,1,2
1516,"Tank, Fighter",Support,"Tank, Mage","Support, Tank",1,1,2
1504,"Fighter, Assassin","Support, Tank",Fighter,Mage,1,1,2
2731,Fighter,"Support, Mage",Marksman,"Support, Mage",2,0,2
1502,"Fighter, Assassin","Fighter, Marksman",Marksman,"Mage, Assassin",2,0,2
2732,Marksman,"Tank, Support","Assassin, Fighter","Tank, Fighter",2,0,2
2738,Fighter,"Support, Tank","Fighter, Tank","Support, Tank",1,1,2
1499,"Assassin, Fighter","Assassin, Mage","Tank, Fighter","Mage, Assassin",2,0,2
1490,Marksman,"Mage, Support","Assassin, Fighter","Fighter, Marksman",2,0,2
2749,Fighter,"Tank, Support","Fighter, Tank","Mage, Support",2,0,2
1489,"Fighter, Tank","Mage, Support",Marksman,"Support, Tank",0,2,2
3227,"Mage, Fighter",Support,Fighter,"Support, Tank",1,1,2
2744,"Fighter, Mage","Mage, Support","Assassin, Fighter","Support, Tank",1,1,2
2746,"Fighter, Tank","Mage, Assassin","Fighter, Assassin","Mage, Support",1,1,2
2747,"Support, Mage","Mage, Assassin","Assassin, Fighter","Support, Mage",2,0,2
1485,"Mage, Fighter","Support, Tank",Fighter,"Mage, Marksman",2,0,2
3878,"Mage, Fighter","Fighter, Tank","Assassin, Fighter","Mage, Support",2,0,2
1475,"Fighter, Tank",Fighter,"Assassin, Fighter","Mage, Fighter",2,0,2
1433,"Fighter, Tank",Mage,"Assassin, Fighter",Mage,1,1,2
2786,"Fighter, Tank","Mage, Support",Marksman,"Support, Mage",0,2,2
2844,"Mage, Fighter","Support, Tank","Fighter, Tank","Mage, Support",2,0,2
1372,"Assassin, Mage","Support, Mage",Fighter,"Tank, Fighter",0,2,2
1399,Marksman,"Mage, Assassin",Fighter,"Assassin, Mage",2,0,2
1390,Fighter,"Support, Tank",Marksman,"Fighter, Tank",0,2,2
2824,Fighter,"Support, Mage","Fighter, Tank","Support, Mage",1,1,2
1388,"Assassin, Fighter",Fighter,Tank,"Fighter, Tank",0,2,2
1387,"Mage, Fighter","Mage, Marksman",Fighter,"Mage, Support",1,1,2
1385,"Tank, Fighter","Fighter, Assassin","Tank, Mage",Marksman,0,2,2
1383,"Fighter, Tank","Mage, Tank",Fighter,"Mage, Fighter",1,1,2
1375,Fighter,"Support, Fighter","Assassin, Mage","Tank, Fighter",1,1,2
1368,"Fighter, Mage",Marksman,"Tank, Mage","Assassin, Fighter",2,0,2
1401,"Mage, Fighter","Mage, Marksman",Fighter,"Mage, Fighter",1,1,2
3192,"Tank, Mage","Tank, Support","Fighter, Mage","Support, Tank",1,1,2
1364,Marksman,"Tank, Support","Fighter, Marksman","Tank, Fighter",1,1,2
3891,"Assassin, Fighter","Tank, Support",Fighter,"Support, Mage",1,1,2
1363,Fighter,"Mage, Fighter","Fighter, Tank",Mage,1,1,2
1362,"Tank, Mage",Marksman,Fighter,"Mage, Fighter",2,0,2
2836,"Fighter, Mage","Support, Tank","Fighter, Tank","Mage, Support",2,0,2
3893,Marksman,"Mage, Support","Fighter, Mage","Mage, Assassin",1,1,2
2842,"Mage, Fighter","Support, Mage","Fighter, Tank","Support, Tank",1,1,2
3196,"Assassin, Fighter","Support, Fighter",Fighter,Support,2,0,2
1402,"Fighter, Mage","Support, Mage","Mage, Fighter","Support, Fighter",0,2,2
3206,Marksman,Marksman,Fighter,Mage,1,1,2
2805,"Tank, Fighter","Fighter, Tank","Tank, Fighter","Support, Fighter",2,0,2
1420,Fighter,"Tank, Support",Marksman,"Support, Mage",1,1,2
2787,"Tank, Fighter","Mage, Support","Fighter, Mage","Fighter, Tank",1,1,2
2790,"Fighter, Mage","Support, Mage","Fighter, Tank","Support, Tank",2,0,2
2797,Marksman,"Support, Mage","Fighter, Mage","Support, Mage",1,1,2
2799,"Fighter, Tank","Support, Tank",Fighter,"Mage, Support",0,2,2
2802,"Support, Mage","Mage, Support","Fighter, Assassin","Support, Mage",1,1,2
2803,"Tank, Fighter",Mage,"Fighter, Tank",Mage,0,2,2
3203,"Mage, Fighter","Fighter, Tank","Fighter, Mage","Tank, Fighter",1,1,2
1416,Mage,Fighter,"Fighter, Assassin","Tank, Fighter",1,1,2
2821,"Fighter, Tank","Tank, Support","Fighter, Mage","Support, Mage",0,2,2
1415,Fighter,"Tank, Support","Mage, Fighter","Mage, Support",1,1,2
2808,Fighter,"Fighter, Tank",Marksman,"Mage, Support",1,1,2
2811,"Tank, Fighter","Tank, Fighter",Fighter,"Mage, Support",0,2,2
2813,"Mage, Fighter","Support, Fighter","Assassin, Fighter","Fighter, Tank",1,1,2
1413,"Assassin, Fighter","Tank, Support","Mage, Fighter","Fighter, Tank",0,2,2
1410,"Mage, Fighter","Fighter, Tank","Fighter, Mage","Tank, Support",2,0,2
2816,"Fighter, Mage","Tank, Fighter","Tank, Fighter","Mage, Support",2,0,2
1409,"Fighter, Assassin","Mage, Support","Fighter, Mage","Tank, Mage",1,1,2
1744,Marksman,"Support, Mage","Fighter, Assassin","Mage, Assassin",1,1,2
1749,"Fighter, Marksman","Mage, Fighter","Tank, Fighter","Fighter, Tank",1,1,2
3326,"Tank, Fighter","Mage, Support","Tank, Fighter",Support,1,1,2
1992,Fighter,"Mage, Marksman","Fighter, Mage","Mage, Support",2,0,2
1996,"Mage, Fighter",Marksman,Marksman,"Assassin, Mage",1,1,2
3534,"Fighter, Assassin","Tank, Support","Assassin, Fighter",Mage,1,1,2
2274,"Fighter, Mage","Tank, Support","Mage, Fighter","Support, Fighter",1,1,2
2276,Fighter,"Support, Fighter","Fighter, Assassin",Mage,1,1,2
2281,"Fighter, Tank","Fighter, Mage","Mage, Marksman",Fighter,1,1,2
1994,Fighter,"Support, Fighter","Fighter, Assassin","Support, Mage",2,0,2
2283,"Fighter, Tank",Fighter,"Mage, Marksman","Fighter, Mage",1,1,2
1993,"Mage, Fighter",Fighter,Fighter,"Support, Mage",0,2,2
1989,"Fighter, Mage",Fighter,Tank,"Assassin, Fighter",1,1,2
2004,Fighter,"Mage, Assassin","Fighter, Mage","Fighter, Mage",1,1,2
3537,"Fighter, Tank","Support, Mage",Fighter,"Support, Mage",0,2,2
1988,"Mage, Fighter","Mage, Support",Fighter,Support,2,0,2
1987,"Mage, Fighter",Support,Fighter,"Support, Fighter",1,1,2
2290,"Tank, Mage",Marksman,Tank,"Support, Mage",0,2,2
1984,Fighter,Support,"Fighter, Mage","Support, Tank",0,2,2
3419,"Tank, Fighter","Tank, Fighter","Assassin, Fighter","Support, Fighter",2,0,2
2293,"Fighter, Mage","Support, Mage","Fighter, Assassin","Support, Tank",1,1,2
2300,"Assassin, Mage","Support, Fighter","Tank, Fighter","Tank, Support",0,2,2
2003,Fighter,"Support, Fighter","Mage, Fighter","Mage, Support",0,2,2
2005,"Mage, Fighter","Assassin, Fighter","Fighter, Mage","Assassin, Fighter",1,1,2
3416,"Fighter, Assassin","Support, Tank","Fighter, Tank","Support, Mage",0,2,2
2022,Fighter,"Support, Mage","Mage, Fighter","Marksman, Mage",2,0,2
2263,Fighter,"Mage, Fighter",Tank,"Fighter, Mage",1,1,2
2030,"Tank, Mage",Fighter,"Fighter, Assassin","Fighter, Tank",2,0,2
3518,Fighter,"Support, Fighter",Marksman,"Fighter, Tank",0,2,2
3519,"Tank, Fighter","Tank, Support","Mage, Fighter","Support, Mage",2,0,2
2028,"Assassin, Fighter",Marksman,"Tank, Fighter","Fighter, Mage",1,1,2
2025,"Assassin, Fighter",Marksman,Fighter,"Support, Mage",1,1,2
2024,"Mage, Fighter",Fighter,"Fighter, Mage","Assassin, Fighter",2,0,2
2266,"Tank, Mage","Fighter, Assassin","Support, Mage",Fighter,2,0,2
2267,"Marksman, Mage","Mage, Assassin","Marksman, Support","Support, Tank",1,1,2
2273,"Assassin, Fighter","Support, Fighter",Fighter,"Support, Mage",1,1,2
2021,Fighter,Mage,"Mage, Fighter",Fighter,1,1,2
2269,"Mage, Fighter",Tank,"Fighter, Mage","Support, Fighter",2,0,2
3525,"Tank, Fighter","Tank, Support","Mage, Fighter","Support, Tank",1,1,2
2019,"Fighter, Mage","Tank, Support","Assassin, Fighter","Support, Fighter",0,2,2
2270,"Fighter, Mage","Assassin, Mage","Fighter, Tank","Fighter, Mage",1,1,2
3428,"Mage, Fighter","Support, Mage","Fighter, Mage","Support, Tank",1,1,2
2016,"Mage, Fighter","Mage, Marksman",Fighter,"Marksman, Mage",2,0,2
2271,"Mage, Marksman",Fighter,"Fighter, Tank","Fighter, Mage",0,2,2
1982,Fighter,Support,"Fighter, Mage","Tank, Support",1,1,2
2303,"Tank, Fighter",Mage,"Fighter, Mage","Tank, Support",0,2,2
3514,"Assassin, Fighter","Support, Tank","Fighter, Mage","Fighter, Tank",1,1,2
1948,Fighter,"Mage, Assassin","Fighter, Mage","Marksman, Mage",1,1,2
1955,Fighter,"Mage, Marksman","Fighter, Mage","Support, Mage",2,0,2
3557,"Mage, Fighter","Fighter, Tank","Fighter, Tank","Tank, Support",0,2,2
2328,Fighter,"Tank, Support","Fighter, Mage","Mage, Support",1,1,2
3398,"Assassin, Fighter","Support, Mage","Mage, Fighter","Tank, Fighter",2,0,2
2329,"Assassin, Fighter",Mage,Fighter,"Tank, Support",2,0,2
3397,"Tank, Fighter","Mage, Support",Fighter,"Tank, Support",1,1,2
1952,Fighter,"Fighter, Mage","Fighter, Mage",Mage,1,1,2
1949,"Tank, Fighter","Assassin, Fighter",Fighter,"Support, Mage",1,1,2
2332,"Mage, Fighter",Mage,Fighter,"Mage, Tank",1,1,2
2327,"Fighter, Mage","Support, Mage","Fighter, Assassin",Mage,2,0,2
2340,"Mage, Fighter","Support, Fighter",Marksman,"Fighter, Tank",1,1,2
1947,"Fighter, Mage","Support, Tank","Fighter, Mage","Tank, Support",2,0,2
2346,"Fighter, Mage","Tank, Support",Fighter,"Fighter, Tank",1,1,2
2348,"Fighter, Assassin","Assassin, Fighter","Fighter, Tank","Fighter, Mage",1,1,2
3392,"Fighter, Mage","Support, Tank","Fighter, Mage","Support, Mage",0,2,2
2351,"Tank, Mage",Fighter,"Fighter, Mage","Mage, Fighter",0,2,2
1940,Fighter,"Assassin, Mage","Fighter, Mage","Tank, Mage",1,1,2
1937,"Tank, Fighter","Marksman, Mage",Fighter,"Assassin, Mage",2,0,2
1971,Fighter,Mage,"Mage, Fighter","Fighter, Mage",0,2,2
2326,"Mage, Fighter","Mage, Support","Assassin, Fighter","Tank, Support",1,1,2
3541,Fighter,"Support, Fighter","Fighter, Tank","Mage, Support",2,0,2
1978,"Fighter, Mage","Support, Fighter","Tank, Fighter","Support, Fighter",1,1,2
1981,Fighter,"Support, Mage","Mage, Fighter",Marksman,2,0,2
3542,"Assassin, Fighter",Mage,"Assassin, Mage","Support, Mage",2,0,2
3543,"Fighter, Mage","Support, Fighter",Marksman,"Support, Mage",1,1,2
1979,"Fighter, Mage","Assassin, Fighter","Tank, Mage","Mage, Fighter",2,0,2
3546,"Fighter, Mage","Fighter, Tank",Fighter,"Support, Mage",1,1,2
3547,"Assassin, Fighter","Fighter, Tank",Marksman,"Support, Tank",2,0,2
3548,"Fighter, Mage","Fighter, Tank","Fighter, Assassin","Support, Mage",2,0,2
3549,Marksman,"Tank, Support","Fighter, Mage","Support, Fighter",1,1,2
2305,"Marksman, Mage","Support, Fighter","Marksman, Assassin",Marksman,2,0,2
3405,"Assassin, Mage","Tank, Support","Fighter, Mage","Mage, Support",0,2,2
2307,"Tank, Mage",Fighter,"Tank, Fighter","Assassin, Fighter",1,1,2
2314,Fighter,"Support, Mage",Marksman,"Mage, Assassin",0,2,2
1977,Fighter,"Mage, Fighter",Marksman,Mage,1,1,2
3407,"Fighter, Tank","Support, Fighter","Fighter, Mage","Support, Tank",1,1,2
2318,"Fighter, Mage","Tank, Fighter",Mage,"Fighter, Assassin",2,0,2
2322,"Support, Mage","Fighter, Assassin","Fighter, Tank","Tank, Fighter",2,0,2
1974,Fighter,Fighter,"Mage, Fighter","Assassin, Mage",2,0,2
2325,"Fighter, Mage","Tank, Fighter","Fighter, Assassin","Tank, Support",1,1,2
2252,"Marksman, Mage","Tank, Fighter",Marksman,"Tank, Support",0,2,2
2250,"Fighter, Assassin","Fighter, Assassin","Fighter, Mage","Tank, Fighter",0,2,2
3711,"Fighter, Mage","Tank, Fighter","Assassin, Fighter","Support, Fighter",1,1,2
2130,Fighter,"Tank, Support","Assassin, Fighter","Tank, Fighter",2,0,2
2143,"Fighter, Mage",Fighter,Fighter,"Mage, Fighter",1,1,2
2190,Tank,Marksman,"Fighter, Mage",Fighter,2,0,2
2192,"Fighter, Assassin",Fighter,Fighter,"Fighter, Mage",2,0,2
3451,"Mage, Fighter","Mage, Assassin","Assassin, Fighter","Support, Mage",2,0,2
3450,"Assassin, Fighter","Support, Mage","Support, Mage","Mage, Assassin",0,2,2
2136,"Assassin, Fighter","Fighter, Mage",Fighter,Fighter,2,0,2
2135,"Tank, Fighter",Fighter,Tank,"Fighter, Assassin",2,0,2
3485,"Assassin, Fighter",Mage,Fighter,"Support, Mage",1,1,2
2194,"Fighter, Mage","Mage, Fighter","Tank, Fighter","Fighter, Mage",0,2,2
2147,"Tank, Fighter","Fighter, Mage","Tank, Mage",Marksman,0,2,2
2129,Fighter,Fighter,"Fighter, Assassin","Mage, Fighter",1,1,2
2125,"Tank, Mage",Marksman,"Tank, Fighter",Marksman,2,0,2
3488,"Assassin, Fighter","Tank, Support","Tank, Fighter","Tank, Fighter",2,0,2
2195,Fighter,Fighter,"Tank, Fighter","Mage, Fighter",2,0,2
2124,Tank,"Fighter, Assassin","Fighter, Assassin","Fighter, Tank",2,0,2
2120,Tank,Fighter,"Fighter, Assassin","Assassin, Fighter",0,2,2
2119,Marksman,"Mage, Support","Marksman, Mage",Marksman,0,2,2
2118,"Assassin, Fighter","Fighter, Tank",Fighter,"Support, Tank",2,0,2
2189,Tank,"Assassin, Fighter",Fighter,"Mage, Fighter",2,0,2
2148,Fighter,Fighter,"Assassin, Fighter","Mage, Fighter",2,0,2
2103,"Support, Mage",Marksman,"Tank, Fighter","Assassin, Fighter",1,1,2
2164,Marksman,Marksman,"Marksman, Mage","Mage, Assassin",1,1,2
2176,"Fighter, Tank",Fighter,"Assassin, Fighter","Fighter, Tank",2,0,2
2171,"Tank, Mage","Assassin, Fighter","Fighter, Assassin","Mage, Fighter",1,1,2
2170,"Assassin, Fighter","Support, Mage","Fighter, Assassin","Tank, Fighter",1,1,2
3461,Marksman,"Mage, Support","Fighter, Assassin","Tank, Fighter",2,0,2
2183,"Support, Mage",Marksman,Marksman,"Mage, Support",2,0,2
2165,Mage,Fighter,"Fighter, Assassin","Mage, Fighter",0,2,2
3462,"Fighter, Tank","Tank, Fighter","Fighter, Mage","Support, Mage",1,1,2
3463,Marksman,"Support, Tank","Fighter, Assassin","Mage, Support",2,0,2
2161,"Assassin, Fighter","Assassin, Fighter","Fighter, Tank","Mage, Fighter",2,0,2
3474,"Assassin, Fighter","Tank, Fighter",Marksman,"Support, Mage",1,1,2
2160,Fighter,Fighter,"Fighter, Tank","Mage, Fighter",1,1,2
3458,"Assassin, Fighter","Support, Mage","Assassin, Fighter","Support, Fighter",1,1,2
3470,"Fighter, Assassin","Fighter, Tank","Assassin, Fighter","Support, Mage",2,0,2
2185,"Tank, Fighter",Mage,"Assassin, Fighter","Support, Mage",2,0,2
2154,Fighter,"Mage, Fighter","Assassin, Fighter","Fighter, Tank",1,1,2
2187,Tank,"Fighter, Mage","Tank, Mage","Mage, Fighter",2,0,2
2151,Fighter,"Mage, Fighter","Fighter, Tank","Fighter, Tank",1,1,2
2149,"Fighter, Assassin","Support, Tank",Fighter,"Support, Tank",1,1,2
2198,"Tank, Mage","Assassin, Fighter","Tank, Fighter","Support, Mage",1,1,2
2199,"Fighter, Tank","Mage, Fighter",Marksman,"Fighter, Mage",1,1,2
2031,"Mage, Marksman","Assassin, Fighter","Tank, Fighter",Marksman,1,1,2
3435,"Mage, Fighter",Mage,"Assassin, Fighter","Tank, Support",1,1,2
3440,"Fighter, Assassin","Tank, Fighter",Fighter,"Tank, Support",2,0,2
2231,"Fighter, Mage","Support, Mage","Fighter, Mage","Fighter, Assassin",1,1,2
2061,"Tank, Mage","Fighter, Assassin","Fighter, Mage",Marksman,1,1,2
2052,Fighter,"Mage, Fighter","Tank, Mage",Marksman,0,2,2
2233,Tank,Marksman,Fighter,"Fighter, Mage",0,2,2
2051,"Tank, Mage","Tank, Fighter","Tank, Fighter","Support, Fighter",1,1,2
2045,"Assassin, Fighter","Mage, Fighter",Fighter,"Fighter, Mage",0,2,2
2042,"Tank, Mage","Tank, Support","Fighter, Mage","Mage, Support",1,1,2
2041,"Fighter, Mage","Fighter, Tank",Fighter,"Mage, Support",2,0,2
3506,Marksman,"Mage, Support","Fighter, Mage","Tank, Support",1,1,2
2236,"Mage, Fighter","Support, Mage","Assassin, Fighter","Fighter, Tank",2,0,2
2238,"Tank, Fighter","Fighter, Mage",Fighter,"Fighter, Assassin",1,1,2
3511,"Fighter, Tank","Support, Mage","Fighter, Mage","Tank, Support",0,2,2
2033,"Assassin, Fighter","Mage, Fighter","Tank, Fighter",Mage,0,2,2
2240,"Fighter, Mage","Assassin, Fighter","Fighter, Marksman","Fighter, Tank",1,1,2
2241,"Tank, Fighter","Support, Mage","Tank, Mage",Fighter,1,1,2
3513,"Fighter, Mage","Support, Tank","Tank, Fighter","Support, Mage",0,2,2
2243,"Assassin, Fighter",Fighter,"Fighter, Tank","Tank, Fighter",1,1,2
2062,"Tank, Mage",Marksman,"Fighter, Tank",Fighter,1,1,2
2066,"Tank, Mage","Mage, Fighter","Assassin, Fighter","Assassin, Fighter",1,1,2
3494,"Tank, Fighter","Support, Mage","Assassin, Mage","Tank, Support",2,0,2
2078,"Tank, Fighter","Tank, Support","Assassin, Mage","Mage, Support",1,1,2
2202,Tank,Fighter,"Tank, Mage",Marksman,2,0,2
2102,"Assassin, Fighter",Mage,Marksman,"Assassin, Fighter",2,0,2
2101,"Tank, Fighter","Mage, Fighter","Support, Tank",Marksman,1,1,2
2095,"Assassin, Fighter","Mage, Assassin","Tank, Fighter","Mage, Fighter",1,1,2
2203,"Fighter, Mage",Fighter,Tank,"Fighter, Mage",0,2,2
2205,Fighter,"Tank, Fighter","Assassin, Fighter","Support, Mage",0,2,2
3443,Fighter,"Tank, Fighter","Tank, Fighter","Support, Fighter",1,1,2
2087,Fighter,"Assassin, Fighter","Mage, Fighter","Mage, Support",0,2,2
3499,"Fighter, Mage","Support, Fighter","Fighter, Assassin",Tank,2,0,2
2225,"Support, Mage","Mage, Assassin","Assassin, Fighter","Support, Tank",1,1,2
2209,Marksman,"Support, Fighter","Fighter, Assassin","Tank, Support",1,1,2
2213,"Fighter, Mage","Assassin, Mage",Fighter,"Tank, Mage",1,1,2
3503,"Tank, Fighter","Support, Fighter","Fighter, Assassin","Tank, Support",2,0,2
2075,"Tank, Mage","Assassin, Mage","Tank, Fighter",Marksman,2,0,2
2222,"Fighter, Tank",Fighter,"Support, Tank","Mage, Fighter",0,2,2
2069,"Assassin, Fighter","Tank, Support","Fighter, Assassin","Fighter, Tank",0,2,2
3441,"Fighter, Assassin","Support, Mage","Fighter, Mage","Support, Mage",1,1,2
2068,"Assassin, Fighter","Mage, Fighter","Mage, Fighter",Fighter,1,1,2
2353,"Tank, Fighter","Tank, Fighter","Fighter, Assassin","Fighter, Mage",1,1,2
2355,"Fighter, Marksman","Mage, Fighter",Tank,"Support, Mage",0,2,2
3569,"Assassin, Fighter","Support, Mage","Fighter, Tank","Mage, Assassin",1,1,2
1799,"Fighter, Mage","Mage, Support",Fighter,"Mage, Tank",1,1,2
2482,"Fighter, Mage",Support,"Fighter, Assassin","Support, Mage",2,0,2
3658,Marksman,"Mage, Support","Fighter, Assassin","Support, Tank",1,1,2
1816,"Mage, Fighter",Support,Fighter,"Tank, Support",1,1,2
1815,Fighter,"Support, Tank","Fighter, Assassin","Support, Tank",0,2,2
1808,Fighter,"Mage, Tank","Fighter, Tank","Mage, Fighter",2,0,2
1803,"Assassin, Fighter","Marksman, Mage","Fighter, Mage","Mage, Marksman",1,1,2
1800,"Fighter, Assassin","Mage, Support",Marksman,"Mage, Tank",2,0,2
3666,"Fighter, Mage",Support,"Mage, Fighter","Mage, Support",1,1,2
2483,Tank,"Mage, Fighter","Tank, Mage",Fighter,2,0,2
2474,"Support, Mage","Mage, Assassin",Marksman,"Mage, Support",1,1,2
1797,"Fighter, Assassin","Mage, Marksman","Mage, Fighter","Marksman, Mage",0,2,2
1784,Fighter,"Support, Fighter","Fighter, Assassin",Support,1,1,2
1783,"Marksman, Assassin","Mage, Assassin",Marksman,"Support, Tank",0,2,2
2491,"Fighter, Mage","Fighter, Mage","Tank, Mage","Tank, Fighter",2,0,2
3672,"Fighter, Assassin","Support, Tank",Fighter,Support,2,0,2
1780,"Mage, Fighter","Fighter, Tank","Fighter, Mage","Support, Tank",1,1,2
3354,Marksman,"Support, Mage","Mage, Fighter","Tank, Support",2,0,2
1779,"Fighter, Mage","Support, Fighter",Fighter,"Tank, Mage",2,0,2
2477,"Fighter, Assassin","Mage, Assassin","Assassin, Fighter","Support, Fighter",0,2,2
2470,"Tank, Fighter","Fighter, Mage",Tank,Fighter,2,0,2
3353,"Fighter, Mage","Tank, Support","Fighter, Tank","Support, Tank",1,1,2
1831,Fighter,"Support, Tank","Fighter, Mage",Support,1,1,2
1832,"Marksman, Assassin","Tank, Fighter","Marksman, Mage","Mage, Support",1,1,2
3643,"Mage, Fighter","Support, Mage","Fighter, Assassin","Support, Mage",1,1,2
3645,"Fighter, Assassin","Support, Tank","Fighter, Tank","Support, Fighter",2,0,2
3646,"Fighter, Tank","Mage, Support",Marksman,"Support, Fighter",2,0,2
3647,"Fighter, Assassin","Tank, Fighter","Assassin, Fighter","Support, Fighter",0,2,2
2440,"Assassin, Fighter","Support, Fighter","Fighter, Mage",Support,1,1,2
2445,"Fighter, Assassin",Support,"Fighter, Mage","Support, Tank",0,2,2
3649,"Fighter, Tank","Support, Fighter","Fighter, Assassin","Support, Tank",1,1,2
3651,Marksman,"Tank, Fighter","Fighter, Assassin","Mage, Support",1,1,2
1817,"Support, Mage","Support, Mage",Marksman,"Support, Mage",1,1,2
2446,"Tank, Fighter","Mage, Fighter",Fighter,"Fighter, Mage",1,1,2
2447,"Fighter, Tank","Mage, Marksman","Assassin, Fighter","Mage, Fighter",1,1,2
1830,Fighter,"Mage, Tank","Fighter, Mage","Assassin, Mage",0,2,2
2449,"Tank, Mage","Fighter, Mage","Fighter, Mage","Tank, Fighter",1,1,2
2458,"Tank, Mage",Fighter,"Fighter, Assassin","Tank, Fighter",1,1,2
1824,Fighter,"Support, Fighter","Fighter, Mage",Support,1,1,2
1823,"Mage, Fighter",Support,"Fighter, Mage","Support, Mage",0,2,2
2461,"Mage, Marksman","Fighter, Assassin","Fighter, Mage",Fighter,2,0,2
1774,"Fighter, Mage","Support, Tank",Fighter,Support,1,1,2
3352,"Mage, Fighter","Tank, Fighter","Assassin, Fighter","Tank, Support",1,1,2
2356,"Assassin, Fighter","Assassin, Fighter","Mage, Fighter","Mage, Marksman",0,2,2
2522,Marksman,"Tank, Fighter","Assassin, Fighter","Mage, Assassin",1,1,2
2517,"Tank, Mage","Mage, Fighter",Fighter,"Fighter, Mage",1,1,2
3342,Marksman,"Support, Fighter",Fighter,"Support, Mage",0,2,2
3341,Fighter,"Mage, Support","Fighter, Assassin","Tank, Support",1,1,2
3696,"Assassin, Fighter","Support, Fighter","Assassin, Fighter","Support, Tank",1,1,2
3338,"Tank, Fighter","Support, Tank","Mage, Fighter","Tank, Support",1,1,2
1755,"Mage, Fighter","Mage, Support","Fighter, Assassin","Assassin, Fighter",1,1,2
2519,"Marksman, Assassin",Marksman,Marksman,"Mage, Assassin",2,0,2
3336,"Fighter, Assassin","Tank, Fighter",Fighter,"Support, Fighter",1,1,2
3705,"Fighter, Assassin","Mage, Fighter",Marksman,"Support, Mage",1,1,2
2516,"Tank, Fighter","Support, Mage","Fighter, Tank","Mage, Support",1,1,2
3333,"Tank, Mage","Tank, Support","Fighter, Mage","Support, Mage",1,1,2
3332,"Tank, Fighter","Support, Tank","Tank, Fighter","Mage, Support",1,1,2
2523,"Tank, Mage","Tank, Support","Fighter, Mage","Support, Fighter",1,1,2
2531,"Mage, Tank",Fighter,"Tank, Mage","Fighter, Mage",1,1,2
2533,Fighter,"Support, Fighter","Fighter, Mage","Fighter, Tank",0,2,2
2534,"Tank, Mage","Tank, Fighter","Fighter, Mage","Fighter, Assassin",1,1,2
1753,"Marksman, Assassin","Support, Fighter","Marksman, Support","Mage, Assassin",2,0,2
1752,"Fighter, Tank","Tank, Fighter","Fighter, Marksman","Fighter, Assassin",0,2,2
1756,"Assassin, Fighter","Mage, Fighter","Mage, Fighter","Fighter, Marksman",2,0,2
3692,Marksman,"Support, Fighter","Assassin, Fighter","Support, Mage",1,1,2
3675,Marksman,"Support, Tank","Marksman, Fighter","Support, Mage",0,2,2
3346,"Mage, Fighter","Support, Mage","Assassin, Fighter","Tank, Fighter",1,1,2
2499,"Fighter, Marksman","Fighter, Mage","Mage, Marksman","Mage, Fighter",1,1,2
1771,"Fighter, Assassin","Fighter, Assassin","Tank, Mage","Tank, Fighter",1,1,2
2502,Marksman,"Mage, Support","Support, Mage","Support, Mage",0,2,2
3349,"Fighter, Assassin","Tank, Fighter","Tank, Fighter","Tank, Support",1,1,2
2503,"Tank, Mage",Fighter,Tank,"Mage, Fighter",2,0,2
1770,"Marksman, Support",Marksman,"Marksman, Mage","Mage, Assassin",1,1,2
1767,"Marksman, Assassin","Mage, Assassin","Marksman, Mage",Marksman,1,1,2
2505,"Fighter, Mage","Support, Tank","Assassin, Fighter",Support,2,0,2
1763,"Mage, Fighter","Assassin, Mage","Fighter, Assassin",Marksman,1,1,2
1757,"Marksman, Support",Marksman,Marksman,"Mage, Assassin",1,1,2
2506,"Support, Mage","Mage, Fighter",Fighter,"Fighter, Mage",0,2,2
1762,"Support, Mage","Mage, Fighter","Mage, Fighter","Assassin, Fighter",1,1,2
2515,"Fighter, Mage","Fighter, Tank",Tank,"Mage, Fighter",2,0,2
1760,"Marksman, Support",Marksman,"Marksman, Mage","Support, Fighter",0,2,2
1758,"Marksman, Assassin",Marksman,"Marksman, Mage","Mage, Assassin",1,1,2
3687,"Tank, Fighter","Support, Tank","Assassin, Fighter","Mage, Support",1,1,2
3343,Fighter,"Support, Mage",Marksman,"Fighter, Tank",1,1,2
3688,"Assassin, Fighter","Mage, Support","Fighter, Tank","Mage, Support",2,0,2
1833,"Mage, Fighter","Mage, Tank","Fighter, Mage","Assassin, Mage",1,1,2
3642,"Assassin, Fighter","Fighter, Tank","Fighter, Assassin","Support, Mage",2,0,2
1834,Fighter,Support,"Tank, Fighter","Support, Tank",0,2,2
3381,Marksman,"Mage, Support","Assassin, Mage",Mage,0,2,2
1913,"Assassin, Mage","Tank, Fighter","Fighter, Mage","Support, Fighter",1,1,2
1912,"Fighter, Mage",Mage,"Tank, Fighter","Support, Fighter",2,0,2
1908,"Tank, Fighter","Fighter, Mage","Tank, Fighter","Fighter, Mage",2,0,2
1904,Marksman,"Support, Fighter","Fighter, Assassin","Support, Mage",2,0,2
1899,"Fighter, Mage",Support,Fighter,"Support, Fighter",1,1,2
3596,Fighter,"Mage, Support",Marksman,Marksman,2,0,2
1896,"Mage, Fighter","Marksman, Mage",Fighter,"Support, Mage",1,1,2
1895,"Mage, Fighter","Mage, Support","Tank, Fighter","Assassin, Fighter",0,2,2
1887,"Marksman, Mage","Tank, Fighter","Marksman, Support","Support, Tank",1,1,2
3586,"Fighter, Assassin","Support, Tank","Assassin, Fighter","Mage, Support",1,1,2
2383,"Fighter, Assassin","Mage, Fighter",Mage,Fighter,1,1,2
2391,"Fighter, Mage","Mage, Support","Fighter, Assassin","Support, Tank",1,1,2
2393,"Tank, Mage",Fighter,"Fighter, Mage","Assassin, Mage",1,1,2
1882,Marksman,"Support, Fighter","Fighter, Assassin","Support, Tank",1,1,2
1878,"Fighter, Tank","Support, Fighter","Mage, Fighter","Mage, Support",0,2,2
2395,"Assassin, Fighter","Support, Fighter","Mage, Fighter","Support, Tank",0,2,2
3603,"Assassin, Fighter","Mage, Assassin","Mage, Fighter","Support, Mage",1,1,2
1876,"Fighter, Mage","Assassin, Fighter","Fighter, Mage","Mage, Fighter",1,1,2
2380,"Support, Tank",Fighter,"Support, Mage","Fighter, Tank",2,0,2
3585,Fighter,"Fighter, Tank","Fighter, Tank","Support, Tank",2,0,2
1836,Fighter,"Assassin, Mage","Assassin, Fighter","Assassin, Mage",0,2,2
1929,Marksman,Marksman,"Mage, Fighter","Support, Mage",0,2,2
1935,"Mage, Fighter","Tank, Support","Fighter, Assassin","Fighter, Tank",0,2,2
3571,"Fighter, Tank","Support, Tank","Assassin, Fighter","Tank, Support",2,0,2
1934,"Mage, Fighter","Tank, Support","Fighter, Tank","Mage, Support",1,1,2
3572,"Fighter, Mage","Support, Mage","Mage, Fighter","Fighter, Tank",1,1,2
3573,"Assassin, Fighter","Mage, Assassin","Mage, Fighter","Support, Tank",2,0,2
1930,"Assassin, Fighter","Mage, Marksman","Fighter, Assassin","Support, Tank",1,1,2
2359,"Assassin, Fighter",Support,"Fighter, Mage","Support, Fighter",2,0,2
3387,Marksman,"Tank, Support","Fighter, Assassin","Mage, Support",1,1,2
1923,"Tank, Mage","Fighter, Assassin",Tank,"Fighter, Mage",1,1,2
2379,"Mage, Fighter","Mage, Support","Fighter, Tank","Assassin, Fighter",1,1,2
1921,"Fighter, Tank",Mage,Fighter,"Support, Mage",1,1,2
1920,"Mage, Fighter",Marksman,Fighter,"Assassin, Fighter",0,2,2
2368,"Fighter, Tank","Mage, Support",Marksman,"Assassin, Fighter",0,2,2
2369,"Fighter, Mage","Support, Mage","Tank, Mage","Support, Mage",0,2,2
1918,"Mage, Fighter",Fighter,Mage,Marksman,0,2,2
3382,Marksman,"Mage, Support","Support, Mage",Mage,2,0,2
2374,"Marksman, Assassin","Tank, Support","Marksman, Mage","Mage, Assassin",0,2,2
1917,Marksman,"Support, Mage","Fighter, Mage","Mage, Marksman",1,1,2
1875,"Fighter, Tank","Fighter, Tank","Fighter, Tank","Support, Mage",1,1,2
1871,"Fighter, Tank",Marksman,"Assassin, Fighter",Fighter,1,1,2
2397,Fighter,Fighter,Tank,"Fighter, Tank",1,1,2
2431,"Fighter, Mage",Fighter,"Mage, Marksman","Fighter, Mage",2,0,2
3625,"Fighter, Mage","Tank, Support",Marksman,"Support, Mage",2,0,2
1859,"Tank, Fighter","Support, Tank","Tank, Mage","Fighter, Tank",2,0,2
3366,"Fighter, Mage","Support, Mage","Tank, Fighter",Support,2,0,2
2424,"Tank, Fighter","Fighter, Assassin","Tank, Mage","Fighter, Mage",1,1,2
2430,"Assassin, Fighter","Mage, Support","Fighter, Tank",Marksman,1,1,2
1854,"Tank, Mage","Support, Mage","Tank, Fighter","Support, Tank",2,0,2
3629,"Support, Mage","Mage, Assassin","Assassin, Fighter","Mage, Support",2,0,2
3362,"Tank, Fighter","Tank, Fighter","Fighter, Mage","Support, Fighter",1,1,2
2434,Mage,"Assassin, Fighter","Fighter, Tank",Fighter,1,1,2
1869,Marksman,"Support, Fighter","Fighter, Mage","Support, Mage",2,0,2
2435,"Tank, Fighter","Fighter, Mage",Marksman,"Mage, Fighter",2,0,2
3361,"Fighter, Assassin","Tank, Support","Fighter, Mage","Support, Fighter",0,2,2
2436,"Fighter, Marksman","Mage, Fighter","Fighter, Mage",Fighter,1,1,2
1852,"Mage, Fighter","Mage, Assassin","Fighter, Assassin","Assassin, Mage",2,0,2
2439,Fighter,"Support, Fighter","Mage, Fighter","Tank, Fighter",1,1,2
1840,"Fighter, Mage","Assassin, Mage","Mage, Fighter","Mage, Assassin",2,0,2
3639,"Fighter, Tank","Mage, Assassin",Fighter,"Mage, Support",1,1,2
3640,"Fighter, Tank","Fighter, Tank","Fighter, Mage","Support, Tank",0,2,2
3624,"Support, Mage",Marksman,"Fighter, Assassin","Mage, Support",1,1,2
3623,"Assassin, Fighter","Support, Fighter",Fighter,"Tank, Fighter",0,2,2
3367,"Tank, Fighter","Tank, Support",Fighter,Support,0,2,2
3622,Fighter,"Support, Fighter","Assassin, Fighter","Mage, Support",2,0,2
1867,"Fighter, Mage","Mage, Assassin",Fighter,Mage,2,0,2
2398,Fighter,"Tank, Support","Mage, Fighter","Tank, Fighter",2,0,2
2400,"Mage, Marksman","Fighter, Assassin","Fighter, Mage","Fighter, Tank",0,2,2
1866,Fighter,"Support, Fighter","Fighter, Assassin","Mage, Support",0,2,2
3375,"Fighter, Tank","Mage, Assassin","Fighter, Assassin","Support, Fighter",1,1,2
2404,"Assassin, Fighter",Mage,"Tank, Fighter","Tank, Support",2,0,2
3373,"Assassin, Fighter",Marksman,Marksman,"Mage, Fighter",2,0,2
1865,Fighter,"Assassin, Mage","Fighter, Mage","Assassin, Mage",0,2,2
2405,Fighter,Marksman,"Tank, Mage","Mage, Fighter",1,1,2
3371,Fighter,Support,"Assassin, Fighter","Support, Fighter",1,1,2
2406,"Fighter, Assassin","Mage, Support","Mage, Fighter","Fighter, Marksman",1,1,2
2409,"Tank, Mage","Fighter, Mage","Fighter, Assassin","Assassin, Fighter",1,1,2
2414,"Fighter, Assassin","Fighter, Mage",Tank,"Mage, Fighter",1,1,2
3614,Marksman,"Support, Mage",Fighter,"Support, Tank",2,0,2
1863,"Fighter, Mage","Mage, Marksman",Fighter,"Support, Mage",2,0,2
3619,"Fighter, Mage","Tank, Support",Marksman,"Support, Tank",2,0,2
3368,"Mage, Fighter","Support, Tank","Tank, Fighter",Support,1,1,2
1246,"Assassin, Fighter","Mage, Fighter",Marksman,"Mage, Marksman",2,0,2
1395,"Fighter, Mage","Mage, Fighter","Mage, Fighter",Mage,2,0,2
2179,"Marksman, Mage","Tank, Fighter","Marksman, Assassin","Support, Fighter",1,1,2
1234,"Tank, Fighter","Support, Mage","Tank, Fighter","Assassin, Fighter",2,0,2
4157,Fighter,"Mage, Support","Fighter, Assassin","Mage, Assassin",0,2,2
3969,"Tank, Fighter",Support,"Support, Mage","Support, Fighter",2,0,2
3972,"Fighter, Mage","Support, Tank","Support, Mage",Support,0,2,2
2964,"Fighter, Tank","Support, Tank","Mage, Fighter","Support, Fighter",2,0,2
4148,"Mage, Fighter","Mage, Support","Support, Mage","Mage, Support",0,2,2
4142,"Fighter, Tank","Support, Mage","Support, Mage","Mage, Support",0,2,2
4141,"Fighter, Mage","Support, Fighter","Fighter, Assassin","Support, Mage",2,0,2
3976,Fighter,"Fighter, Tank",Marksman,"Tank, Support",1,1,2
1068,Fighter,"Fighter, Tank","Fighter, Tank","Tank, Support",0,2,2
2963,"Fighter, Mage","Support, Mage","Assassin, Fighter","Support, Fighter",1,1,2
1222,"Mage, Fighter","Fighter, Tank","Fighter, Mage","Support, Mage",1,1,2
1219,"Fighter, Mage","Fighter, Tank",Fighter,"Tank, Support",2,0,2
4132,"Fighter, Tank","Support, Mage","Fighter, Assassin","Mage, Support",2,0,2
4123,"Mage, Fighter","Tank, Support","Assassin, Fighter","Tank, Fighter",1,1,2
3979,"Fighter, Tank","Support, Fighter","Assassin, Fighter","Support, Mage",2,0,2
1217,"Assassin, Fighter","Fighter, Tank",Fighter,"Support, Mage",1,1,2
3112,"Fighter, Mage","Mage, Marksman","Tank, Fighter","Mage, Support",1,1,2
1069,Fighter,Tank,"Fighter, Assassin","Tank, Support",2,0,2
1214,Marksman,"Mage, Fighter","Fighter, Assassin","Mage, Support",2,0,2
2938,"Tank, Mage","Support, Fighter",Fighter,"Tank, Fighter",1,1,2
1070,"Mage, Fighter",Marksman,"Tank, Fighter","Mage, Support",1,1,2
1209,Fighter,"Mage, Assassin","Fighter, Mage","Mage, Tank",0,2,2
3109,"Fighter, Tank","Support, Tank","Fighter, Mage","Support, Fighter",1,1,2
1076,"Tank, Mage",Marksman,"Assassin, Fighter","Fighter, Mage",1,1,2
2939,"Fighter, Mage","Tank, Fighter","Assassin, Fighter","Support, Mage",2,0,2
3108,"Fighter, Assassin","Tank, Support","Fighter, Assassin","Support, Mage",2,0,2
4110,Marksman,"Mage, Support","Assassin, Fighter","Fighter, Tank",2,0,2
1078,"Fighter, Assassin","Support, Fighter","Mage, Fighter","Mage, Support",2,0,2
1082,"Fighter, Assassin","Assassin, Mage",Marksman,"Assassin, Mage",0,2,2
3115,"Tank, Fighter","Fighter, Tank","Fighter, Mage","Tank, Support",0,2,2
4160,"Tank, Fighter","Mage, Support","Tank, Fighter","Support, Tank",2,0,2
4169,"Tank, Fighter","Tank, Support",Fighter,"Support, Tank",1,1,2
3132,"Mage, Fighter","Mage, Marksman","Fighter, Mage","Support, Fighter",1,1,2
3009,"Tank, Fighter","Mage, Assassin","Tank, Fighter",Mage,1,1,2
1232,"Tank, Fighter","Mage, Fighter","Tank, Mage","Fighter, Assassin",1,1,2
3010,"Tank, Fighter",Marksman,"Tank, Fighter","Tank, Mage",1,1,2
3011,"Mage, Fighter","Support, Fighter","Tank, Fighter",Support,0,2,2
1230,"Fighter, Tank","Fighter, Mage","Tank, Mage","Tank, Mage",0,2,2
3013,"Tank, Fighter","Tank, Mage","Fighter, Assassin",Marksman,1,1,2
3014,"Mage, Fighter","Support, Mage","Tank, Fighter","Tank, Support",0,2,2
3016,"Assassin, Fighter","Mage, Marksman","Tank, Fighter","Mage, Support",2,0,2
2975,"Fighter, Mage","Support, Mage",Fighter,"Fighter, Tank",1,1,2
4193,Fighter,"Support, Fighter","Fighter, Mage","Mage, Support",0,2,2
1060,Fighter,"Fighter, Mage",Tank,Fighter,0,2,2
4191,"Fighter, Mage",Mage,"Fighter, Tank","Support, Mage",1,1,2
1062,Marksman,"Support, Mage",Fighter,Marksman,2,0,2
1228,"Mage, Fighter","Tank, Support","Fighter, Tank","Support, Fighter",0,2,2
3032,"Support, Mage","Support, Mage","Assassin, Fighter","Support, Fighter",1,1,2
2936,"Tank, Fighter","Support, Mage",Fighter,"Mage, Support",1,1,2
3959,"Assassin, Fighter","Support, Fighter","Mage, Fighter","Mage, Assassin",2,0,2
3019,"Tank, Mage","Support, Mage","Tank, Fighter","Support, Mage",0,2,2
2972,"Fighter, Tank","Mage, Support",Fighter,"Tank, Support",2,0,2
3021,"Tank, Fighter","Mage, Marksman","Fighter, Mage","Support, Mage",1,1,2
2971,Fighter,"Fighter, Tank","Mage, Fighter","Support, Mage",2,0,2
3023,"Fighter, Assassin","Mage, Marksman","Assassin, Fighter","Mage, Tank",2,0,2
2970,Marksman,"Support, Fighter","Assassin, Fighter","Tank, Fighter",1,1,2
3126,"Tank, Fighter","Tank, Mage","Tank, Fighter","Mage, Marksman",0,2,2
1065,Marksman,"Support, Fighter","Mage, Fighter","Mage, Support",2,0,2
2969,"Fighter, Mage","Tank, Support","Assassin, Fighter","Tank, Fighter",2,0,2
1223,"Support, Mage","Mage, Support","Assassin, Fighter",Marksman,1,1,2
1067,Fighter,"Tank, Support","Mage, Fighter",Tank,0,2,2
1205,"Support, Mage","Mage, Fighter","Assassin, Fighter",Marksman,1,1,2
1088,"Assassin, Fighter","Tank, Support",Marksman,"Fighter, Tank",1,1,2
1201,"Mage, Fighter","Mage, Support",Fighter,"Assassin, Fighter",1,1,2
3082,"Tank, Fighter",Mage,"Tank, Fighter","Mage, Assassin",1,1,2
1167,"Fighter, Mage","Mage, Assassin",Marksman,Marksman,1,1,2
1129,Fighter,"Support, Tank","Assassin, Fighter","Fighter, Tank",0,2,2
4015,"Fighter, Mage","Mage, Support","Fighter, Assassin","Tank, Mage",1,1,2
4016,"Mage, Fighter","Support, Mage","Tank, Fighter","Mage, Support",0,2,2
4017,"Mage, Fighter","Tank, Mage","Support, Mage","Mage, Support",1,1,2
4019,"Fighter, Assassin","Mage, Support",Fighter,"Support, Fighter",1,1,2
1130,"Fighter, Mage","Fighter, Tank","Fighter, Tank","Support, Fighter",2,0,2
4022,"Mage, Fighter","Support, Fighter","Fighter, Tank","Support, Tank",2,0,2
1135,"Mage, Marksman","Mage, Fighter","Fighter, Marksman","Assassin, Fighter",2,0,2
1136,"Support, Mage","Fighter, Marksman","Assassin, Fighter","Mage, Fighter",2,0,2
3086,"Assassin, Fighter","Mage, Assassin","Support, Mage","Mage, Fighter",1,1,2
3085,"Fighter, Mage",Support,"Mage, Fighter","Support, Fighter",2,0,2
1139,"Fighter, Tank","Support, Mage","Fighter, Mage",Marksman,0,2,2
2947,"Fighter, Mage","Mage, Support","Fighter, Tank","Support, Mage",1,1,2
1121,"Tank, Fighter",Mage,"Fighter, Tank","Mage, Assassin",1,1,2
3069,"Mage, Fighter","Support, Mage","Fighter, Mage","Mage, Marksman",1,1,2
3081,Fighter,"Support, Mage","Mage, Fighter","Support, Fighter",2,0,2
3080,"Tank, Fighter","Mage, Fighter","Tank, Fighter","Mage, Assassin",2,0,2
1153,Fighter,Marksman,"Assassin, Fighter","Mage, Fighter",1,1,2
1151,"Tank, Fighter","Marksman, Mage","Fighter, Assassin","Mage, Assassin",2,0,2
1150,"Mage, Fighter","Mage, Assassin","Fighter, Assassin",Marksman,0,2,2
4059,"Tank, Mage","Support, Mage","Fighter, Mage","Tank, Fighter",1,1,2
3072,"Fighter, Assassin","Mage, Support",Fighter,"Support, Mage",2,0,2
1145,Marksman,"Mage, Marksman",Marksman,"Tank, Support",2,0,2
4046,"Tank, Fighter","Support, Mage","Tank, Mage","Support, Mage",0,2,2
4048,"Fighter, Tank","Support, Tank",Fighter,"Fighter, Tank",2,0,2
1143,Marksman,"Support, Tank","Fighter, Assassin","Support, Tank",1,1,2
4052,"Tank, Fighter","Support, Fighter","Fighter, Tank","Support, Fighter",2,0,2
4075,"Fighter, Mage","Mage, Support","Tank, Mage","Support, Mage",1,1,2
1108,"Assassin, Fighter","Mage, Assassin","Fighter, Tank","Support, Tank",2,0,2
3989,"Mage, Fighter","Tank, Fighter","Assassin, Fighter","Mage, Support",2,0,2
4090,"Fighter, Tank","Support, Fighter",Fighter,"Support, Tank",2,0,2
3990,"Fighter, Assassin",Support,"Mage, Fighter","Support, Tank",2,0,2
1198,Fighter,"Support, Mage","Marksman, Mage","Support, Mage",2,0,2
3993,Fighter,"Mage, Support","Tank, Fighter","Support, Tank",1,1,2
4103,"Fighter, Mage","Support, Tank","Tank, Fighter",Support,2,0,2
1089,Marksman,Mage,"Fighter, Assassin","Mage, Marksman",1,1,2
4102,Fighter,"Mage, Support","Tank, Fighter","Support, Mage",1,1,2
4100,Marksman,"Support, Mage","Tank, Fighter","Support, Fighter",0,2,2
1191,"Fighter, Marksman","Mage, Fighter",Tank,"Assassin, Fighter",2,0,2
2941,"Assassin, Fighter","Tank, Fighter",Fighter,Mage,1,1,2
1188,"Mage, Fighter","Fighter, Marksman",Marksman,"Mage, Assassin",1,1,2
4096,"Assassin, Fighter","Support, Mage","Fighter, Tank","Mage, Support",1,1,2
4093,"Fighter, Tank","Tank, Support",Fighter,"Support, Fighter",1,1,2
1185,"Fighter, Assassin","Mage, Assassin","Mage, Fighter","Support, Tank",1,1,2
3999,"Tank, Fighter","Support, Tank",Fighter,"Support, Tank",0,2,2
2952,"Tank, Fighter","Tank, Fighter","Assassin, Mage","Tank, Support",1,1,2
1090,"Assassin, Fighter","Support, Tank","Mage, Fighter","Fighter, Tank",1,1,2
4087,"Fighter, Assassin","Mage, Support","Assassin, Fighter","Tank, Support",1,1,2
1093,"Fighter, Tank","Mage, Support","Mage, Fighter","Mage, Assassin",0,2,2
2955,"Fighter, Tank","Mage, Support",Fighter,"Support, Fighter",1,1,2
1168,"Mage, Fighter","Marksman, Mage","Assassin, Fighter","Assassin, Fighter",0,2,2
4085,"Tank, Fighter","Support, Fighter","Mage, Fighter","Support, Fighter",1,1,2
3096,Fighter,"Tank, Support","Fighter, Assassin","Support, Mage",2,0,2
3094,"Mage, Fighter","Tank, Fighter","Fighter, Mage","Support, Mage",2,0,2
1100,"Support, Mage",Mage,"Fighter, Assassin","Assassin, Mage",1,1,2
1104,"Assassin, Fighter","Mage, Assassin","Assassin, Fighter",Mage,2,0,2
4080,"Assassin, Fighter","Support, Tank",Fighter,"Support, Tank",2,0,2
3064,"Assassin, Fighter","Mage, Fighter","Tank, Fighter","Mage, Assassin",2,0,2
1105,"Mage, Fighter","Tank, Fighter","Tank, Fighter","Tank, Support",1,1,2
1056,"Fighter, Assassin",Fighter,Tank,"Assassin, Fighter",1,1,2
3042,"Tank, Fighter","Mage, Support","Mage, Fighter","Support, Mage",2,0,2
1140,Fighter,"Assassin, Mage","Fighter, Mage","Mage, Marksman",1,1,2
2996,"Fighter, Assassin","Mage, Marksman","Assassin, Fighter","Mage, Fighter",0,2,2
2993,"Tank, Fighter","Support, Fighter",Fighter,Mage,0,2,2
3005,"Tank, Fighter",Marksman,"Assassin, Fighter","Mage, Assassin",1,1,2
2980,"Fighter, Tank","Mage, Support","Assassin, Fighter","Support, Tank",1,1,2
1238,"Fighter, Mage","Fighter, Tank","Mage, Fighter","Mage, Support",1,1,2
3007,"Fighter, Tank","Mage, Fighter","Tank, Fighter","Mage, Assassin",0,2,2
1048,"Fighter, Assassin","Mage, Support","Fighter, Mage","Mage, Assassin",2,0,2
3135,"Tank, Mage","Support, Mage","Tank, Fighter","Fighter, Tank",2,0,2
1237,Tank,Fighter,"Fighter, Assassin","Fighter, Assassin",2,0,2
3943,"Assassin, Mage","Support, Tank","Mage, Fighter","Tank, Support",0,2,2
2984,"Mage, Fighter","Mage, Support",Marksman,"Tank, Fighter",0,2,2
3136,"Fighter, Assassin",Support,"Tank, Fighter","Support, Fighter",1,1,2
1042,Marksman,"Mage, Assassin","Fighter, Assassin","Fighter, Marksman",1,1,2
3942,"Fighter, Tank",Support,"Fighter, Assassin","Support, Fighter",0,2,2
1243,"Assassin, Fighter","Marksman, Mage","Fighter, Mage",Mage,0,2,2
1043,"Fighter, Mage","Assassin, Fighter","Fighter, Tank","Fighter, Tank",2,0,2
2978,Fighter,"Support, Fighter",Marksman,"Mage, Support",1,1,2
3002,"Tank, Fighter","Support, Fighter","Assassin, Fighter","Mage, Support",0,2,2
2995,Fighter,Marksman,"Mage, Fighter","Mage, Assassin",1,1,2
2989,Fighter,"Tank, Fighter","Assassin, Fighter","Mage, Support",2,0,2
1242,"Mage, Marksman","Fighter, Mage","Fighter, Mage","Fighter, Assassin",2,0,2
4215,"Assassin, Fighter","Support, Fighter","Tank, Fighter",Mage,2,0,2
9108,"Assassin, Fighter","Marksman, Mage",Fighter,"Fighter, Mage",0,1,1
7996,Tank,Marksman,"Tank, Mage","Fighter, Tank",0,1,1
7771,Mage,"Fighter, Assassin","Assassin, Mage",Fighter,0,1,1
8007,"Tank, Fighter",Marksman,"Fighter, Assassin","Tank, Fighter",1,0,1
8006,Fighter,"Fighter, Mage","Tank, Fighter","Mage, Fighter",0,1,1
8008,"Fighter, Tank","Fighter, Mage","Support, Mage",Marksman,0,1,1
9110,"Fighter, Tank","Mage, Marksman","Fighter, Mage","Fighter, Marksman",0,1,1
8009,"Support, Mage",Marksman,"Fighter, Assassin","Mage, Fighter",1,0,1
7997,"Fighter, Tank","Fighter, Tank",Fighter,"Fighter, Mage",0,1,1
8005,"Support, Mage",Marksman,"Tank, Fighter","Mage, Fighter",0,1,1
7999,"Assassin, Fighter",Marksman,"Tank, Fighter",Fighter,1,0,1
7998,Tank,Fighter,"Tank, Fighter","Fighter, Mage",0,1,1
8884,Marksman,"Mage, Assassin","Assassin, Fighter","Mage, Tank",1,0,1
8000,Fighter,Marksman,"Assassin, Fighter","Fighter, Mage",0,1,1
7769,Mage,Fighter,"Tank, Mage","Tank, Fighter",1,0,1
8004,Tank,"Fighter, Tank","Tank, Mage",Marksman,0,1,1
7770,"Fighter, Mage","Assassin, Fighter","Assassin, Mage","Tank, Fighter",0,1,1
9111,"Assassin, Mage","Marksman, Mage","Assassin, Fighter","Marksman, Mage",0,1,1
8886,"Fighter, Assassin","Mage, Support","Support, Mage",Marksman,0,1,1
2958,"Fighter, Tank","Support, Mage","Fighter, Mage","Tank, Fighter",0,1,1
8002,Fighter,Fighter,"Assassin, Fighter","Fighter, Tank",1,0,1
8001,"Fighter, Mage","Fighter, Tank","Fighter, Tank","Assassin, Fighter",0,1,1
8010,"Fighter, Support",Fighter,"Tank, Fighter","Mage, Fighter",0,1,1
9114,Fighter,"Assassin, Fighter","Fighter, Assassin",Mage,1,0,1
8011,"Tank, Fighter","Assassin, Fighter","Tank, Fighter","Tank, Fighter",1,0,1
8874,"Assassin, Fighter","Mage, Tank","Fighter, Assassin","Mage, Fighter",1,0,1
2953,Marksman,"Support, Mage","Assassin, Mage","Tank, Support",0,1,1
8866,"Tank, Fighter","Tank, Mage","Tank, Fighter","Mage, Tank",0,1,1
2954,"Assassin, Fighter","Mage, Support","Tank, Fighter",Tank,1,0,1
8022,"Tank, Fighter",Fighter,"Mage, Marksman","Mage, Fighter",0,1,1
8868,"Fighter, Mage","Mage, Support","Fighter, Assassin","Assassin, Fighter",1,0,1
8869,"Fighter, Mage","Tank, Mage","Fighter, Assassin","Mage, Assassin",1,0,1
7765,Tank,"Tank, Fighter","Fighter, Marksman","Fighter, Mage",0,1,1
8021,"Tank, Mage",Marksman,"Mage, Marksman","Mage, Fighter",1,0,1
8020,"Tank, Mage","Fighter, Mage","Assassin, Fighter",Marksman,0,1,1
8871,"Assassin, Fighter","Mage, Support","Fighter, Mage","Tank, Mage",1,0,1
8872,"Assassin, Fighter","Tank, Mage","Mage, Fighter",Mage,0,1,1
8873,"Mage, Fighter","Assassin, Fighter","Fighter, Assassin","Mage, Tank",0,1,1
7766,"Fighter, Marksman","Fighter, Mage","Tank, Mage","Tank, Mage",1,0,1
8875,Marksman,"Support, Mage","Fighter, Mage","Assassin, Mage",1,0,1
7768,"Fighter, Tank","Fighter, Mage","Support, Mage","Assassin, Fighter",0,1,1
8876,"Assassin, Fighter","Mage, Fighter","Assassin, Fighter","Mage, Marksman",1,0,1
8019,"Fighter, Tank",Fighter,"Assassin, Fighter",Marksman,1,0,1
8877,"Fighter, Mage","Support, Mage","Mage, Fighter","Assassin, Fighter",1,0,1
8017,"Fighter, Tank","Fighter, Mage","Fighter, Assassin",Marksman,1,0,1
9115,"Fighter, Mage","Fighter, Assassin",Fighter,"Mage, Assassin",1,0,1
8016,"Fighter, Assassin",Marksman,"Tank, Mage","Fighter, Tank",1,0,1
8880,"Mage, Fighter","Assassin, Fighter",Marksman,"Mage, Tank",1,0,1
8015,Tank,"Fighter, Tank","Tank, Mage",Fighter,1,0,1
2956,"Support, Mage","Support, Tank","Fighter, Mage",Support,0,1,1
9107,"Assassin, Fighter","Mage, Fighter",Fighter,"Marksman, Mage",1,0,1
9113,Fighter,"Mage, Assassin","Fighter, Mage","Support, Mage",1,0,1
8013,Marksman,"Mage, Fighter","Tank, Fighter","Fighter, Mage",1,0,1
8012,"Fighter, Support","Fighter, Mage","Support, Mage","Assassin, Fighter",1,0,1
7772,"Tank, Mage","Tank, Fighter","Mage, Marksman","Fighter, Mage",1,0,1
7992,"Fighter, Tank","Fighter, Mage","Tank, Mage",Marksman,0,1,1
2959,"Assassin, Fighter",Tank,"Fighter, Assassin","Mage, Support",1,0,1
7971,"Fighter, Tank","Assassin, Mage","Mage, Fighter","Fighter, Mage",0,1,1
7968,"Tank, Fighter",Fighter,"Fighter, Mage","Assassin, Mage",0,1,1
7969,Tank,"Fighter, Mage","Mage, Tank",Fighter,0,1,1
8913,"Tank, Fighter",Mage,"Tank, Mage",Marksman,1,0,1
8912,"Tank, Mage",Mage,"Tank, Mage","Tank, Mage",1,0,1
2979,Marksman,"Mage, Support",Fighter,"Support, Fighter",1,0,1
7970,"Mage, Marksman","Assassin, Fighter","Assassin, Fighter","Fighter, Mage",0,1,1
7972,"Mage, Fighter","Fighter, Mage","Support, Mage","Assassin, Fighter",1,0,1
2983,"Fighter, Mage","Support, Tank","Assassin, Fighter","Mage, Assassin",0,1,1
7973,"Tank, Mage","Assassin, Fighter","Assassin, Fighter","Assassin, Mage",0,1,1
7974,"Support, Tank",Fighter,"Tank, Fighter","Mage, Fighter",1,0,1
9100,"Fighter, Mage","Marksman, Mage","Fighter, Tank","Fighter, Mage",1,0,1
8908,"Tank, Fighter",Mage,"Support, Mage",Marksman,1,0,1
7975,"Fighter, Mage","Fighter, Mage",Tank,"Assassin, Fighter",0,1,1
9101,"Assassin, Fighter","Marksman, Mage",Fighter,"Fighter, Marksman",0,1,1
7779,"Fighter, Mage","Tank, Fighter","Fighter, Marksman","Fighter, Mage",1,0,1
7780,"Tank, Fighter","Fighter, Mage","Fighter, Mage","Tank, Fighter",1,0,1
7967,"Fighter, Tank","Tank, Fighter","Mage, Tank",Fighter,1,0,1
8914,"Tank, Mage","Assassin, Mage","Tank, Mage",Marksman,1,0,1
9098,"Fighter, Mage","Marksman, Mage","Assassin, Fighter","Mage, Marksman",1,0,1
7966,"Mage, Tank","Tank, Fighter","Fighter, Tank",Fighter,0,1,1
9097,"Fighter, Mage","Marksman, Mage","Tank, Fighter","Mage, Assassin",1,0,1
8915,"Mage, Fighter","Mage, Fighter","Tank, Fighter",Marksman,0,1,1
7965,"Fighter, Mage","Assassin, Fighter","Tank, Mage","Assassin, Mage",0,1,1
7964,"Tank, Mage","Assassin, Mage",Tank,"Assassin, Fighter",0,1,1
7963,"Fighter, Tank","Mage, Fighter","Support, Tank","Fighter, Tank",1,0,1
7962,Mage,"Fighter, Tank","Tank, Fighter","Fighter, Tank",0,1,1
9096,"Fighter, Mage","Marksman, Mage","Assassin, Fighter","Fighter, Mage",1,0,1
8916,"Mage, Fighter","Tank, Mage","Tank, Fighter",Marksman,0,1,1
7961,"Support, Mage","Mage, Fighter","Fighter, Tank","Fighter, Tank",1,0,1
7960,"Support, Mage","Mage, Fighter","Fighter, Assassin","Fighter, Mage",0,1,1
7959,"Tank, Fighter","Fighter, Mage","Assassin, Fighter",Fighter,1,0,1
8906,"Tank, Mage",Mage,"Tank, Fighter","Mage, Support",0,1,1
8905,"Assassin, Fighter","Support, Mage","Mage, Fighter","Assassin, Mage",1,0,1
9102,"Fighter, Mage","Marksman, Mage",Fighter,"Marksman, Mage",1,0,1
7985,"Tank, Fighter","Fighter, Mage","Mage, Marksman",Fighter,1,0,1
8890,Marksman,"Mage, Marksman","Tank, Fighter","Mage, Assassin",0,1,1
7994,"Tank, Mage","Fighter, Assassin",Tank,Marksman,1,0,1
7993,"Tank, Mage","Fighter, Mage",Tank,Marksman,0,1,1
8025,"Mage, Fighter","Assassin, Mage","Fighter, Tank","Fighter, Assassin",1,0,1
7991,Tank,Marksman,"Fighter, Tank",Fighter,0,1,1
7990,"Fighter, Tank","Assassin, Fighter",Fighter,"Fighter, Assassin",1,0,1
8892,"Tank, Fighter","Fighter, Marksman","Assassin, Fighter",Marksman,1,0,1
7989,Tank,Fighter,"Tank, Mage","Mage, Fighter",1,0,1
7774,"Fighter, Tank","Fighter, Tank","Tank, Fighter","Fighter, Assassin",0,1,1
7988,"Fighter, Mage",Fighter,Fighter,"Assassin, Fighter",0,1,1
7987,"Fighter, Tank","Fighter, Mage","Assassin, Fighter","Fighter, Assassin",0,1,1
7986,"Fighter, Mage",Fighter,Fighter,"Fighter, Mage",1,0,1
8893,"Assassin, Fighter",Marksman,"Fighter, Mage","Mage, Support",1,0,1
7775,"Tank, Mage","Fighter, Mage","Tank, Mage",Fighter,1,0,1
7984,Tank,"Mage, Fighter","Tank, Mage","Fighter, Mage",0,1,1
9103,"Tank, Fighter","Mage, Assassin","Fighter, Mage","Marksman, Mage",0,1,1
7983,Tank,"Mage, Fighter","Tank, Mage","Tank, Fighter",0,1,1
7982,"Tank, Mage","Mage, Fighter",Tank,"Fighter, Assassin",0,1,1
8895,"Tank, Mage","Fighter, Marksman","Mage, Fighter",Mage,1,0,1
7981,Tank,"Assassin, Mage","Tank, Mage","Mage, Fighter",0,1,1
8897,"Tank, Fighter",Marksman,Marksman,Mage,1,0,1
7980,"Support, Mage","Assassin, Fighter","Support, Tank",Marksman,0,1,1
9105,Fighter,"Mage, Marksman","Fighter, Assassin","Mage, Support",1,0,1
7979,"Support, Tank",Marksman,"Tank, Fighter","Mage, Fighter",1,0,1
7978,"Tank, Fighter","Fighter, Tank",Mage,Marksman,1,0,1
7977,"Fighter, Assassin","Fighter, Mage","Support, Mage",Fighter,0,1,1
7777,"Tank, Mage",Fighter,"Tank, Mage","Fighter, Mage",0,1,1
2960,"Tank, Fighter","Support, Tank","Fighter, Mage",Tank,0,1,1
8901,"Tank, Fighter",Marksman,"Tank, Mage",Mage,0,1,1
8902,"Assassin, Fighter","Support, Mage","Mage, Fighter","Mage, Marksman",1,0,1
8865,"Tank, Fighter",Mage,"Support, Mage","Mage, Support",0,1,1
8029,"Assassin, Fighter","Assassin, Fighter","Fighter, Mage","Tank, Fighter",1,0,1
8026,"Fighter, Assassin","Fighter, Mage","Fighter, Mage","Assassin, Mage",1,0,1
8066,Tank,"Mage, Fighter","Fighter, Tank","Fighter, Assassin",1,0,1
8818,Marksman,"Mage, Assassin","Assassin, Fighter","Fighter, Marksman",0,1,1
7746,"Assassin, Fighter","Fighter, Mage","Assassin, Mage",Fighter,0,1,1
8071,"Mage, Fighter","Fighter, Mage","Fighter, Tank","Fighter, Assassin",0,1,1
8819,"Fighter, Mage","Fighter, Marksman","Assassin, Fighter","Mage, Support",0,1,1
8070,Tank,Fighter,"Tank, Mage","Fighter, Tank",0,1,1
8820,Fighter,"Fighter, Tank",Marksman,Marksman,1,0,1
8069,"Mage, Fighter","Fighter, Mage","Fighter, Tank","Assassin, Fighter",1,0,1
8821,"Assassin, Fighter","Mage, Fighter","Assassin, Fighter","Mage, Fighter",1,0,1
8822,Marksman,"Fighter, Marksman",Fighter,"Mage, Support",1,0,1
7747,Mage,Fighter,"Assassin, Fighter","Fighter, Mage",0,1,1
7748,"Assassin, Fighter",Fighter,Fighter,"Mage, Fighter",0,1,1
8068,"Tank, Mage","Assassin, Mage","Fighter, Tank","Fighter, Mage",0,1,1
8067,"Mage, Fighter","Fighter, Assassin","Fighter, Tank",Fighter,1,0,1
8823,"Assassin, Fighter","Mage, Fighter",Fighter,"Fighter, Marksman",0,1,1
8065,"Fighter, Tank","Mage, Fighter","Support, Mage","Fighter, Assassin",0,1,1
8072,"Fighter, Tank","Fighter, Assassin",Tank,"Assassin, Mage",1,0,1
8064,Tank,"Fighter, Assassin","Assassin, Fighter",Fighter,1,0,1
8063,"Assassin, Fighter","Mage, Fighter","Fighter, Assassin","Fighter, Assassin",1,0,1
8825,"Assassin, Fighter","Mage, Support","Fighter, Tank","Mage, Fighter",0,1,1
8826,"Assassin, Fighter","Fighter, Marksman","Assassin, Fighter","Mage, Assassin",1,0,1
9129,"Fighter, Mage","Support, Mage","Tank, Fighter","Fighter, Marksman",1,0,1
8062,"Tank, Fighter","Assassin, Mage","Tank, Mage","Assassin, Fighter",1,0,1
8827,Fighter,"Mage, Support","Support, Mage","Assassin, Fighter",1,0,1
9128,Fighter,"Fighter, Mage","Tank, Fighter",Mage,1,0,1
8828,"Assassin, Fighter","Mage, Support","Fighter, Mage","Fighter, Marksman",1,0,1
7749,"Fighter, Mage","Mage, Fighter",Fighter,Fighter,1,0,1
8830,"Support, Mage","Mage, Support","Fighter, Mage","Mage, Support",0,1,1
2948,"Support, Mage","Mage, Support","Fighter, Assassin","Support, Fighter",0,1,1
9127,Fighter,"Assassin, Fighter","Tank, Fighter",Mage,0,1,1
8831,Marksman,"Mage, Support","Support, Mage","Assassin, Fighter",1,0,1
7745,"Assassin, Fighter",Fighter,"Assassin, Mage","Assassin, Fighter",1,0,1
8816,"Mage, Fighter","Support, Mage",Fighter,Marksman,0,1,1
8027,"Mage, Fighter","Tank, Fighter","Fighter, Mage","Fighter, Mage",0,1,1
8803,"Mage, Fighter",Marksman,"Assassin, Fighter","Marksman, Mage",0,1,1
8795,Fighter,"Assassin, Fighter","Mage, Fighter","Assassin, Mage",1,0,1
8796,"Mage, Fighter",Mage,"Assassin, Fighter","Assassin, Mage",1,0,1
8086,Tank,Fighter,"Fighter, Tank","Assassin, Mage",1,0,1
2943,"Fighter, Tank","Support, Mage",Marksman,"Support, Fighter",1,0,1
7741,"Fighter, Marksman","Fighter, Tank","Tank, Mage","Fighter, Assassin",0,1,1
8084,"Mage, Fighter","Tank, Fighter","Fighter, Tank","Fighter, Tank",0,1,1
8083,"Tank, Mage","Fighter, Assassin","Fighter, Mage","Assassin, Mage",0,1,1
8798,"Mage, Fighter","Assassin, Fighter","Assassin, Fighter",Marksman,1,0,1
7742,"Tank, Fighter","Assassin, Fighter","Fighter, Marksman","Fighter, Assassin",1,0,1
8799,"Tank, Fighter",Fighter,Fighter,Marksman,0,1,1
8082,"Fighter, Mage","Assassin, Mage","Fighter, Assassin","Fighter, Mage",1,0,1
8801,Fighter,"Mage, Fighter","Mage, Fighter","Marksman, Mage",1,0,1
8081,"Tank, Mage","Fighter, Mage",Tank,"Assassin, Mage",1,0,1
8080,"Fighter, Assassin","Fighter, Assassin","Assassin, Fighter",Fighter,0,1,1
8079,"Assassin, Fighter","Fighter, Mage",Tank,"Mage, Fighter",0,1,1
7744,"Tank, Fighter","Fighter, Assassin","Fighter, Tank",Fighter,1,0,1
8078,"Tank, Fighter","Fighter, Mage",Tank,"Mage, Fighter",1,0,1
8805,Marksman,"Mage, Marksman","Assassin, Fighter","Marksman, Mage",0,1,1
8806,"Mage, Fighter","Mage, Fighter",Marksman,"Support, Mage",1,0,1
8807,"Assassin, Fighter","Support, Mage","Mage, Fighter","Marksman, Mage",0,1,1
8808,"Assassin, Mage","Mage, Support",Fighter,"Mage, Support",0,1,1
8809,"Fighter, Mage","Marksman, Fighter",Fighter,"Assassin, Mage",1,0,1
8077,"Tank, Mage","Assassin, Mage",Tank,"Mage, Fighter",0,1,1
2945,"Support, Mage","Mage, Support","Fighter, Assassin",Support,0,1,1
8810,"Mage, Fighter","Assassin, Mage","Assassin, Fighter","Support, Mage",1,0,1
8811,Fighter,"Assassin, Mage","Mage, Fighter","Fighter, Mage",0,1,1
8075,"Support, Mage",Fighter,"Support, Mage","Mage, Fighter",0,1,1
8813,Fighter,"Mage, Assassin","Fighter, Mage","Marksman, Fighter",0,1,1
8074,"Assassin, Fighter",Fighter,"Tank, Fighter","Mage, Fighter",0,1,1
8073,"Tank, Mage",Fighter,"Tank, Fighter","Assassin, Mage",0,1,1
8059,"Assassin, Mage",Fighter,"Fighter, Mage","Fighter, Mage",0,1,1
8832,"Assassin, Fighter",Mage,"Support, Mage","Assassin, Mage",1,0,1
7750,"Fighter, Assassin",Fighter,"Tank, Mage","Mage, Fighter",1,0,1
7762,"Mage, Marksman","Tank, Mage","Fighter, Mage","Fighter, Mage",0,1,1
8044,"Fighter, Tank","Assassin, Mage","Fighter, Tank",Fighter,1,0,1
8043,"Fighter, Mage","Assassin, Mage","Fighter, Tank","Fighter, Assassin",0,1,1
2985,"Fighter, Assassin","Tank, Fighter",Fighter,"Mage, Support",0,1,1
8042,"Mage, Tank","Fighter, Assassin","Tank, Mage","Assassin, Fighter",0,1,1
8041,"Mage, Fighter",Fighter,"Fighter, Mage","Fighter, Assassin",1,0,1
8040,"Fighter, Mage","Assassin, Mage","Fighter, Assassin","Fighter, Assassin",1,0,1
8848,"Fighter, Assassin","Fighter, Marksman","Assassin, Fighter","Mage, Fighter",1,0,1
8849,"Fighter, Tank","Mage, Assassin","Mage, Fighter","Mage, Fighter",1,0,1
8850,Marksman,Marksman,"Fighter, Tank","Mage, Support",0,1,1
7761,"Fighter, Mage","Fighter, Assassin","Fighter, Mage","Fighter, Tank",0,1,1
8039,"Tank, Mage",Fighter,"Mage, Support","Assassin, Fighter",1,0,1
8853,"Assassin, Fighter",Mage,"Support, Mage",Mage,0,1,1
8038,"Fighter, Mage",Fighter,"Mage, Fighter","Assassin, Mage",1,0,1
8037,"Mage, Fighter","Assassin, Mage","Fighter, Mage",Fighter,0,1,1
8036,"Fighter, Mage",Fighter,"Fighter, Assassin","Fighter, Mage",0,1,1
8834,"Fighter, Tank",Mage,"Support, Mage","Mage, Marksman",1,0,1
8035,Fighter,"Assassin, Mage","Tank, Mage","Fighter, Mage",0,1,1
8857,"Fighter, Assassin",Mage,"Mage, Fighter","Fighter, Marksman",1,0,1
7763,"Fighter, Tank","Fighter, Mage","Fighter, Tank","Fighter, Mage",1,0,1
7764,"Tank, Fighter","Fighter, Mage","Fighter, Mage","Mage, Fighter",1,0,1
8034,"Mage, Support",Fighter,"Fighter, Mage","Assassin, Fighter",1,0,1
8858,"Fighter, Assassin","Tank, Mage","Assassin, Fighter","Mage, Support",1,0,1
8033,"Tank, Mage",Fighter,"Mage, Fighter","Assassin, Fighter",1,0,1
8032,"Tank, Mage","Assassin, Fighter",Fighter,"Assassin, Mage",1,0,1
8031,"Fighter, Tank","Fighter, Mage","Fighter, Mage","Assassin, Mage",1,0,1
8030,"Tank, Mage","Assassin, Mage","Fighter, Mage","Fighter, Mage",0,1,1
7958,"Tank, Fighter","Fighter, Mage","Fighter, Tank","Fighter, Mage",1,0,1
8861,"Mage, Support",Marksman,"Fighter, Mage","Mage, Support",0,1,1
8028,"Assassin, Fighter",Fighter,"Fighter, Mage","Assassin, Mage",0,1,1
8863,"Fighter, Mage","Tank, Mage",Marksman,"Mage, Support",1,0,1
8844,"Fighter, Mage","Tank, Fighter","Mage, Fighter","Tank, Mage",1,0,1
7759,"Mage, Marksman","Fighter, Assassin","Fighter, Marksman",Fighter,0,1,1
9119,"Tank, Fighter","Marksman, Mage","Tank, Fighter","Assassin, Mage",1,0,1
9120,"Fighter, Assassin","Assassin, Mage","Fighter, Tank","Mage, Assassin",1,0,1
7751,"Tank, Mage","Assassin, Fighter",Fighter,"Support, Mage",1,0,1
7752,"Tank, Fighter","Fighter, Tank","Fighter, Marksman","Fighter, Assassin",1,0,1
7753,Tank,"Fighter, Tank","Fighter, Marksman",Fighter,0,1,1
7754,"Tank, Mage","Assassin, Fighter","Fighter, Marksman","Fighter, Tank",1,0,1
8058,"Mage, Marksman","Tank, Fighter","Fighter, Mage","Tank, Fighter",0,1,1
2949,"Mage, Fighter","Support, Fighter","Fighter, Assassin",Support,0,1,1
8056,Fighter,"Fighter, Assassin","Tank, Mage","Tank, Fighter",0,1,1
9125,"Tank, Fighter","Fighter, Mage","Assassin, Fighter","Assassin, Mage",1,0,1
7755,"Fighter, Marksman","Fighter, Assassin",Tank,Fighter,0,1,1
9123,"Fighter, Tank","Support, Mage","Fighter, Assassin","Mage, Assassin",0,1,1
8055,"Tank, Mage",Fighter,Mage,"Fighter, Assassin",1,0,1
8054,"Fighter, Assassin","Tank, Fighter","Fighter, Tank","Fighter, Tank",0,1,1
8053,"Support, Mage","Fighter, Assassin","Tank, Mage","Tank, Fighter",0,1,1
8052,"Tank, Mage","Tank, Fighter","Support, Mage","Tank, Fighter",1,0,1
9122,Fighter,Mage,"Fighter, Assassin","Assassin, Fighter",0,1,1
7756,Tank,"Assassin, Fighter","Tank, Mage","Fighter, Tank",1,0,1
8837,"Tank, Fighter","Assassin, Fighter",Marksman,Marksman,0,1,1
8838,"Mage, Fighter","Assassin, Fighter",Fighter,"Tank, Mage",1,0,1
2988,Marksman,"Mage, Support","Fighter, Assassin","Support, Fighter",1,0,1
8051,"Tank, Fighter","Tank, Fighter","Mage, Marksman",Fighter,0,1,1
2987,"Fighter, Mage","Mage, Support","Assassin, Mage","Tank, Support",0,1,1
8050,"Mage, Support","Fighter, Mage","Mage, Marksman","Tank, Fighter",0,1,1
8049,"Fighter, Mage","Tank, Fighter","Tank, Mage","Fighter, Assassin",1,0,1
8841,"Fighter, Mage","Support, Mage",Marksman,"Mage, Marksman",1,0,1
8842,"Fighter, Mage",Mage,"Mage, Fighter","Assassin, Mage",1,0,1
2950,"Tank, Fighter","Support, Tank","Assassin, Fighter","Tank, Mage",1,0,1
2951,"Assassin, Mage","Mage, Support","Mage, Fighter","Mage, Support",0,1,1
9121,"Tank, Fighter","Mage, Assassin","Fighter, Tank","Assassin, Mage",1,0,1
8046,"Tank, Mage","Fighter, Mage","Fighter, Mage","Assassin, Mage",0,1,1
7781,"Tank, Fighter","Tank, Fighter","Fighter, Assassin","Fighter, Assassin",0,1,1
7810,"Mage, Tank",Fighter,"Tank, Fighter","Fighter, Mage",1,0,1
7782,"Fighter, Marksman","Assassin, Fighter","Fighter, Mage",Fighter,0,1,1
9023,"Tank, Fighter","Mage, Tank","Fighter, Tank","Mage, Support",0,1,1
9027,Marksman,"Mage, Support","Fighter, Mage","Marksman, Mage",0,1,1
7862,"Fighter, Marksman","Assassin, Fighter","Fighter, Tank","Fighter, Mage",1,0,1
7863,Fighter,"Assassin, Fighter","Fighter, Tank","Fighter, Mage",1,0,1
7864,"Fighter, Tank","Fighter, Mage","Mage, Marksman","Assassin, Fighter",1,0,1
7865,Assassin,Fighter,"Fighter, Tank","Assassin, Fighter",1,0,1
7866,"Fighter, Mage","Assassin, Fighter","Fighter, Assassin","Mage, Fighter",1,0,1
9080,Fighter,"Marksman, Mage","Assassin, Fighter","Marksman, Mage",1,0,1
7800,"Fighter, Assassin",Fighter,"Tank, Mage","Assassin, Mage",1,0,1
2973,"Mage, Fighter","Mage, Support",Fighter,"Tank, Fighter",0,1,1
9081,"Tank, Fighter","Mage, Marksman",Fighter,"Marksman, Mage",1,0,1
7869,"Mage, Marksman",Fighter,"Fighter, Mage","Fighter, Assassin",0,1,1
7870,"Fighter, Marksman","Fighter, Mage","Fighter, Tank","Fighter, Assassin",1,0,1
9019,"Fighter, Mage","Mage, Marksman","Mage, Fighter","Mage, Tank",0,1,1
7871,"Fighter, Tank","Fighter, Mage","Fighter, Marksman","Mage, Fighter",0,1,1
9028,"Fighter, Tank","Mage, Marksman","Fighter, Mage","Mage, Support",1,0,1
7861,"Tank, Fighter","Fighter, Assassin","Fighter, Mage",Fighter,1,0,1
7860,"Tank, Fighter","Tank, Fighter","Fighter, Tank","Fighter, Marksman",1,0,1
7859,"Fighter, Marksman",Marksman,"Mage, Marksman","Assassin, Fighter",1,0,1
7858,"Mage, Marksman","Mage, Fighter","Fighter, Mage","Assassin, Fighter",1,0,1
7857,"Tank, Fighter","Assassin, Fighter",Fighter,Marksman,0,1,1
7856,"Assassin, Fighter",Marksman,"Tank, Fighter","Fighter, Assassin",0,1,1
7855,"Mage, Marksman",Marksman,"Fighter, Marksman","Mage, Fighter",0,1,1
7854,"Tank, Fighter",Marksman,Tank,"Fighter, Mage",1,0,1
7853,"Tank, Mage","Assassin, Fighter","Fighter, Mage","Mage, Fighter",1,0,1
9079,"Tank, Fighter",Mage,"Tank, Mage","Tank, Mage",1,0,1
7852,Fighter,"Assassin, Fighter","Tank, Mage","Fighter, Mage",1,0,1
7851,"Tank, Mage",Marksman,"Fighter, Mage","Mage, Fighter",1,0,1
9030,Fighter,"Support, Mage","Fighter, Tank","Mage, Fighter",1,0,1
7850,Tank,Fighter,"Mage, Marksman",Marksman,0,1,1
9032,"Assassin, Fighter","Support, Mage","Mage, Fighter","Mage, Fighter",1,0,1
7849,"Tank, Mage",Marksman,Fighter,"Assassin, Fighter",1,0,1
9017,"Fighter, Mage","Support, Mage","Fighter, Tank","Mage, Marksman",0,1,1
7872,"Tank, Fighter",Fighter,"Fighter, Marksman","Mage, Fighter",0,1,1
9016,"Assassin, Fighter","Mage, Tank","Mage, Fighter","Marksman, Mage",1,0,1
9005,"Tank, Fighter","Assassin, Mage",Fighter,"Mage, Support",0,1,1
7891,"Tank, Fighter","Tank, Fighter","Fighter, Mage","Assassin, Fighter",1,0,1
7890,"Fighter, Tank","Fighter, Mage","Mage, Marksman","Mage, Fighter",1,0,1
7889,"Fighter, Marksman","Fighter, Mage","Fighter, Mage","Tank, Fighter",0,1,1
7888,"Fighter, Marksman","Fighter, Assassin","Fighter, Mage","Assassin, Fighter",1,0,1
7887,"Tank, Fighter","Fighter, Mage","Fighter, Mage","Fighter, Assassin",0,1,1
7797,"Fighter, Assassin","Tank, Fighter","Assassin, Fighter","Assassin, Mage",0,1,1
8999,"Fighter, Tank","Mage, Support",Fighter,"Mage, Fighter",0,1,1
9000,"Assassin, Fighter","Mage, Fighter","Fighter, Tank","Mage, Support",1,0,1
9083,"Tank, Mage","Mage, Marksman",Fighter,"Mage, Assassin",0,1,1
7885,"Mage, Marksman","Support, Mage","Fighter, Mage","Fighter, Assassin",0,1,1
7884,"Mage, Marksman","Assassin, Fighter",Marksman,Marksman,0,1,1
7883,"Fighter, Tank","Fighter, Mage","Mage, Marksman",Marksman,1,0,1
7882,"Fighter, Tank","Fighter, Assassin",Tank,Marksman,0,1,1
9082,"Assassin, Mage","Marksman, Mage","Fighter, Mage","Mage, Marksman",0,1,1
7880,"Tank, Fighter","Fighter, Assassin","Fighter, Assassin",Marksman,1,0,1
7799,"Tank, Mage","Fighter, Mage","Mage, Tank",Fighter,0,1,1
9007,"Fighter, Mage","Mage, Tank","Assassin, Fighter",Mage,1,0,1
7879,Mage,"Assassin, Fighter","Mage, Marksman","Fighter, Mage",0,1,1
9008,"Fighter, Tank","Assassin, Mage","Mage, Fighter","Mage, Assassin",0,1,1
7878,"Fighter, Mage","Assassin, Fighter","Mage, Marksman","Assassin, Fighter",1,0,1
9009,"Assassin, Fighter","Support, Mage","Fighter, Tank","Mage, Fighter",1,0,1
9010,"Mage, Fighter","Mage, Fighter","Fighter, Tank","Mage, Support",0,1,1
7877,"Fighter, Marksman",Marksman,"Fighter, Mage","Assassin, Fighter",0,1,1
9011,"Fighter, Tank",Mage,"Mage, Fighter","Mage, Tank",1,0,1
7876,"Fighter, Mage","Mage, Fighter","Fighter, Tank","Fighter, Assassin",0,1,1
7798,"Fighter, Mage","Fighter, Mage","Tank, Mage","Fighter, Assassin",1,0,1
7874,"Fighter, Tank","Tank, Fighter",Marksman,"Fighter, Assassin",1,0,1
9014,"Mage, Fighter","Mage, Support",Marksman,"Mage, Marksman",1,0,1
7873,"Fighter, Mage","Assassin, Fighter","Tank, Fighter",Fighter,0,1,1
9015,"Assassin, Fighter","Mage, Marksman","Mage, Fighter","Support, Mage",1,0,1
7848,"Tank, Mage",Marksman,"Tank, Fighter","Fighter, Mage",1,0,1
7847,"Fighter, Assassin","Mage, Fighter","Mage, Marksman","Fighter, Mage",0,1,1
7957,"Support, Tank","Mage, Fighter","Fighter, Assassin","Fighter, Mage",1,0,1
9058,Fighter,"Assassin, Mage","Tank, Fighter","Support, Mage",1,0,1
9072,"Assassin, Fighter","Mage, Support",Support,"Assassin, Fighter",1,0,1
9073,"Fighter, Mage","Mage, Support","Tank, Fighter","Mage, Assassin",1,0,1
7823,"Fighter, Tank","Assassin, Mage","Fighter, Tank","Fighter, Mage",0,1,1
7824,"Fighter, Tank","Fighter, Mage","Mage, Tank","Tank, Fighter",0,1,1
7825,"Tank, Mage","Fighter, Assassin","Fighter, Assassin","Fighter, Assassin",0,1,1
7826,"Support, Mage","Assassin, Fighter","Fighter, Mage","Tank, Fighter",1,0,1
9057,"Fighter, Tank","Mage, Assassin","Fighter, Tank",Mage,1,0,1
9034,"Fighter, Mage","Fighter, Mage",Fighter,Mage,1,0,1
7827,"Fighter, Marksman","Mage, Fighter","Tank, Fighter","Fighter, Mage",1,0,1
9056,"Tank, Fighter","Assassin, Mage","Fighter, Tank","Assassin, Fighter",0,1,1
7805,"Tank, Mage","Fighter, Tank",Tank,Fighter,0,1,1
7828,Tank,"Assassin, Fighter","Mage, Tank","Assassin, Fighter",0,1,1
7829,"Fighter, Mage",Marksman,Tank,"Mage, Fighter",0,1,1
7830,Tank,Marksman,"Mage, Marksman","Mage, Fighter",0,1,1
7806,"Fighter, Mage","Fighter, Mage","Fighter, Assassin","Assassin, Fighter",1,0,1
7822,"Fighter, Tank","Tank, Fighter","Fighter, Tank","Assassin, Mage",1,0,1
7807,"Tank, Mage","Fighter, Mage","Assassin, Fighter","Assassin, Fighter",1,0,1
7821,"Tank, Mage","Tank, Fighter","Fighter, Assassin",Fighter,0,1,1
7820,"Tank, Mage","Assassin, Fighter","Support, Mage",Fighter,1,0,1
7819,"Fighter, Tank","Assassin, Fighter","Support, Mage",Fighter,1,0,1
7818,"Fighter, Assassin","Assassin, Fighter","Fighter, Mage","Tank, Fighter",1,0,1
7808,"Fighter, Mage",Fighter,Mage,"Fighter, Mage",1,0,1
7817,"Fighter, Assassin",Fighter,Mage,"Tank, Fighter",0,1,1
7816,"Fighter, Tank","Assassin, Fighter","Support, Mage","Fighter, Tank",0,1,1
9065,"Fighter, Assassin","Assassin, Mage","Mage, Fighter",Mage,0,1,1
7815,"Tank, Mage",Fighter,Mage,"Tank, Fighter",1,0,1
7814,"Fighter, Assassin","Fighter, Assassin","Tank, Mage",Fighter,1,0,1
7813,"Mage, Marksman",Fighter,"Fighter, Assassin","Assassin, Fighter",1,0,1
7809,Mage,"Assassin, Fighter","Fighter, Mage","Fighter, Mage",0,1,1
7812,Mage,"Fighter, Mage","Tank, Mage",Fighter,1,0,1
7811,"Mage, Support","Assassin, Fighter","Fighter, Mage",Fighter,0,1,1
9053,"Tank, Fighter","Mage, Assassin",Fighter,"Mage, Assassin",1,0,1
9052,"Tank, Fighter","Assassin, Mage",Fighter,"Assassin, Fighter",0,1,1
7831,Tank,Marksman,"Fighter, Mage","Mage, Fighter",1,0,1
9040,"Tank, Fighter","Support, Mage","Fighter, Assassin","Mage, Assassin",0,1,1
7846,"Mage, Marksman","Mage, Fighter","Fighter, Marksman",Marksman,1,0,1
9036,"Fighter, Assassin","Assassin, Mage","Fighter, Tank","Assassin, Fighter",0,1,1
7845,"Tank, Fighter",Marksman,"Mage, Marksman","Fighter, Assassin",0,1,1
9037,"Tank, Fighter","Mage, Assassin",Fighter,"Mage, Support",1,0,1
7844,"Fighter, Marksman","Mage, Fighter",Tank,"Fighter, Assassin",0,1,1
9077,"Fighter, Mage","Tank, Mage","Tank, Fighter","Mage, Assassin",0,1,1
7843,"Fighter, Assassin",Marksman,"Fighter, Tank","Fighter, Assassin",0,1,1
7801,Tank,Fighter,"Assassin, Fighter","Tank, Fighter",0,1,1
7842,"Fighter, Marksman","Assassin, Fighter","Fighter, Mage",Marksman,0,1,1
9039,"Tank, Fighter","Mage, Assassin","Assassin, Fighter","Mage, Assassin",0,1,1
7802,"Mage, Fighter","Fighter, Mage","Tank, Mage","Assassin, Fighter",1,0,1
7841,"Tank, Fighter",Marksman,"Fighter, Marksman","Support, Mage",0,1,1
2974,Fighter,"Tank, Fighter",Marksman,"Fighter, Tank",1,0,1
7839,"Fighter, Mage","Fighter, Tank","Fighter, Mage",Marksman,1,0,1
7838,Tank,"Fighter, Tank","Fighter, Mage","Mage, Fighter",0,1,1
9050,"Tank, Fighter","Assassin, Mage","Assassin, Fighter",Mage,1,0,1
9042,"Mage, Fighter",Mage,"Tank, Fighter","Mage, Assassin",0,1,1
7837,"Fighter, Mage","Fighter, Tank","Fighter, Tank","Fighter, Mage",0,1,1
9076,"Fighter, Tank",Marksman,"Tank, Fighter","Mage, Support",1,0,1
7836,"Fighter, Marksman","Fighter, Tank","Tank, Fighter","Fighter, Assassin",0,1,1
7803,"Fighter, Mage","Assassin, Fighter","Assassin, Fighter","Tank, Fighter",1,0,1
9074,"Tank, Fighter",Marksman,"Assassin, Fighter",Mage,1,0,1
9046,"Fighter, Assassin","Mage, Support","Tank, Fighter","Mage, Assassin",0,1,1
7834,"Mage, Marksman",Marksman,"Tank, Fighter","Fighter, Assassin",1,0,1
9047,"Assassin, Fighter","Mage, Assassin","Fighter, Assassin","Mage, Assassin",1,0,1
7804,"Support, Mage","Fighter, Mage",Tank,"Assassin, Fighter",1,0,1
9048,"Fighter, Assassin",Mage,Fighter,"Assassin, Mage",1,0,1
9049,Fighter,"Mage, Assassin","Tank, Fighter","Mage, Support",1,0,1
7833,"Tank, Fighter","Fighter, Tank","Mage, Marksman","Fighter, Assassin",1,0,1
2977,Marksman,"Fighter, Tank","Mage, Fighter",Tank,1,0,1
8995,"Assassin, Fighter","Mage, Marksman","Fighter, Mage",Mage,0,1,1
8994,Fighter,"Assassin, Fighter",Marksman,Mage,1,0,1
8993,"Fighter, Tank","Mage, Assassin","Fighter, Mage","Mage, Marksman",0,1,1
9092,"Fighter, Tank","Marksman, Mage","Assassin, Mage",Mage,1,0,1
7938,"Fighter, Assassin","Fighter, Assassin","Fighter, Tank","Assassin, Fighter",1,0,1
7939,"Fighter, Mage","Mage, Fighter","Mage, Marksman","Fighter, Mage",0,1,1
7940,"Tank, Fighter","Tank, Fighter","Fighter, Assassin","Assassin, Fighter",1,0,1
8944,"Mage, Fighter",Marksman,"Fighter, Mage","Marksman, Fighter",0,1,1
9091,"Assassin, Mage",Mage,"Tank, Fighter","Mage, Assassin",0,1,1
7941,"Tank, Fighter","Tank, Fighter",Tank,"Mage, Fighter",1,0,1
8943,"Tank, Fighter","Mage, Support",Marksman,Mage,0,1,1
7892,Tank,"Fighter, Assassin","Tank, Fighter","Fighter, Mage",0,1,1
8942,"Fighter, Mage",Marksman,Marksman,Mage,0,1,1
7942,"Fighter, Marksman","Tank, Fighter","Fighter, Tank","Tank, Fighter",0,1,1
8941,"Assassin, Fighter","Mage, Marksman","Fighter, Mage","Support, Mage",1,0,1
7789,"Tank, Fighter","Tank, Fighter","Fighter, Marksman","Fighter, Assassin",1,0,1
7944,"Tank, Fighter",Fighter,Tank,"Tank, Fighter",0,1,1
7945,Tank,"Fighter, Mage","Fighter, Marksman","Tank, Fighter",0,1,1
8947,Marksman,"Mage, Marksman","Tank, Mage","Marksman, Mage",1,0,1
7937,"Fighter, Tank","Fighter, Assassin","Tank, Fighter",Fighter,1,0,1
7790,"Fighter, Assassin","Assassin, Fighter","Tank, Mage","Mage, Fighter",0,1,1
7936,"Fighter, Marksman","Mage, Fighter","Fighter, Tank","Support, Mage",0,1,1
8950,"Fighter, Tank","Mage, Fighter","Mage, Fighter","Mage, Marksman",1,0,1
7935,"Fighter, Assassin","Mage, Fighter",Tank,"Tank, Fighter",0,1,1
7934,"Tank, Mage",Marksman,"Tank, Fighter","Tank, Fighter",0,1,1
7933,"Fighter, Assassin","Tank, Mage","Tank, Mage","Tank, Fighter",0,1,1
7932,"Fighter, Tank","Tank, Fighter",Tank,"Tank, Mage",0,1,1
7931,"Fighter, Mage","Tank, Mage","Fighter, Tank","Mage, Fighter",1,0,1
7930,"Fighter, Tank","Tank, Mage","Tank, Fighter",Marksman,1,0,1
7791,"Tank, Mage","Fighter, Assassin",Fighter,"Tank, Fighter",0,1,1
9089,"Tank, Fighter","Marksman, Mage",Fighter,Mage,1,0,1
7928,"Tank, Fighter","Mage, Fighter",Tank,"Tank, Mage",0,1,1
7927,"Tank, Fighter",Fighter,"Tank, Mage","Tank, Fighter",0,1,1
7792,"Fighter, Tank","Tank, Fighter","Support, Mage","Assassin, Fighter",0,1,1
7926,Tank,"Tank, Mage","Tank, Mage","Tank, Mage",1,0,1
8940,"Fighter, Mage","Support, Mage","Tank, Fighter","Marksman, Fighter",1,0,1
7946,"Tank, Mage","Fighter, Assassin","Fighter, Marksman",Fighter,1,0,1
7788,"Fighter, Assassin","Tank, Fighter","Fighter, Mage","Tank, Mage",1,0,1
8929,"Fighter, Mage","Mage, Assassin","Assassin, Fighter",Marksman,1,0,1
7783,"Tank, Mage","Mage, Fighter","Tank, Mage",Fighter,0,1,1
8919,"Fighter, Mage",Marksman,Fighter,"Mage, Tank",1,0,1
9069,"Mage, Fighter",Mage,"Fighter, Tank","Assassin, Mage",0,1,1
7784,"Tank, Mage","Fighter, Mage","Tank, Mage","Mage, Fighter",1,0,1
8920,"Fighter, Mage","Tank, Mage",Fighter,Marksman,1,0,1
8921,"Mage, Fighter","Assassin, Mage","Support, Mage",Mage,0,1,1
7785,"Fighter, Tank","Fighter, Mage","Fighter, Marksman",Fighter,1,0,1
8923,"Tank, Mage","Mage, Support",Fighter,Marksman,1,0,1
7955,"Fighter, Tank","Fighter, Tank",Tank,"Fighter, Mage",0,1,1
7954,"Support, Tank","Mage, Fighter","Fighter, Assassin","Assassin, Fighter",1,0,1
7953,"Tank, Mage","Fighter, Assassin","Support, Tank","Mage, Fighter",1,0,1
8926,Fighter,"Mage, Support","Mage, Fighter","Mage, Marksman",0,1,1
8927,"Mage, Fighter","Fighter, Marksman","Tank, Mage",Marksman,0,1,1
8928,"Tank, Mage","Mage, Support","Fighter, Mage","Mage, Assassin",0,1,1
7952,"Support, Tank",Marksman,"Fighter, Assassin","Fighter, Assassin",1,0,1
8939,"Mage, Fighter",Marksman,"Assassin, Fighter","Mage, Marksman",1,0,1
8930,"Tank, Fighter","Tank, Mage","Tank, Mage",Marksman,1,0,1
7951,"Fighter, Assassin",Marksman,"Fighter, Assassin","Assassin, Fighter",0,1,1
8931,"Tank, Mage",Marksman,Marksman,"Mage, Support",1,0,1
8932,"Tank, Mage","Assassin, Mage","Mage, Fighter","Fighter, Marksman",1,0,1
2961,"Assassin, Mage","Support, Fighter","Fighter, Mage","Support, Mage",0,1,1
8934,"Tank, Fighter",Marksman,"Mage, Fighter","Assassin, Mage",1,0,1
7949,"Marksman, Fighter",Fighter,Mage,"Mage, Fighter",1,0,1
8936,Marksman,"Mage, Support","Fighter, Mage","Mage, Marksman",0,1,1
7786,"Fighter, Marksman",Fighter,"Tank, Fighter","Tank, Mage",0,1,1
7948,"Fighter, Assassin","Mage, Fighter",Mage,"Fighter, Tank",1,0,1
8937,Marksman,"Assassin, Mage","Fighter, Mage","Mage, Marksman",0,1,1
7787,"Fighter, Mage","Tank, Fighter","Tank, Mage","Tank, Mage",1,0,1
2962,"Fighter, Tank","Tank, Support","Assassin, Mage","Support, Fighter",1,0,1
8938,"Tank, Mage",Marksman,Fighter,"Mage, Marksman",1,0,1
8087,"Fighter, Mage",Fighter,"Fighter, Tank","Assassin, Mage",0,1,1
8955,Fighter,"Mage, Marksman","Mage, Fighter","Mage, Tank",0,1,1
7925,"Fighter, Assassin","Tank, Fighter","Fighter, Marksman","Tank, Mage",1,0,1
7899,"Fighter, Marksman","Tank, Fighter","Tank, Fighter","Support, Mage",0,1,1
7906,"Tank, Fighter","Assassin, Fighter","Mage, Marksman","Fighter, Assassin",1,0,1
7905,"Mage, Marksman","Assassin, Fighter","Fighter, Marksman","Tank, Fighter",0,1,1
7904,"Fighter, Marksman","Fighter, Mage","Mage, Marksman","Fighter, Assassin",1,0,1
8976,"Fighter, Mage","Support, Mage","Fighter, Mage","Mage, Assassin",1,0,1
7903,"Tank, Fighter","Assassin, Fighter","Mage, Marksman","Fighter, Mage",1,0,1
8977,"Fighter, Mage",Marksman,"Assassin, Fighter","Mage, Assassin",1,0,1
7902,"Assassin, Fighter",Marksman,"Fighter, Mage","Fighter, Assassin",0,1,1
8979,"Assassin, Fighter","Support, Mage",Fighter,Marksman,0,1,1
8980,"Fighter, Mage","Support, Mage",Marksman,Marksman,1,0,1
8981,Fighter,Marksman,"Fighter, Mage","Fighter, Assassin",1,0,1
8982,"Fighter, Tank","Support, Mage","Mage, Fighter",Marksman,1,0,1
7901,Tank,"Mage, Support","Tank, Fighter","Fighter, Mage",0,1,1
8984,Fighter,"Mage, Marksman","Assassin, Fighter","Marksman, Mage",1,0,1
7900,"Fighter, Mage","Fighter, Assassin","Assassin, Fighter","Mage, Fighter",0,1,1
7898,"Fighter, Mage",Marksman,"Fighter, Mage","Assassin, Fighter",0,1,1
7907,"Fighter, Mage","Fighter, Assassin","Tank, Fighter","Fighter, Mage",1,0,1
8985,Fighter,"Mage, Support","Fighter, Mage","Marksman, Mage",0,1,1
7794,"Assassin, Fighter",Fighter,"Fighter, Mage","Assassin, Fighter",0,1,1
7897,"Marksman, Mage","Assassin, Fighter","Fighter, Tank","Fighter, Mage",0,1,1
8986,"Mage, Fighter","Mage, Support",Marksman,"Mage, Tank",0,1,1
8988,"Assassin, Fighter","Mage, Marksman","Fighter, Tank",Mage,1,0,1
7896,"Mage, Tank","Fighter, Mage",Tank,"Fighter, Assassin",1,0,1
7895,"Tank, Fighter","Tank, Fighter","Mage, Marksman","Mage, Fighter",0,1,1
8989,"Fighter, Mage","Mage, Marksman","Mage, Fighter","Assassin, Fighter",1,0,1
7796,"Mage, Tank","Assassin, Mage","Tank, Mage","Fighter, Mage",0,1,1
7894,"Fighter, Tank",Marksman,"Fighter, Mage","Fighter, Tank",0,1,1
8990,"Tank, Fighter","Assassin, Mage","Fighter, Tank","Tank, Support",0,1,1
8991,"Tank, Mage","Marksman, Assassin","Tank, Fighter","Mage, Support",1,0,1
7893,"Tank, Fighter",Marksman,Mage,"Fighter, Mage",0,1,1
8992,"Fighter, Assassin","Mage, Assassin","Mage, Fighter","Mage, Tank",0,1,1
9085,"Fighter, Mage","Mage, Fighter",Fighter,"Assassin, Fighter",1,0,1
9086,"Assassin, Fighter","Mage, Marksman","Fighter, Tank","Mage, Assassin",1,0,1
8956,"Tank, Fighter","Mage, Marksman",Fighter,"Assassin, Fighter",0,1,1
7915,"Tank, Mage",Marksman,"Fighter, Tank","Fighter, Tank",1,0,1
2965,"Assassin, Fighter","Support, Mage",Fighter,"Tank, Support",0,1,1
7923,"Fighter, Tank","Assassin, Fighter","Mage, Marksman",Fighter,1,0,1
7922,"Fighter, Tank","Mage, Fighter","Fighter, Assassin","Support, Mage",0,1,1
7921,"Tank, Fighter","Assassin, Fighter","Fighter, Assassin","Support, Mage",1,0,1
8959,"Mage, Fighter","Assassin, Mage",Marksman,"Mage, Assassin",0,1,1
8960,"Mage, Fighter","Mage, Assassin",Fighter,"Fighter, Assassin",0,1,1
7920,Tank,"Assassin, Fighter","Mage, Marksman","Fighter, Assassin",0,1,1
8962,Fighter,Mage,"Mage, Fighter",Marksman,1,0,1
8963,"Mage, Fighter","Mage, Assassin",Fighter,Fighter,1,0,1
7919,"Assassin, Fighter","Fighter, Mage","Tank, Mage","Fighter, Tank",1,0,1
7793,"Fighter, Mage","Fighter, Mage","Tank, Mage","Assassin, Fighter",0,1,1
7918,"Assassin, Fighter","Mage, Fighter",Tank,"Fighter, Mage",1,0,1
7917,"Assassin, Fighter","Mage, Fighter",Fighter,Fighter,1,0,1
7916,"Mage, Marksman","Fighter, Assassin","Fighter, Tank","Assassin, Fighter",0,1,1
7914,"Fighter, Mage",Marksman,"Fighter, Mage","Mage, Fighter",1,0,1
7908,"Mage, Tank","Tank, Fighter","Fighter, Tank","Mage, Fighter",0,1,1
2968,Fighter,"Tank, Fighter","Fighter, Assassin","Support, Fighter",1,0,1
8965,Marksman,"Assassin, Mage",Marksman,Mage,1,0,1
8966,"Tank, Fighter","Mage, Assassin","Fighter, Tank",Marksman,0,1,1
8967,Fighter,Mage,Marksman,Marksman,0,1,1
7912,"Fighter, Tank","Fighter, Assassin","Fighter, Mage","Mage, Fighter",1,0,1
7911,"Tank, Fighter","Mage, Fighter",Tank,"Support, Mage",0,1,1
8968,"Fighter, Assassin",Marksman,Fighter,"Mage, Assassin",0,1,1
7910,"Mage, Tank","Mage, Fighter","Fighter, Mage","Tank, Fighter",0,1,1
7909,"Tank, Fighter","Mage, Fighter","Fighter, Mage","Support, Mage",1,0,1
8969,"Mage, Fighter","Mage, Assassin","Fighter, Mage",Marksman,1,0,1
8970,"Fighter, Mage","Mage, Support",Marksman,"Mage, Assassin",0,1,1
8971,Fighter,"Assassin, Mage",Marksman,Mage,0,1,1
8972,"Fighter, Mage","Support, Mage","Mage, Fighter",Marksman,0,1,1
9087,Fighter,"Mage, Marksman","Tank, Fighter","Mage, Assassin",1,0,1
7956,"Tank, Fighter","Fighter, Tank","Support, Tank","Fighter, Mage",0,1,1
8309,"Assassin, Fighter","Mage, Fighter","Tank, Mage","Assassin, Fighter",1,0,1
8794,"Assassin, Fighter","Assassin, Mage","Fighter, Tank","Support, Mage",1,0,1
8466,"Mage, Fighter","Mage, Support",Marksman,"Fighter, Marksman",1,0,1
8471,"Support, Mage","Mage, Support","Mage, Fighter","Mage, Support",1,0,1
8470,"Assassin, Fighter","Assassin, Mage","Support, Mage","Mage, Tank",0,1,1
8241,"Mage, Marksman","Fighter, Tank","Tank, Mage",Fighter,1,0,1
8242,"Fighter, Marksman",Fighter,"Tank, Fighter","Fighter, Tank",1,0,1
8469,Marksman,"Assassin, Mage","Assassin, Fighter","Mage, Assassin",0,1,1
2857,"Fighter, Tank","Support, Mage","Tank, Fighter","Tank, Support",1,0,1
8467,"Support, Mage",Mage,Marksman,"Mage, Fighter",0,1,1
8243,"Fighter, Mage",Marksman,Tank,"Fighter, Tank",0,1,1
2861,"Fighter, Mage","Support, Tank","Assassin, Fighter","Mage, Support",0,1,1
2859,"Mage, Fighter","Support, Fighter","Tank, Fighter",Mage,0,1,1
8244,Tank,"Mage, Fighter","Tank, Mage","Mage, Fighter",0,1,1
8245,Fighter,"Fighter, Assassin","Tank, Fighter",Marksman,1,0,1
8464,"Mage, Fighter",Mage,"Tank, Fighter","Fighter, Marksman",0,1,1
8246,Mage,"Mage, Fighter","Tank, Fighter",Marksman,1,0,1
8247,"Fighter, Assassin",Marksman,Fighter,"Assassin, Fighter",1,0,1
8248,"Fighter, Assassin",Fighter,Mage,"Assassin, Fighter",0,1,1
8472,Marksman,"Mage, Assassin","Assassin, Mage","Mage, Support",0,1,1
8473,Marksman,"Assassin, Mage","Assassin, Fighter","Mage, Fighter",1,0,1
8240,"Tank, Mage",Marksman,"Mage, Marksman",Fighter,1,0,1
2855,"Assassin, Fighter","Support, Mage","Tank, Fighter","Tank, Support",1,0,1
2850,Fighter,"Support, Fighter","Fighter, Assassin","Tank, Fighter",1,0,1
8238,"Fighter, Tank","Assassin, Fighter","Mage, Marksman","Mage, Fighter",0,1,1
8486,"Fighter, Assassin","Mage, Fighter",Marksman,Marksman,0,1,1
2851,"Mage, Fighter","Support, Mage","Fighter, Tank",Tank,0,1,1
8484,Marksman,Marksman,"Support, Mage",Mage,1,0,1
8483,"Assassin, Fighter","Assassin, Mage","Support, Mage",Marksman,0,1,1
8239,"Fighter, Marksman","Assassin, Fighter","Assassin, Fighter",Fighter,1,0,1
8482,"Support, Mage",Marksman,Marksman,"Assassin, Mage",1,0,1
2854,"Fighter, Mage","Tank, Fighter",Fighter,"Mage, Support",1,0,1
8480,"Support, Mage","Mage, Fighter","Fighter, Assassin","Mage, Support",1,0,1
8479,"Tank, Fighter","Tank, Mage","Fighter, Tank","Mage, Support",0,1,1
8478,"Support, Mage","Mage, Tank",Marksman,"Assassin, Mage",0,1,1
8477,"Mage, Fighter","Mage, Assassin","Fighter, Assassin","Assassin, Fighter",1,0,1
8476,"Assassin, Fighter","Mage, Support","Mage, Fighter","Mage, Tank",1,0,1
8475,"Fighter, Assassin","Mage, Assassin",Marksman,"Mage, Fighter",1,0,1
8249,"Mage, Marksman","Assassin, Fighter","Tank, Fighter","Assassin, Fighter",1,0,1
2862,"Fighter, Tank","Tank, Fighter","Fighter, Assassin","Support, Mage",0,1,1
2849,"Fighter, Tank","Support, Tank","Mage, Fighter","Support, Tank",1,0,1
2873,"Tank, Fighter","Tank, Fighter","Assassin, Fighter","Support, Mage",0,1,1
8447,Marksman,"Marksman, Mage","Mage, Fighter","Mage, Marksman",0,1,1
8446,Marksman,Mage,Marksman,"Assassin, Fighter",1,0,1
8445,"Tank, Fighter",Mage,Marksman,"Mage, Support",0,1,1
8444,"Assassin, Fighter",Mage,"Fighter, Assassin","Mage, Marksman",0,1,1
8443,"Tank, Fighter",Fighter,Marksman,Mage,0,1,1
8442,Fighter,"Mage, Fighter",Marksman,"Mage, Marksman",0,1,1
2870,"Fighter, Tank","Support, Tank","Fighter, Tank","Support, Fighter",1,0,1
8261,"Tank, Fighter","Assassin, Fighter",Mage,Marksman,0,1,1
8251,"Fighter, Assassin","Mage, Fighter","Marksman, Fighter","Fighter, Assassin",0,1,1
8262,"Marksman, Fighter","Assassin, Fighter",Marksman,"Mage, Fighter",1,0,1
8439,"Assassin, Fighter","Marksman, Mage",Marksman,"Mage, Marksman",1,0,1
8438,"Mage, Fighter","Mage, Fighter",Fighter,"Mage, Marksman",1,0,1
8437,"Assassin, Fighter","Assassin, Fighter",Marksman,"Mage, Marksman",1,0,1
8263,"Mage, Support","Fighter, Mage","Tank, Fighter","Mage, Fighter",0,1,1
8436,"Assassin, Mage","Mage, Fighter","Fighter, Mage","Assassin, Fighter",0,1,1
8435,"Mage, Fighter","Assassin, Mage","Assassin, Fighter",Marksman,0,1,1
8448,"Fighter, Mage",Mage,"Assassin, Fighter",Fighter,0,1,1
8260,"Marksman, Fighter",Marksman,Fighter,"Fighter, Assassin",0,1,1
8450,"Assassin, Fighter",Mage,Marksman,"Assassin, Mage",0,1,1
8259,Fighter,Marksman,"Marksman, Fighter","Mage, Fighter",0,1,1
8252,"Support, Tank","Assassin, Fighter","Mage, Fighter",Fighter,0,1,1
8253,"Mage, Support",Fighter,Mage,Marksman,0,1,1
8254,"Support, Mage",Fighter,Mage,Marksman,0,1,1
8460,"Assassin, Fighter","Fighter, Marksman",Marksman,"Mage, Assassin",0,1,1
8255,Fighter,Fighter,"Tank, Fighter",Marksman,1,0,1
8458,Marksman,"Assassin, Fighter","Assassin, Fighter","Mage, Fighter",1,0,1
8256,Mage,Fighter,"Marksman, Fighter","Mage, Fighter",0,1,1
8457,"Assassin, Fighter","Fighter, Assassin",Marksman,"Fighter, Mage",1,0,1
8456,"Assassin, Fighter",Mage,"Mage, Support","Fighter, Tank",1,0,1
8455,"Fighter, Tank","Fighter, Assassin","Fighter, Assassin","Assassin, Fighter",0,1,1
8257,"Support, Mage",Marksman,"Fighter, Tank","Assassin, Fighter",0,1,1
2864,"Fighter, Tank","Fighter, Tank","Mage, Fighter","Mage, Support",1,0,1
8453,"Fighter, Mage","Marksman, Mage",Marksman,"Mage, Marksman",1,0,1
8258,Mage,"Mage, Fighter","Fighter, Assassin","Assassin, Fighter",0,1,1
2865,"Fighter, Tank","Support, Tank","Mage, Fighter","Mage, Support",1,0,1
8237,"Fighter, Tank","Mage, Fighter","Mage, Marksman","Assassin, Fighter",1,0,1
2848,"Tank, Fighter","Tank, Support","Tank, Fighter",Mage,0,1,1
8088,"Fighter, Tank","Assassin, Mage","Fighter, Mage","Assassin, Fighter",1,0,1
8219,"Tank, Mage",Marksman,"Fighter, Marksman","Mage, Fighter",1,0,1
8528,"Fighter, Mage","Mage, Support","Tank, Mage","Assassin, Mage",1,0,1
8527,"Mage, Fighter","Mage, Support","Tank, Fighter","Fighter, Marksman",1,0,1
8216,"Tank, Mage","Assassin, Fighter","Mage, Marksman","Mage, Fighter",1,0,1
8217,"Mage, Marksman","Mage, Fighter","Tank, Fighter","Assassin, Fighter",0,1,1
9132,"Tank, Fighter","Mage, Assassin","Tank, Mage","Fighter, Mage",0,1,1
8526,"Tank, Fighter","Assassin, Mage",Fighter,"Tank, Mage",0,1,1
8218,"Mage, Marksman","Mage, Fighter","Fighter, Mage",Marksman,1,0,1
2826,"Tank, Fighter",Tank,"Mage, Fighter","Support, Tank",0,1,1
8517,"Assassin, Fighter","Tank, Mage","Fighter, Mage","Mage, Support",0,1,1
8523,"Fighter, Assassin",Marksman,"Tank, Fighter","Fighter, Marksman",0,1,1
8522,Fighter,"Marksman, Fighter","Assassin, Fighter","Assassin, Fighter",1,0,1
8220,"Fighter, Marksman","Mage, Fighter","Tank, Mage","Assassin, Fighter",0,1,1
8521,"Assassin, Fighter","Tank, Mage","Fighter, Tank","Support, Mage",0,1,1
8221,"Mage, Marksman",Marksman,"Tank, Mage","Assassin, Fighter",0,1,1
2828,"Fighter, Assassin","Tank, Support","Tank, Fighter","Mage, Support",0,1,1
8519,"Mage, Fighter","Fighter, Marksman","Tank, Fighter",Marksman,1,0,1
2823,"Tank, Mage","Support, Mage","Fighter, Mage","Tank, Support",0,1,1
8215,Tank,"Assassin, Fighter","Tank, Mage","Fighter, Assassin",0,1,1
2822,"Fighter, Tank","Tank, Support","Tank, Fighter","Support, Tank",1,0,1
8531,"Tank, Mage","Mage, Support","Tank, Fighter","Fighter, Marksman",1,0,1
8209,"Fighter, Tank","Fighter, Tank","Tank, Fighter","Assassin, Fighter",0,1,1
8210,Fighter,"Fighter, Assassin","Tank, Mage","Assassin, Fighter",1,0,1
8542,"Tank, Fighter","Fighter, Marksman","Fighter, Mage",Mage,1,0,1
2814,"Tank, Fighter","Support, Tank","Tank, Mage",Tank,0,1,1
2815,"Assassin, Fighter",Tank,Fighter,Support,1,0,1
8539,Marksman,"Assassin, Mage","Fighter, Assassin",Mage,1,0,1
8211,"Tank, Mage","Assassin, Fighter","Fighter, Marksman",Fighter,1,0,1
8212,"Fighter, Tank","Fighter, Tank","Fighter, Marksman",Fighter,1,0,1
2817,"Assassin, Fighter","Mage, Support","Tank, Fighter","Mage, Marksman",0,1,1
2820,"Fighter, Tank","Tank, Fighter","Fighter, Mage","Support, Fighter",1,0,1
8213,"Fighter, Marksman","Support, Mage","Fighter, Mage","Assassin, Fighter",1,0,1
8535,"Mage, Fighter","Mage, Support","Tank, Fighter","Tank, Mage",0,1,1
8534,"Tank, Mage",Mage,Fighter,"Mage, Support",0,1,1
8214,"Tank, Mage","Assassin, Fighter",Fighter,"Mage, Fighter",1,0,1
8532,"Tank, Fighter","Mage, Fighter","Tank, Mage","Mage, Support",1,0,1
2829,"Fighter, Mage","Support, Mage","Tank, Fighter",Mage,1,0,1
2830,"Tank, Fighter","Tank, Support","Fighter, Mage",Tank,0,1,1
8490,"Fighter, Assassin",Marksman,"Assassin, Fighter","Mage, Fighter",0,1,1
8233,"Assassin, Fighter","Fighter, Tank","Fighter, Tank","Fighter, Mage",1,0,1
8230,"Assassin, Fighter","Fighter, Tank","Fighter, Tank","Mage, Fighter",0,1,1
8231,Tank,"Mage, Fighter","Assassin, Fighter",Marksman,1,0,1
8502,Marksman,Mage,"Support, Mage","Mage, Support",0,1,1
8501,"Assassin, Fighter","Assassin, Fighter",Marksman,"Mage, Tank",0,1,1
2839,"Assassin, Fighter","Support, Tank",Support,"Fighter, Mage",1,0,1
2841,"Fighter, Tank","Support, Tank","Fighter, Mage","Support, Tank",1,0,1
8232,Fighter,"Fighter, Mage","Assassin, Fighter","Assassin, Fighter",1,0,1
8497,Fighter,"Assassin, Mage","Assassin, Fighter","Mage, Fighter",1,0,1
8515,"Mage, Fighter","Mage, Assassin","Fighter, Mage","Fighter, Marksman",0,1,1
8496,"Mage, Fighter",Mage,"Assassin, Fighter","Mage, Fighter",1,0,1
8234,Fighter,"Mage, Fighter","Assassin, Fighter","Assassin, Fighter",1,0,1
2846,"Mage, Fighter","Support, Tank","Fighter, Assassin","Fighter, Tank",1,0,1
8235,"Fighter, Mage","Assassin, Fighter",Fighter,"Fighter, Mage",0,1,1
8236,"Mage, Marksman","Fighter, Tank","Fighter, Tank","Mage, Fighter",1,0,1
8492,"Fighter, Assassin",Marksman,"Support, Mage","Mage, Support",1,0,1
2847,"Fighter, Mage",Tank,"Fighter, Assassin","Tank, Fighter",1,0,1
8504,"Mage, Fighter","Fighter, Marksman","Support, Mage","Mage, Support",1,0,1
8505,Marksman,Mage,"Assassin, Fighter","Fighter, Marksman",1,0,1
2835,"Assassin, Fighter",Support,Fighter,"Support, Mage",0,1,1
8229,Fighter,"Fighter, Tank","Assassin, Fighter",Marksman,1,0,1
2831,"Assassin, Fighter","Fighter, Tank","Tank, Fighter","Support, Fighter",1,0,1
8513,"Assassin, Fighter",Marksman,Fighter,"Assassin, Mage",0,1,1
8222,"Fighter, Mage",Marksman,"Fighter, Marksman","Assassin, Fighter",1,0,1
8512,"Mage, Fighter","Fighter, Marksman","Assassin, Fighter","Mage, Fighter",1,0,1
8223,Fighter,Fighter,"Assassin, Fighter","Assassin, Fighter",0,1,1
8224,"Fighter, Tank","Assassin, Fighter","Mage, Marksman","Fighter, Mage",1,0,1
2832,"Fighter, Mage",Support,"Fighter, Assassin","Support, Tank",1,0,1
8225,Tank,"Assassin, Fighter","Assassin, Fighter","Fighter, Mage",0,1,1
8226,Fighter,"Assassin, Fighter","Assassin, Fighter","Fighter, Assassin",0,1,1
8227,"Fighter, Tank","Fighter, Mage","Assassin, Fighter","Mage, Fighter",0,1,1
2833,"Assassin, Mage","Tank, Support","Tank, Fighter","Support, Mage",0,1,1
2834,"Tank, Fighter","Tank, Support","Assassin, Mage","Tank, Fighter",1,0,1
8508,"Fighter, Mage","Mage, Fighter","Support, Mage",Marksman,0,1,1
8228,"Assassin, Fighter","Mage, Fighter","Fighter, Mage","Fighter, Assassin",1,0,1
8507,"Assassin, Mage",Marksman,Marksman,"Mage, Assassin",1,0,1
2875,"Fighter, Assassin","Tank, Fighter",Fighter,"Support, Tank",0,1,1
8433,"Tank, Fighter",Fighter,"Fighter, Mage",Marksman,0,1,1
8264,Fighter,"Assassin, Fighter","Fighter, Assassin","Fighter, Mage",1,0,1
8349,"Fighter, Tank",Mage,"Fighter, Mage",Marksman,1,0,1
8295,"Fighter, Assassin","Mage, Fighter","Assassin, Fighter",Fighter,0,1,1
2922,"Fighter, Assassin",Marksman,"Mage, Fighter","Mage, Assassin",0,1,1
8354,"Mage, Fighter",Marksman,"Tank, Fighter",Fighter,0,1,1
8353,"Fighter, Mage",Marksman,"Mage, Fighter","Mage, Assassin",0,1,1
8296,"Tank, Fighter","Assassin, Fighter","Assassin, Fighter","Mage, Fighter",1,0,1
8297,"Mage, Fighter","Mage, Fighter","Tank, Mage",Fighter,1,0,1
8350,"Assassin, Fighter",Mage,"Support, Mage",Fighter,0,1,1
2926,Marksman,"Mage, Support","Fighter, Tank",Marksman,0,1,1
2929,"Tank, Mage","Support, Mage",Fighter,"Support, Tank",1,0,1
8298,"Assassin, Fighter","Mage, Fighter","Tank, Mage","Fighter, Assassin",0,1,1
8346,Fighter,"Mage, Assassin",Marksman,"Assassin, Fighter",1,0,1
8299,"Assassin, Fighter",Marksman,"Fighter, Assassin","Mage, Fighter",0,1,1
8345,"Mage, Fighter","Support, Mage","Assassin, Fighter","Mage, Fighter",0,1,1
8344,"Mage, Fighter",Mage,"Support, Mage","Mage, Support",0,1,1
2928,Fighter,"Mage, Assassin","Support, Mage",Marksman,1,0,1
8342,Fighter,"Fighter, Marksman","Assassin, Fighter",Fighter,0,1,1
8294,Fighter,"Mage, Fighter","Fighter, Assassin","Fighter, Mage",1,0,1
2918,"Assassin, Fighter","Mage, Assassin",Fighter,"Support, Mage",0,1,1
8293,Mage,"Fighter, Assassin","Support, Tank","Mage, Fighter",1,0,1
8292,"Support, Tank","Mage, Fighter","Fighter, Tank","Assassin, Fighter",1,0,1
8370,Fighter,"Assassin, Mage","Tank, Fighter","Tank, Mage",0,1,1
8369,"Mage, Fighter","Assassin, Mage","Tank, Fighter","Mage, Fighter",0,1,1
2912,"Mage, Fighter","Support, Fighter","Fighter, Mage","Tank, Fighter",0,1,1
2913,"Fighter, Mage","Support, Tank","Mage, Fighter","Tank, Fighter",0,1,1
8366,"Assassin, Fighter",Fighter,"Mage, Fighter","Marksman, Mage",0,1,1
8289,"Support, Tank",Marksman,"Mage, Support",Fighter,0,1,1
8364,Fighter,"Mage, Support",Marksman,"Assassin, Mage",0,1,1
8290,"Support, Tank","Mage, Fighter","Fighter, Mage",Fighter,0,1,1
2915,"Mage, Fighter","Tank, Fighter","Fighter, Mage","Support, Tank",0,1,1
8362,"Mage, Fighter","Assassin, Fighter","Fighter, Mage",Marksman,1,0,1
8291,"Fighter, Assassin",Fighter,Mage,"Mage, Fighter",1,0,1
2916,Marksman,"Tank, Fighter","Mage, Fighter","Support, Tank",1,0,1
2917,"Fighter, Tank",Mage,"Mage, Fighter","Tank, Support",1,0,1
8359,"Fighter, Assassin",Mage,Fighter,"Fighter, Mage",0,1,1
8358,"Fighter, Mage","Assassin, Mage","Fighter, Tank","Assassin, Fighter",1,0,1
8300,Fighter,Marksman,"Tank, Mage","Assassin, Fighter",0,1,1
8340,"Fighter, Mage","Fighter, Assassin",Fighter,Marksman,1,0,1
2878,"Assassin, Fighter","Tank, Support","Mage, Fighter","Mage, Support",1,0,1
8317,Fighter,"Assassin, Fighter","Tank, Fighter","Mage, Fighter",0,1,1
8323,"Support, Tank","Assassin, Fighter","Fighter, Assassin","Mage, Fighter",1,0,1
8322,"Support, Mage",Marksman,Mage,"Mage, Fighter",1,0,1
8321,Fighter,"Mage, Fighter","Tank, Fighter",Marksman,1,0,1
8306,"Mage, Fighter",Marksman,"Tank, Mage","Mage, Fighter",1,0,1
8320,"Tank, Fighter","Assassin, Fighter","Support, Mage",Marksman,1,0,1
8319,Marksman,"Fighter, Mage","Tank, Fighter","Fighter, Assassin",1,0,1
8318,Fighter,Marksman,"Tank, Fighter","Fighter, Mage",0,1,1
2933,Marksman,"Support, Mage","Fighter, Mage","Mage, Fighter",0,1,1
8301,"Assassin, Fighter","Assassin, Fighter","Mage, Fighter","Mage, Fighter",0,1,1
8315,"Fighter, Assassin","Mage, Fighter","Tank, Fighter","Assassin, Fighter",1,0,1
8307,"Tank, Mage","Mage, Fighter","Fighter, Assassin",Marksman,0,1,1
8308,"Assassin, Fighter","Mage, Fighter","Tank, Mage",Fighter,0,1,1
8314,"Mage, Fighter","Assassin, Fighter","Assassin, Fighter","Mage, Fighter",0,1,1
8313,"Assassin, Fighter","Tank, Mage","Fighter, Mage",Fighter,1,0,1
8312,"Mage, Fighter",Marksman,"Assassin, Fighter",Fighter,0,1,1
8311,"Assassin, Fighter",Marksman,"Mage, Fighter",Fighter,1,0,1
8324,"Fighter, Assassin",Fighter,Fighter,"Mage, Fighter",1,0,1
8325,"Marksman, Fighter","Mage, Fighter",Fighter,Fighter,1,0,1
2934,Marksman,"Support, Mage","Tank, Mage","Fighter, Tank",1,0,1
8326,Fighter,"Assassin, Fighter","Fighter, Marksman","Mage, Fighter",0,1,1
8302,"Mage, Fighter","Fighter, Assassin",Fighter,"Mage, Fighter",1,0,1
8338,Fighter,"Fighter, Mage","Fighter, Mage","Mage, Support",1,0,1
8303,"Mage, Marksman","Assassin, Fighter","Assassin, Fighter",Marksman,1,0,1
2931,"Support, Mage","Mage, Support",Fighter,"Support, Mage",0,1,1
8336,"Mage, Fighter","Support, Mage","Fighter, Mage","Mage, Assassin",1,0,1
8335,"Mage, Fighter",Mage,"Tank, Fighter",Fighter,1,0,1
8304,"Assassin, Fighter","Assassin, Fighter","Tank, Mage","Assassin, Fighter",1,0,1
8334,"Fighter, Mage","Mage, Marksman","Tank, Fighter","Mage, Assassin",1,0,1
2932,"Fighter, Mage","Fighter, Tank",Marksman,"Support, Mage",0,1,1
8332,Fighter,"Marksman, Mage","Fighter, Mage","Mage, Support",0,1,1
8331,"Support, Tank",Marksman,"Tank, Fighter","Fighter, Mage",0,1,1
8330,"Mage, Marksman",Marksman,"Fighter, Assassin","Fighter, Mage",1,0,1
8329,"Tank, Fighter","Fighter, Mage","Mage, Marksman",Marksman,0,1,1
8328,"Tank, Mage","Mage, Fighter",Mage,Marksman,1,0,1
8327,Fighter,"Tank, Fighter","Tank, Fighter","Mage, Fighter",0,1,1
8371,"Fighter, Mage","Fighter, Marksman","Mage, Fighter","Tank, Mage",0,1,1
8288,"Support, Tank",Fighter,"Fighter, Assassin","Assassin, Fighter",0,1,1
8372,"Fighter, Mage","Assassin, Mage","Tank, Fighter","Fighter, Marksman",1,0,1
8410,Fighter,"Support, Mage","Assassin, Fighter","Assassin, Mage",1,0,1
8415,"Fighter, Mage","Marksman, Assassin",Marksman,"Mage, Marksman",1,0,1
8414,"Tank, Fighter","Mage, Tank","Mage, Fighter",Mage,1,0,1
2891,"Fighter, Assassin","Support, Mage","Fighter, Tank","Support, Mage",1,0,1
8272,"Marksman, Fighter","Assassin, Mage",Marksman,"Mage, Fighter",0,1,1
2892,"Assassin, Fighter","Fighter, Tank","Assassin, Fighter","Support, Tank",1,0,1
8411,"Fighter, Mage","Marksman, Assassin","Mage, Fighter","Mage, Marksman",0,1,1
8273,Marksman,"Fighter, Assassin","Support, Tank",Marksman,1,0,1
8409,"Fighter, Tank",Mage,"Fighter, Mage",Mage,0,1,1
8373,"Tank, Fighter","Assassin, Fighter","Tank, Fighter","Fighter, Marksman",0,1,1
8408,Marksman,"Mage, Tank","Fighter, Assassin",Mage,0,1,1
8407,Fighter,"Mage, Fighter","Fighter, Tank","Mage, Fighter",1,0,1
2893,"Assassin, Fighter","Tank, Fighter",Fighter,"Tank, Support",0,1,1
2894,Fighter,"Support, Mage","Tank, Fighter","Fighter, Tank",1,0,1
2895,"Mage, Fighter","Fighter, Tank","Assassin, Fighter","Support, Tank",1,0,1
8403,"Tank, Fighter",Mage,"Mage, Fighter","Mage, Fighter",1,0,1
8274,"Fighter, Tank","Mage, Fighter","Marksman, Fighter",Marksman,0,1,1
8416,"Fighter, Tank","Support, Mage",Fighter,"Mage, Marksman",0,1,1
8271,"Support, Mage",Marksman,"Fighter, Tank","Mage, Fighter",0,1,1
8418,"Assassin, Fighter","Mage, Fighter",Marksman,Fighter,1,0,1
8419,Fighter,"Support, Mage","Fighter, Mage",Marksman,1,0,1
8431,"Fighter, Mage","Mage, Assassin","Assassin, Fighter","Fighter, Mage",0,1,1
8430,"Assassin, Fighter","Assassin, Mage",Marksman,"Mage, Marksman",1,0,1
8265,"Tank, Fighter",Marksman,Fighter,Fighter,1,0,1
8266,"Fighter, Assassin","Fighter, Tank","Support, Mage","Mage, Fighter",0,1,1
8267,Mage,Marksman,"Fighter, Assassin",Fighter,1,0,1
2884,Fighter,"Support, Mage","Fighter, Tank","Support, Tank",0,1,1
8426,Tank,Marksman,"Fighter, Assassin","Fighter, Assassin",1,0,1
8425,Fighter,"Fighter, Mage",Marksman,"Mage, Marksman",0,1,1
8424,"Tank, Fighter","Mage, Marksman","Mage, Fighter","Assassin, Mage",1,0,1
8268,"Fighter, Assassin",Marksman,"Support, Tank","Assassin, Fighter",1,0,1
8423,"Support, Mage","Mage, Marksman","Fighter, Mage","Assassin, Mage",0,1,1
2886,"Fighter, Tank","Support, Mage","Assassin, Fighter","Tank, Support",0,1,1
8269,"Tank, Fighter","Assassin, Fighter","Mage, Support",Marksman,0,1,1
8420,Marksman,"Mage, Marksman","Fighter, Mage","Assassin, Mage",1,0,1
8270,"Fighter, Tank","Mage, Fighter",Mage,Fighter,0,1,1
8275,"Marksman, Fighter",Marksman,"Fighter, Assassin",Fighter,1,0,1
2897,"Mage, Fighter","Support, Mage","Fighter, Assassin","Tank, Fighter",1,0,1
8276,Mage,"Assassin, Fighter","Fighter, Assassin","Mage, Fighter",0,1,1
8284,"Fighter, Assassin","Mage, Fighter","Support, Tank","Assassin, Fighter",1,0,1
8285,"Marksman, Fighter",Fighter,"Tank, Fighter","Mage, Fighter",0,1,1
2935,"Fighter, Mage","Support, Tank","Fighter, Tank","Support, Mage",1,0,1
8385,"Mage, Fighter",Fighter,"Tank, Fighter",Mage,0,1,1
2909,"Fighter, Mage","Tank, Fighter","Assassin, Fighter","Support, Tank",1,0,1
8383,Fighter,"Assassin, Fighter","Mage, Fighter","Mage, Assassin",0,1,1
2910,Marksman,"Support, Mage","Fighter, Tank","Mage, Support",0,1,1
8287,"Tank, Fighter","Mage, Fighter",Mage,Marksman,1,0,1
8381,"Tank, Fighter",Mage,"Mage, Fighter","Mage, Assassin",1,0,1
8380,"Fighter, Mage",Marksman,"Tank, Mage","Mage, Support",0,1,1
8379,"Fighter, Mage",Mage,"Assassin, Fighter","Fighter, Assassin",1,0,1
8378,"Tank, Fighter",Mage,"Fighter, Mage","Support, Mage",1,0,1
2911,"Fighter, Mage","Tank, Fighter",Marksman,"Support, Mage",0,1,1
8376,"Tank, Fighter","Assassin, Fighter","Support, Mage",Mage,1,0,1
8375,"Tank, Fighter","Marksman, Fighter","Fighter, Mage",Marksman,0,1,1
8374,Fighter,"Fighter, Marksman","Fighter, Tank","Mage, Support",1,0,1
8387,Marksman,"Support, Mage","Mage, Fighter","Marksman, Mage",1,0,1
8388,"Tank, Fighter",Fighter,Fighter,"Support, Mage",0,1,1
2898,"Fighter, Tank","Mage, Support","Support, Mage","Support, Tank",1,0,1
8389,"Tank, Fighter","Fighter, Assassin","Mage, Fighter","Mage, Support",1,0,1
8399,Marksman,"Mage, Tank",Fighter,"Mage, Marksman",0,1,1
8277,"Fighter, Assassin",Marksman,Mage,"Mage, Fighter",1,0,1
8278,"Tank, Fighter",Marksman,Mage,Fighter,0,1,1
8279,"Tank, Mage",Marksman,"Support, Tank",Fighter,0,1,1
2899,"Tank, Fighter","Tank, Support",Marksman,"Tank, Fighter",0,1,1
8397,Marksman,Mage,Fighter,"Marksman, Mage",0,1,1
8396,Fighter,"Mage, Marksman","Mage, Fighter","Fighter, Mage",0,1,1
8280,"Support, Mage","Fighter, Mage","Fighter, Assassin","Mage, Fighter",0,1,1
8394,Fighter,"Assassin, Mage","Fighter, Mage","Mage, Assassin",1,0,1
8281,"Marksman, Fighter","Fighter, Assassin","Tank, Fighter",Marksman,1,0,1
8393,Fighter,"Fighter, Assassin","Fighter, Assassin","Marksman, Mage",0,1,1
8282,"Support, Tank",Marksman,"Fighter, Tank","Mage, Fighter",0,1,1
2901,"Fighter, Assassin","Support, Tank","Fighter, Mage","Mage, Fighter",0,1,1
2902,Marksman,"Tank, Fighter","Mage, Fighter","Mage, Support",1,0,1
8283,"Mage, Fighter",Fighter,"Mage, Marksman","Mage, Fighter",0,1,1
2812,"Tank, Fighter","Fighter, Tank","Fighter, Tank","Tank, Support",1,0,1
8545,"Fighter, Assassin","Support, Mage",Marksman,"Assassin, Mage",0,1,1
8547,"Fighter, Mage","Mage, Marksman","Fighter, Assassin","Mage, Support",1,0,1
8722,"Tank, Fighter","Mage, Support","Tank, Fighter","Fighter, Mage",1,0,1
8143,"Mage, Support","Fighter, Assassin","Fighter, Tank","Tank, Fighter",1,0,1
2689,Marksman,"Support, Tank",Fighter,Mage,0,1,1
8726,"Fighter, Mage",Mage,"Tank, Fighter","Tank, Mage",0,1,1
8725,Fighter,"Mage, Support","Tank, Mage",Marksman,0,1,1
2690,"Fighter, Assassin","Support, Fighter",Fighter,"Mage, Assassin",1,0,1
8144,"Fighter, Mage","Tank, Fighter","Support, Mage","Fighter, Assassin",0,1,1
8723,"Tank, Fighter","Mage, Support","Tank, Mage","Assassin, Mage",1,0,1
8145,"Support, Mage","Tank, Fighter","Fighter, Tank","Fighter, Assassin",1,0,1
8715,"Tank, Fighter",Marksman,"Fighter, Assassin","Tank, Mage",1,0,1
8721,"Tank, Mage","Mage, Tank","Tank, Fighter",Marksman,1,0,1
8720,"Tank, Fighter","Mage, Tank","Tank, Fighter","Assassin, Mage",0,1,1
2693,Marksman,"Support, Mage","Support, Mage","Support, Mage",1,0,1
8718,"Mage, Fighter","Mage, Support","Fighter, Mage","Assassin, Fighter",0,1,1
2696,"Fighter, Mage","Support, Mage","Fighter, Tank","Mage, Support",0,1,1
8146,"Fighter, Tank",Fighter,Mage,"Fighter, Assassin",1,0,1
8147,"Tank, Mage","Tank, Fighter","Mage, Support","Tank, Fighter",1,0,1
2688,"Mage, Fighter","Support, Tank","Fighter, Assassin","Mage, Assassin",0,1,1
8729,"Mage, Fighter","Tank, Mage","Fighter, Mage",Mage,0,1,1
8142,"Tank, Mage","Tank, Fighter","Assassin, Fighter","Fighter, Assassin",1,0,1
8141,"Assassin, Mage","Fighter, Assassin","Tank, Mage","Tank, Fighter",0,1,1
8132,"Tank, Fighter","Tank, Mage","Fighter, Tank","Mage, Fighter",0,1,1
8133,"Fighter, Mage","Fighter, Mage","Fighter, Tank","Tank, Mage",1,0,1
8134,"Fighter, Tank","Mage, Fighter","Tank, Mage","Tank, Mage",1,0,1
8135,"Tank, Fighter","Tank, Fighter",Tank,"Fighter, Mage",0,1,1
8739,"Support, Mage","Assassin, Fighter","Fighter, Assassin","Mage, Support",1,0,1
8738,Marksman,"Mage, Support","Fighter, Assassin","Assassin, Fighter",1,0,1
8737,Marksman,"Mage, Tank","Fighter, Assassin","Mage, Support",1,0,1
8136,"Mage, Marksman","Tank, Mage","Fighter, Tank","Fighter, Mage",0,1,1
8736,"Fighter, Mage","Mage, Tank","Support, Mage","Assassin, Mage",1,0,1
8137,"Tank, Fighter","Tank, Fighter","Fighter, Assassin","Tank, Mage",1,0,1
8138,Mage,"Tank, Fighter","Fighter, Mage","Fighter, Assassin",1,0,1
8139,"Support, Mage","Assassin, Fighter","Tank, Mage",Fighter,1,0,1
8732,"Tank, Mage",Marksman,"Tank, Fighter","Tank, Mage",1,0,1
8731,"Tank, Fighter","Assassin, Fighter","Tank, Mage","Mage, Support",0,1,1
8140,"Fighter, Mage","Tank, Fighter","Mage, Support","Fighter, Assassin",1,0,1
8148,"Tank, Mage","Fighter, Assassin","Support, Mage","Tank, Fighter",1,0,1
8149,"Support, Mage",Fighter,"Tank, Mage","Fighter, Assassin",1,0,1
8685,"Fighter, Assassin","Marksman, Assassin","Mage, Fighter","Mage, Support",1,0,1
8162,"Support, Mage","Tank, Fighter","Tank, Mage","Fighter, Assassin",1,0,1
8699,"Fighter, Mage","Fighter, Mage","Mage, Fighter",Mage,1,0,1
8698,"Mage, Fighter","Mage, Assassin","Fighter, Mage","Assassin, Fighter",1,0,1
8697,Fighter,"Mage, Tank","Mage, Fighter","Mage, Marksman",0,1,1
8160,"Assassin, Mage","Fighter, Assassin","Fighter, Tank","Tank, Fighter",0,1,1
8161,"Support, Mage",Fighter,"Fighter, Mage","Tank, Fighter",0,1,1
2708,"Fighter, Assassin","Support, Mage","Fighter, Mage","Support, Fighter",1,0,1
8695,"Mage, Fighter","Marksman, Mage",Fighter,"Mage, Assassin",0,1,1
2712,"Fighter, Tank","Mage, Assassin","Fighter, Assassin",Marksman,1,0,1
8150,"Fighter, Tank","Assassin, Fighter","Support, Mage","Assassin, Fighter",0,1,1
2714,"Mage, Fighter","Support, Mage",Fighter,"Mage, Assassin",0,1,1
2715,"Fighter, Mage",Mage,"Fighter, Tank","Support, Tank",1,0,1
8163,"Fighter, Mage","Tank, Fighter","Assassin, Mage","Assassin, Fighter",0,1,1
8164,"Fighter, Mage","Fighter, Assassin","Fighter, Tank","Fighter, Assassin",0,1,1
2718,"Fighter, Mage","Mage, Support","Support, Mage","Support, Fighter",0,1,1
8688,"Assassin, Fighter","Mage, Assassin",Marksman,"Assassin, Fighter",1,0,1
8687,"Fighter, Assassin","Fighter, Marksman","Assassin, Fighter","Assassin, Fighter",0,1,1
8700,Fighter,"Fighter, Marksman","Support, Mage",Marksman,0,1,1
8701,"Support, Mage","Assassin, Fighter","Mage, Fighter","Mage, Support",1,0,1
8702,"Mage, Fighter","Fighter, Marksman",Fighter,"Mage, Fighter",1,0,1
8159,"Tank, Mage","Tank, Fighter","Support, Mage","Fighter, Assassin",0,1,1
8714,"Fighter, Assassin","Tank, Mage","Tank, Fighter",Mage,0,1,1
2697,Fighter,"Support, Fighter","Mage, Fighter","Mage, Assassin",0,1,1
8151,"Support, Mage","Fighter, Assassin","Fighter, Assassin","Tank, Fighter",0,1,1
8712,"Assassin, Fighter","Mage, Support",Marksman,"Mage, Marksman",0,1,1
8152,Mage,"Tank, Fighter","Fighter, Tank","Assassin, Fighter",1,0,1
8153,"Fighter, Tank","Fighter, Mage","Tank, Mage","Fighter, Assassin",1,0,1
2698,"Assassin, Fighter","Mage, Assassin",Fighter,Marksman,1,0,1
8154,"Fighter, Mage","Fighter, Mage","Fighter, Tank","Support, Mage",0,1,1
8709,"Mage, Fighter",Marksman,"Fighter, Assassin","Fighter, Marksman",1,0,1
8155,Tank,"Assassin, Fighter","Tank, Mage","Fighter, Mage",0,1,1
8156,"Assassin, Mage","Fighter, Assassin","Fighter, Mage","Tank, Fighter",1,0,1
8157,"Mage, Support","Tank, Fighter",Mage,"Fighter, Assassin",1,0,1
8158,"Support, Mage","Assassin, Fighter","Tank, Mage","Tank, Fighter",0,1,1
8706,"Fighter, Assassin","Fighter, Marksman","Mage, Fighter",Marksman,0,1,1
2705,"Tank, Fighter",Mage,"Fighter, Tank","Tank, Support",0,1,1
8131,"Tank, Fighter","Assassin, Fighter","Fighter, Tank","Tank, Mage",0,1,1
8744,"Fighter, Assassin",Mage,"Mage, Fighter","Assassin, Fighter",0,1,1
8130,"Tank, Mage","Fighter, Mage","Fighter, Tank","Tank, Mage",1,0,1
8106,"Tank, Mage","Fighter, Tank","Mage, Tank",Fighter,1,0,1
8787,"Mage, Fighter","Assassin, Mage",Fighter,"Support, Mage",1,0,1
8786,Fighter,"Mage, Fighter","Mage, Fighter","Mage, Marksman",0,1,1
8785,"Mage, Fighter","Mage, Fighter",Fighter,"Support, Mage",1,0,1
8104,Tank,Fighter,"Tank, Mage","Assassin, Mage",1,0,1
8784,"Fighter, Tank","Mage, Marksman",Fighter,"Mage, Fighter",0,1,1
8105,"Mage, Fighter",Fighter,"Tank, Mage","Fighter, Mage",0,1,1
8310,Tank,"Mage, Fighter","Assassin, Fighter",Fighter,0,1,1
8107,"Mage, Fighter","Assassin, Mage","Fighter, Tank","Fighter, Mage",1,0,1
8746,Marksman,Marksman,"Fighter, Assassin","Assassin, Mage",0,1,1
8781,Fighter,"Mage, Tank","Fighter, Mage","Mage, Marksman",1,0,1
8780,Fighter,"Mage, Fighter","Fighter, Mage","Mage, Marksman",1,0,1
8779,Fighter,"Mage, Marksman","Assassin, Fighter","Assassin, Mage",0,1,1
8778,"Mage, Fighter","Assassin, Mage",Marksman,"Support, Mage",0,1,1
8777,Fighter,Mage,"Fighter, Tank","Assassin, Mage",1,0,1
8108,"Tank, Mage","Assassin, Fighter","Mage, Marksman","Tank, Fighter",0,1,1
8109,"Fighter, Tank","Fighter, Tank","Mage, Tank","Tank, Fighter",1,0,1
8103,"Tank, Mage","Assassin, Mage","Assassin, Fighter",Fighter,0,1,1
8102,"Assassin, Fighter",Fighter,"Tank, Mage","Assassin, Mage",1,0,1
8101,"Assassin, Fighter","Assassin, Mage",Tank,"Fighter, Mage",0,1,1
8788,Marksman,"Mage, Fighter",Marksman,"Marksman, Mage",0,1,1
8089,"Tank, Mage","Assassin, Mage","Fighter, Tank",Fighter,1,0,1
8090,Tank,Fighter,"Tank, Fighter","Assassin, Mage",0,1,1
8091,"Tank, Mage","Assassin, Mage","Fighter, Mage","Assassin, Fighter",1,0,1
8092,"Fighter, Tank",Fighter,"Fighter, Mage","Assassin, Mage",0,1,1
8792,Fighter,Marksman,"Marksman, Fighter","Assassin, Mage",0,1,1
8791,"Mage, Fighter",Fighter,Fighter,"Assassin, Fighter",0,1,1
8093,Tank,"Assassin, Fighter","Fighter, Tank","Assassin, Mage",1,0,1
8094,"Mage, Fighter","Tank, Fighter","Fighter, Tank",Fighter,1,0,1
8095,"Assassin, Fighter","Assassin, Mage","Tank, Mage","Fighter, Mage",1,0,1
8096,"Tank, Mage","Assassin, Mage","Fighter, Tank","Assassin, Fighter",1,0,1
8097,"Mage, Fighter","Fighter, Assassin","Fighter, Mage","Assassin, Mage",1,0,1
8098,"Fighter, Tank","Fighter, Assassin","Fighter, Mage","Assassin, Mage",1,0,1
8099,Tank,"Fighter, Mage","Fighter, Tank","Assassin, Mage",0,1,1
8789,"Fighter, Assassin","Mage, Marksman",Marksman,"Marksman, Mage",0,1,1
8100,"Mage, Fighter","Tank, Fighter","Fighter, Mage",Fighter,0,1,1
8110,"Assassin, Fighter",Marksman,"Fighter, Support","Assassin, Fighter",1,0,1
8776,"Fighter, Assassin",Mage,"Fighter, Mage","Marksman, Fighter",1,0,1
8111,"Tank, Mage","Fighter, Assassin","Fighter, Tank","Tank, Mage",0,1,1
8761,"Mage, Fighter","Fighter, Marksman",Fighter,"Mage, Support",1,0,1
8121,"Tank, Mage","Assassin, Fighter","Fighter, Mage","Tank, Mage",1,0,1
8122,"Fighter, Mage","Tank, Mage","Tank, Fighter","Fighter, Mage",1,0,1
8123,"Fighter, Tank","Mage, Fighter",Assassin,"Fighter, Assassin",1,0,1
8124,"Fighter, Tank","Assassin, Fighter","Fighter, Marksman","Fighter, Mage",0,1,1
2942,Marksman,Support,"Support, Mage","Mage, Support",1,0,1
8756,"Fighter, Assassin",Mage,"Fighter, Mage",Mage,1,0,1
8126,"Fighter, Mage","Fighter, Tank",Tank,"Assassin, Fighter",0,1,1
8127,"Tank, Mage","Fighter, Mage","Fighter, Assassin","Tank, Mage",1,0,1
8752,"Fighter, Assassin","Mage, Tank","Fighter, Mage",Mage,0,1,1
8751,"Fighter, Mage","Support, Mage","Tank, Fighter","Tank, Mage",0,1,1
8128,"Tank, Fighter","Tank, Mage",Tank,"Tank, Fighter",1,0,1
8750,"Fighter, Mage","Tank, Mage",Fighter,"Mage, Tank",1,0,1
8129,Tank,"Tank, Mage","Tank, Mage","Fighter, Mage",1,0,1
8748,"Tank, Fighter","Fighter, Assassin","Fighter, Mage","Assassin, Mage",1,0,1
8747,"Fighter, Assassin","Mage, Tank","Tank, Fighter","Mage, Support",1,0,1
8120,"Tank, Fighter","Tank, Mage","Fighter, Marksman","Fighter, Mage",1,0,1
8762,"Fighter, Tank","Assassin, Mage",Fighter,"Mage, Fighter",0,1,1
8112,"Tank, Mage","Tank, Fighter","Tank, Mage","Assassin, Fighter",0,1,1
8119,"Fighter, Tank","Tank, Fighter","Fighter, Mage","Tank, Mage",1,0,1
8773,"Assassin, Fighter","Assassin, Mage",Fighter,"Support, Mage",0,1,1
8113,Tank,"Tank, Mage","Fighter, Tank",Fighter,0,1,1
8772,"Mage, Fighter","Marksman, Mage",Marksman,"Support, Mage",0,1,1
8771,"Assassin, Fighter","Mage, Fighter","Mage, Fighter","Marksman, Mage",1,0,1
8770,"Mage, Fighter","Mage, Marksman","Assassin, Fighter","Mage, Fighter",1,0,1
8114,"Support, Mage","Mage, Support",Assassin,"Support, Mage",0,1,1
8115,"Tank, Fighter","Tank, Fighter","Tank, Mage","Fighter, Mage",1,0,1
8769,Marksman,"Mage, Marksman","Mage, Fighter","Mage, Fighter",1,0,1
8768,"Mage, Fighter","Mage, Marksman",Marksman,"Mage, Assassin",0,1,1
8767,"Mage, Fighter",Mage,"Mage, Assassin","Mage, Marksman",0,1,1
8766,"Assassin, Fighter","Mage, Marksman","Fighter, Mage","Assassin, Fighter",1,0,1
8116,"Tank, Mage","Tank, Fighter","Fighter, Marksman","Mage, Fighter",1,0,1
8117,"Tank, Fighter","Fighter, Assassin","Fighter, Mage","Tank, Fighter",1,0,1
8118,"Assassin, Fighter","Support, Mage","Fighter, Assassin","Fighter, Assassin",1,0,1
8764,"Assassin, Fighter","Mage, Marksman",Fighter,"Assassin, Mage",0,1,1
8686,"Mage, Fighter","Assassin, Mage","Assassin, Fighter","Mage, Tank",0,1,1
8684,"Fighter, Assassin",Mage,"Assassin, Fighter","Fighter, Marksman",1,0,1
8208,"Fighter, Tank","Fighter, Tank",Tank,"Assassin, Fighter",0,1,1
2937,"Assassin, Fighter","Support, Mage",Fighter,"Fighter, Tank",1,0,1
8600,"Support, Mage",Marksman,Fighter,"Fighter, Marksman",1,0,1
8599,"Fighter, Tank",Mage,"Assassin, Fighter","Mage, Fighter",1,0,1
8195,"Assassin, Fighter","Assassin, Fighter","Mage, Fighter",Marksman,1,0,1
2777,"Fighter, Tank",Marksman,"Fighter, Assassin","Mage, Support",1,0,1
2778,"Mage, Fighter","Fighter, Tank","Fighter, Assassin","Support, Tank",1,0,1
8595,"Tank, Fighter","Tank, Mage","Tank, Fighter",Mage,1,0,1
2779,"Support, Mage","Mage, Assassin",Marksman,"Support, Tank",1,0,1
2783,"Fighter, Assassin","Tank, Support","Fighter, Tank","Support, Mage",0,1,1
8585,"Fighter, Assassin","Fighter, Marksman","Mage, Fighter","Mage, Fighter",0,1,1
8591,"Mage, Fighter",Mage,"Tank, Fighter","Assassin, Mage",0,1,1
2784,"Fighter, Tank","Support, Mage","Fighter, Mage","Support, Mage",0,1,1
8589,Fighter,"Mage, Support","Mage, Fighter","Marksman, Mage",0,1,1
8588,Fighter,Mage,"Mage, Fighter","Fighter, Marksman",0,1,1
2785,"Fighter, Assassin",Marksman,Fighter,"Tank, Fighter",1,0,1
8197,"Tank, Mage","Mage, Fighter",Tank,"Fighter, Mage",0,1,1
8198,Tank,Marksman,"Fighter, Mage",Marksman,0,1,1
2775,Fighter,Mage,Marksman,"Support, Tank",1,0,1
8194,"Fighter, Assassin","Mage, Fighter",Tank,Marksman,0,1,1
8602,"Support, Mage","Assassin, Fighter","Assassin, Fighter",Marksman,1,0,1
2772,"Assassin, Fighter","Tank, Support","Fighter, Assassin","Mage, Assassin",0,1,1
8614,"Tank, Fighter","Mage, Marksman",Fighter,"Mage, Fighter",0,1,1
2768,"Fighter, Tank",Marksman,"Assassin, Fighter","Support, Fighter",0,1,1
8612,Marksman,"Mage, Support","Fighter, Mage",Mage,0,1,1
2769,Fighter,"Support, Mage","Fighter, Assassin","Mage, Assassin",1,0,1
8610,"Fighter, Tank","Fighter, Marksman","Mage, Fighter","Mage, Fighter",0,1,1
8609,Marksman,"Fighter, Marksman","Mage, Fighter",Mage,0,1,1
8189,"Fighter, Tank","Assassin, Fighter",Fighter,"Mage, Fighter",0,1,1
8607,"Support, Mage",Marksman,Marksman,"Mage, Marksman",0,1,1
8190,"Fighter, Tank","Mage, Fighter","Assassin, Fighter","Fighter, Tank",0,1,1
8191,Tank,"Mage, Fighter",Fighter,"Fighter, Tank",0,1,1
8606,Marksman,Marksman,"Support, Mage","Assassin, Fighter",0,1,1
8192,Tank,Marksman,"Support, Tank","Mage, Fighter",0,1,1
8605,"Mage, Fighter","Fighter, Marksman",Fighter,Marksman,0,1,1
8193,Tank,"Fighter, Mage","Mage, Fighter",Fighter,1,0,1
8604,Fighter,"Assassin, Mage","Mage, Fighter","Assassin, Fighter",1,0,1
8199,"Fighter, Tank",Fighter,"Fighter, Tank","Tank, Mage",1,0,1
8584,"Fighter, Assassin","Mage, Fighter",Marksman,"Mage, Fighter",1,0,1
8683,"Assassin, Fighter","Mage, Support","Mage, Fighter","Marksman, Assassin",1,0,1
8205,"Fighter, Tank","Fighter, Assassin","Assassin, Fighter","Mage, Fighter",0,1,1
2800,"Tank, Mage",Mage,"Tank, Fighter",Mage,1,0,1
2801,"Assassin, Fighter","Tank, Support","Fighter, Tank","Support, Mage",1,0,1
8203,Fighter,"Mage, Fighter",Tank,Fighter,0,1,1
8558,"Fighter, Tank","Mage, Support","Tank, Fighter","Assassin, Mage",0,1,1
8557,"Fighter, Tank","Tank, Mage","Fighter, Tank","Assassin, Mage",1,0,1
2804,Fighter,"Support, Tank","Assassin, Fighter","Support, Tank",1,0,1
8204,"Mage, Assassin","Fighter, Assassin","Assassin, Fighter","Assassin, Fighter",1,0,1
8554,"Tank, Fighter","Tank, Mage","Fighter, Assassin","Mage, Assassin",1,0,1
8583,"Assassin, Fighter","Assassin, Mage",Marksman,"Assassin, Mage",1,0,1
2806,"Mage, Fighter",Support,"Fighter, Tank","Support, Tank",1,0,1
8552,"Tank, Fighter","Mage, Support",Fighter,"Mage, Marksman",1,0,1
2807,"Tank, Fighter","Tank, Support","Tank, Mage","Fighter, Tank",1,0,1
8550,Fighter,"Assassin, Mage","Fighter, Tank","Assassin, Mage",0,1,1
8206,"Tank, Mage","Assassin, Fighter","Fighter, Marksman","Mage, Fighter",0,1,1
8207,"Tank, Mage","Mage, Fighter",Tank,Fighter,0,1,1
8549,Fighter,"Mage, Support","Fighter, Tank",Marksman,1,0,1
8202,"Fighter, Tank",Marksman,"Fighter, Mage",Fighter,0,1,1
8564,"Assassin, Fighter","Assassin, Mage","Fighter, Mage","Mage, Tank",1,0,1
8565,"Assassin, Fighter","Mage, Tank","Mage, Fighter",Mage,1,0,1
8566,"Assassin, Fighter",Mage,"Fighter, Assassin","Mage, Tank",1,0,1
8582,"Assassin, Fighter",Marksman,"Fighter, Assassin","Fighter, Marksman",1,0,1
8581,"Tank, Fighter","Fighter, Assassin","Fighter, Mage","Mage, Support",0,1,1
8200,"Fighter, Mage",Marksman,"Mage, Assassin",Marksman,1,0,1
2792,"Assassin, Fighter","Tank, Fighter","Fighter, Mage","Support, Tank",1,0,1
2793,"Fighter, Assassin","Support, Tank","Mage, Fighter","Fighter, Tank",0,1,1
8576,"Mage, Fighter","Assassin, Mage","Fighter, Mage","Assassin, Mage",0,1,1
2794,"Assassin, Fighter","Support, Mage",Marksman,Tank,1,0,1
8574,Marksman,"Tank, Mage","Assassin, Fighter","Mage, Support",0,1,1
8573,"Assassin, Fighter","Assassin, Mage","Fighter, Assassin","Support, Mage",0,1,1
8572,Marksman,"Mage, Tank","Assassin, Fighter","Fighter, Marksman",0,1,1
8201,Tank,Marksman,"Mage, Assassin",Marksman,0,1,1
8570,Marksman,"Assassin, Fighter","Fighter, Assassin","Mage, Tank",1,0,1
8569,"Support, Mage","Mage, Marksman",Marksman,"Mage, Assassin",1,0,1
8568,"Assassin, Fighter","Mage, Fighter",Fighter,"Assassin, Mage",0,1,1
8567,"Assassin, Fighter","Mage, Assassin",Marksman,"Mage, Tank",0,1,1
2765,"Tank, Fighter","Support, Tank",Marksman,"Tank, Support",0,1,1
8188,"Assassin, Fighter","Fighter, Tank",Fighter,"Mage, Fighter",1,0,1
2762,"Assassin, Fighter","Support, Tank","Fighter, Tank","Support, Fighter",1,0,1
8172,"Mage, Tank",Fighter,"Fighter, Tank","Mage, Fighter",0,1,1
2726,"Assassin, Fighter","Mage, Support","Fighter, Tank","Tank, Fighter",1,0,1
8666,"Mage, Fighter","Mage, Fighter","Support, Mage",Mage,0,1,1
8665,Marksman,"Fighter, Marksman","Assassin, Fighter",Mage,1,0,1
2728,"Assassin, Mage","Support, Tank",Marksman,"Support, Mage",1,0,1
8171,Fighter,"Fighter, Mage","Mage, Fighter",Fighter,1,0,1
2729,"Fighter, Mage","Support, Mage","Fighter, Tank","Support, Mage",0,1,1
2730,"Fighter, Assassin","Mage, Assassin",Fighter,Marksman,0,1,1
2733,"Fighter, Tank","Support, Tank","Support, Mage","Mage, Assassin",1,0,1
8187,"Fighter, Mage","Assassin, Fighter","Assassin, Fighter",Fighter,1,0,1
8658,"Fighter, Mage","Assassin, Mage","Tank, Mage","Mage, Support",1,0,1
2734,"Fighter, Tank","Fighter, Tank","Fighter, Mage","Support, Mage",0,1,1
2736,Fighter,"Fighter, Tank","Fighter, Assassin","Support, Mage",0,1,1
8654,Fighter,"Mage, Fighter","Mage, Fighter","Mage, Fighter",0,1,1
8653,"Support, Mage","Mage, Fighter",Fighter,"Support, Mage",1,0,1
2739,"Assassin, Fighter","Support, Fighter","Fighter, Assassin","Mage, Assassin",1,0,1
8651,"Tank, Fighter",Mage,"Assassin, Fighter",Mage,0,1,1
8668,"Support, Mage","Assassin, Fighter",Marksman,"Assassin, Fighter",1,0,1
2724,"Fighter, Tank","Mage, Assassin",Fighter,Marksman,1,0,1
8670,"Support, Mage","Assassin, Fighter",Fighter,Marksman,1,0,1
8671,"Assassin, Fighter","Assassin, Fighter","Mage, Fighter","Assassin, Fighter",0,1,1
8165,Fighter,"Fighter, Mage","Tank, Mage","Mage, Fighter",0,1,1
8681,"Assassin, Fighter","Mage, Tank","Mage, Fighter","Assassin, Mage",1,0,1
8166,"Support, Mage",Fighter,"Assassin, Fighter","Assassin, Mage",1,0,1
8167,"Fighter, Tank","Mage, Fighter","Support, Tank","Fighter, Mage",1,0,1
8680,"Assassin, Fighter","Mage, Tank",Marksman,"Mage, Support",1,0,1
2720,Fighter,"Support, Tank","Mage, Fighter",Mage,0,1,1
8168,"Fighter, Assassin","Fighter, Tank","Fighter, Tank","Fighter, Mage",1,0,1
8678,"Mage, Fighter","Mage, Support","Assassin, Mage","Assassin, Fighter",1,0,1
8677,"Fighter, Assassin","Assassin, Mage","Fighter, Tank","Mage, Support",0,1,1
2721,"Fighter, Mage","Fighter, Tank","Fighter, Assassin","Mage, Support",1,0,1
2722,"Fighter, Assassin","Tank, Support","Mage, Fighter","Fighter, Tank",0,1,1
8674,"Mage, Fighter","Assassin, Fighter",Fighter,"Mage, Fighter",0,1,1
8673,Fighter,"Assassin, Fighter","Assassin, Fighter",Mage,0,1,1
8170,Tank,"Fighter, Assassin",Fighter,"Fighter, Mage",1,0,1
8672,Marksman,"Mage, Assassin","Mage, Fighter","Fighter, Marksman",1,0,1
8650,"Tank, Fighter",Marksman,"Assassin, Fighter","Tank, Mage",0,1,1
8649,"Tank, Fighter","Tank, Mage","Mage, Fighter","Mage, Support",1,0,1
8173,"Fighter, Tank","Fighter, Mage",Fighter,"Fighter, Tank",1,0,1
8633,Marksman,"Assassin, Fighter","Support, Mage",Marksman,0,1,1
2755,"Assassin, Fighter","Fighter, Tank","Assassin, Mage","Mage, Assassin",1,0,1
8630,Marksman,"Assassin, Fighter","Fighter, Tank","Mage, Fighter",0,1,1
8629,"Assassin, Fighter",Mage,Marksman,Marksman,0,1,1
8628,"Mage, Fighter","Fighter, Marksman","Assassin, Fighter","Assassin, Mage",0,1,1
8627,"Assassin, Fighter","Mage, Assassin",Fighter,"Assassin, Fighter",1,0,1
8183,Fighter,Marksman,"Fighter, Tank","Mage, Fighter",1,0,1
8625,"Assassin, Fighter","Assassin, Fighter",Fighter,Marksman,1,0,1
8624,"Mage, Fighter","Fighter, Marksman",Marksman,Marksman,0,1,1
8184,"Assassin, Fighter","Mage, Fighter","Fighter, Tank",Fighter,1,0,1
2759,"Fighter, Mage","Tank, Fighter","Mage, Fighter","Tank, Support",1,0,1
8621,"Support, Mage","Mage, Support","Fighter, Tank","Mage, Support",0,1,1
2761,"Assassin, Fighter","Tank, Support","Support, Mage","Mage, Assassin",0,1,1
8619,"Assassin, Fighter","Assassin, Mage","Fighter, Mage",Marksman,1,0,1
8186,"Assassin, Fighter",Fighter,"Fighter, Mage",Marksman,1,0,1
8618,"Support, Mage","Mage, Support",Fighter,Marksman,1,0,1
8632,"Support, Mage",Mage,"Fighter, Assassin",Mage,0,1,1
2754,Marksman,"Mage, Assassin",Fighter,"Mage, Support",1,0,1
8174,Fighter,"Mage, Fighter","Fighter, Tank",Marksman,1,0,1
8635,"Assassin, Fighter",Marksman,Marksman,"Mage, Marksman",1,0,1
8175,"Support, Tank","Assassin, Fighter","Fighter, Tank","Fighter, Mage",1,0,1
2740,"Fighter, Mage","Support, Fighter","Fighter, Tank","Mage, Support",0,1,1
2743,"Fighter, Assassin","Support, Fighter",Marksman,"Mage, Support",1,0,1
8176,"Marksman, Assassin","Assassin, Fighter","Fighter, Tank","Mage, Fighter",0,1,1
8177,"Support, Tank","Fighter, Assassin",Tank,"Fighter, Mage",0,1,1
8644,Marksman,Marksman,"Fighter, Mage","Mage, Support",1,0,1
8178,"Fighter, Tank",Fighter,"Marksman, Assassin","Mage, Fighter",1,0,1
8179,"Support, Tank","Assassin, Fighter","Fighter, Tank",Fighter,0,1,1
8642,"Fighter, Assassin",Mage,Marksman,Marksman,1,0,1
8180,"Mage, Fighter","Assassin, Fighter","Fighter, Mage",Fighter,1,0,1
8641,"Fighter, Assassin",Marksman,Fighter,Mage,0,1,1
2748,"Assassin, Fighter","Mage, Support","Assassin, Mage","Mage, Assassin",1,0,1
8181,Fighter,"Tank, Fighter",Tank,Fighter,0,1,1
2750,"Mage, Fighter","Support, Mage","Assassin, Mage","Mage, Support",1,0,1
8636,"Support, Mage","Mage, Support",Fighter,"Mage, Fighter",0,1,1
8783,"Mage, Fighter","Mage, Fighter","Assassin, Mage",Mage,1,0,1
4218,"Fighter, Assassin","Tank, Support","Fighter, Tank","Support, Fighter",1,0,1
9133,"Tank, Fighter","Fighter, Mage","Fighter, Mage","Mage, Assassin",1,0,1
10443,"Assassin, Fighter",Mage,"Fighter, Tank","Mage, Tank",0,1,1
10452,"Tank, Fighter","Assassin, Mage","Fighter, Marksman","Mage, Support",1,0,1
10451,"Tank, Fighter",Mage,"Fighter, Assassin",Marksman,1,0,1
10450,Fighter,Marksman,"Mage, Fighter",Marksman,0,1,1
10449,Fighter,Marksman,"Mage, Fighter","Assassin, Mage",0,1,1
10448,"Fighter, Tank","Tank, Mage",Fighter,"Mage, Support",0,1,1
10447,"Tank, Fighter","Mage, Support","Fighter, Assassin",Marksman,1,0,1
10446,"Tank, Fighter","Tank, Mage","Fighter, Mage","Assassin, Mage",0,1,1
10445,"Mage, Fighter","Mage, Fighter",Marksman,"Fighter, Marksman",1,0,1
10444,"Fighter, Assassin","Assassin, Fighter",Marksman,"Assassin, Fighter",1,0,1
10442,"Fighter, Tank","Assassin, Fighter","Assassin, Fighter",Mage,1,0,1
10454,"Assassin, Fighter",Mage,"Tank, Fighter","Mage, Support",1,0,1
10441,Fighter,"Mage, Support","Fighter, Assassin","Mage, Marksman",0,1,1
10440,"Fighter, Assassin","Mage, Assassin","Mage, Fighter",Mage,0,1,1
10439,Marksman,"Mage, Assassin","Fighter, Assassin",Mage,0,1,1
10438,"Assassin, Fighter","Assassin, Fighter","Assassin, Fighter","Mage, Assassin",1,0,1
10437,"Fighter, Tank","Mage, Support","Assassin, Fighter","Fighter, Marksman",1,0,1
10436,Marksman,"Assassin, Fighter","Assassin, Fighter","Assassin, Fighter",1,0,1
10435,"Fighter, Assassin","Fighter, Marksman","Mage, Fighter",Mage,1,0,1
10434,"Mage, Fighter","Fighter, Marksman","Fighter, Assassin","Mage, Fighter",1,0,1
10433,"Assassin, Fighter","Fighter, Marksman","Assassin, Fighter","Mage, Support",1,0,1
10453,"Mage, Fighter",Mage,"Tank, Mage","Mage, Support",0,1,1
10455,"Fighter, Mage",Marksman,"Mage, Fighter","Tank, Mage",0,1,1
10380,"Support, Mage","Mage, Support",Marksman,"Mage, Fighter",1,0,1
10469,"Assassin, Fighter","Tank, Mage","Tank, Fighter",Mage,1,0,1
10480,"Assassin, Fighter","Assassin, Fighter",Fighter,Mage,1,0,1
10479,"Tank, Fighter","Support, Mage",Fighter,"Mage, Assassin",1,0,1
10478,Fighter,"Support, Mage","Fighter, Tank","Mage, Assassin",1,0,1
10477,Fighter,Mage,"Assassin, Fighter","Mage, Assassin",0,1,1
10475,"Assassin, Fighter","Mage, Assassin",Fighter,"Marksman, Mage",1,0,1
10474,"Fighter, Assassin","Fighter, Assassin",Fighter,"Assassin, Mage",0,1,1
10473,"Assassin, Fighter","Mage, Support","Tank, Fighter",Mage,0,1,1
10471,Fighter,"Mage, Assassin","Assassin, Fighter","Assassin, Mage",0,1,1
10470,"Fighter, Assassin","Assassin, Mage","Assassin, Fighter","Mage, Assassin",0,1,1
10468,Fighter,"Support, Mage","Tank, Fighter","Assassin, Mage",0,1,1
10456,"Mage, Fighter",Marksman,"Fighter, Tank","Mage, Support",0,1,1
10467,"Fighter, Mage","Tank, Mage","Fighter, Assassin",Mage,0,1,1
10466,"Assassin, Fighter","Mage, Support","Mage, Fighter","Assassin, Mage",1,0,1
10465,Fighter,"Tank, Mage","Assassin, Fighter","Fighter, Assassin",1,0,1
10464,"Assassin, Fighter","Tank, Mage","Fighter, Mage","Mage, Assassin",1,0,1
10461,"Tank, Fighter","Tank, Mage","Assassin, Fighter",Mage,1,0,1
10460,"Fighter, Assassin","Tank, Mage","Mage, Fighter","Mage, Assassin",0,1,1
10459,"Fighter, Tank","Tank, Mage","Fighter, Assassin",Mage,1,0,1
10458,"Mage, Fighter","Tank, Mage",Fighter,"Mage, Support",0,1,1
10457,"Fighter, Mage","Mage, Support",Fighter,"Tank, Mage",1,0,1
10431,"Mage, Fighter",Mage,Assassin,"Mage, Support",1,0,1
10430,"Assassin, Fighter","Mage, Assassin",Marksman,"Fighter, Marksman",1,0,1
10429,"Fighter, Mage","Assassin, Fighter","Mage, Fighter","Mage, Tank",0,1,1
10394,"Assassin, Fighter","Assassin, Mage",Marksman,Marksman,1,0,1
10404,"Fighter, Tank","Assassin, Mage","Fighter, Assassin",Marksman,1,0,1
10403,"Fighter, Assassin",Marksman,"Assassin, Fighter","Assassin, Fighter",0,1,1
10402,Fighter,"Assassin, Fighter",Marksman,"Mage, Support",1,0,1
10401,"Assassin, Fighter",Marksman,Fighter,"Mage, Marksman",1,0,1
10399,"Fighter, Assassin","Mage, Fighter",Fighter,Marksman,1,0,1
10398,Marksman,"Assassin, Fighter","Assassin, Fighter","Tank, Fighter",1,0,1
10397,"Assassin, Fighter","Tank, Fighter","Assassin, Fighter","Assassin, Fighter",0,1,1
10396,"Mage, Fighter","Mage, Marksman","Assassin, Fighter",Marksman,0,1,1
10395,"Assassin, Fighter","Mage, Fighter","Fighter, Assassin","Mage, Fighter",1,0,1
10393,"Assassin, Fighter","Fighter, Marksman","Support, Mage","Assassin, Mage",1,0,1
10428,"Mage, Fighter","Assassin, Fighter","Fighter, Mage","Mage, Assassin",1,0,1
10392,Marksman,Marksman,"Assassin, Fighter","Mage, Support",0,1,1
10391,"Assassin, Fighter","Fighter, Marksman","Fighter, Assassin","Mage, Fighter",0,1,1
10390,Assassin,Marksman,"Fighter, Assassin","Mage, Support",0,1,1
10389,"Assassin, Fighter","Fighter, Marksman","Assassin, Fighter",Marksman,1,0,1
10388,Fighter,Marksman,"Mage, Fighter","Fighter, Marksman",0,1,1
10387,"Assassin, Fighter","Mage, Fighter","Fighter, Tank","Assassin, Mage",0,1,1
10386,"Assassin, Fighter","Assassin, Fighter","Assassin, Fighter","Support, Mage",0,1,1
10384,"Assassin, Mage","Fighter, Marksman",Marksman,Mage,0,1,1
10383,Marksman,"Assassin, Mage","Assassin, Mage",Marksman,0,1,1
10405,"Mage, Fighter",Marksman,"Fighter, Assassin","Mage, Marksman",1,0,1
10406,"Fighter, Assassin","Mage, Support",Fighter,"Mage, Fighter",0,1,1
10407,"Mage, Fighter",Marksman,"Assassin, Fighter","Fighter, Marksman",0,1,1
10408,"Assassin, Fighter","Mage, Support","Support, Mage","Mage, Marksman",0,1,1
10427,"Fighter, Mage","Assassin, Fighter","Assassin, Fighter","Mage, Fighter",1,0,1
10426,Marksman,"Assassin, Fighter","Assassin, Mage","Assassin, Fighter",0,1,1
10425,"Fighter, Mage","Assassin, Fighter",Marksman,"Mage, Support",0,1,1
10424,Marksman,"Mage, Support","Support, Mage","Fighter, Marksman",0,1,1
10423,"Fighter, Tank","Fighter, Marksman","Assassin, Fighter","Mage, Support",0,1,1
10422,"Mage, Fighter","Fighter, Marksman","Fighter, Mage","Mage, Support",1,0,1
10421,"Assassin, Mage","Mage, Support","Fighter, Mage","Mage, Tank",0,1,1
10420,"Assassin, Fighter","Assassin, Fighter","Mage, Fighter","Fighter, Marksman",1,0,1
10419,"Fighter, Mage","Fighter, Marksman","Fighter, Assassin","Mage, Tank",0,1,1
10418,"Fighter, Mage","Fighter, Marksman","Assassin, Fighter","Mage, Assassin",1,0,1
10417,"Fighter, Assassin","Mage, Tank","Mage, Fighter","Fighter, Marksman",1,0,1
10416,"Assassin, Fighter",Marksman,"Assassin, Fighter","Mage, Fighter",1,0,1
10415,"Assassin, Fighter",Mage,"Assassin, Mage","Mage, Support",1,0,1
10414,"Assassin, Fighter","Mage, Support","Assassin, Mage",Marksman,1,0,1
10413,"Fighter, Assassin","Assassin, Fighter",Fighter,"Mage, Support",0,1,1
10412,"Assassin, Fighter","Mage, Support",Fighter,"Mage, Marksman",1,0,1
10411,"Assassin, Fighter","Assassin, Mage","Fighter, Tank","Mage, Support",1,0,1
10410,"Fighter, Tank","Mage, Support",Fighter,Marksman,0,1,1
10409,"Fighter, Assassin",Marksman,Marksman,"Mage, Fighter",1,0,1
10482,Fighter,"Assassin, Mage","Fighter, Assassin",Fighter,1,0,1
10483,Fighter,Marksman,"Tank, Mage","Mage, Support",0,1,1
10484,"Fighter, Mage","Mage, Support","Fighter, Mage",Marksman,1,0,1
10551,Fighter,"Assassin, Mage","Mage, Fighter","Assassin, Mage",0,1,1
10560,"Mage, Fighter","Marksman, Mage",Marksman,"Mage, Marksman",1,0,1
10559,"Mage, Fighter","Marksman, Mage",Marksman,Mage,1,0,1
10558,Marksman,"Mage, Assassin","Fighter, Assassin","Mage, Marksman",0,1,1
10557,Marksman,"Mage, Tank",Fighter,"Assassin, Mage",1,0,1
10556,Marksman,"Mage, Fighter",Fighter,"Assassin, Fighter",1,0,1
10555,Marksman,"Mage, Marksman",Fighter,"Assassin, Mage",0,1,1
10554,"Fighter, Mage","Mage, Fighter",Marksman,"Mage, Tank",1,0,1
10553,Marksman,"Mage, Tank",Fighter,"Mage, Fighter",0,1,1
10552,Fighter,Mage,Marksman,"Mage, Tank",1,0,1
10550,"Fighter, Assassin","Fighter, Mage","Fighter, Assassin","Mage, Assassin",0,1,1
10538,"Fighter, Mage",Mage,Marksman,"Tank, Mage",1,0,1
10549,Fighter,"Assassin, Fighter","Fighter, Assassin","Mage, Assassin",1,0,1
10548,Marksman,"Mage, Tank","Mage, Fighter",Mage,0,1,1
10547,"Fighter, Assassin","Assassin, Fighter","Assassin, Fighter","Mage, Tank",1,0,1
10546,"Assassin, Fighter","Assassin, Fighter","Mage, Fighter","Fighter, Assassin",1,0,1
10545,"Assassin, Fighter","Fighter, Marksman","Mage, Fighter","Mage, Support",1,0,1
10544,"Fighter, Assassin","Mage, Support","Assassin, Fighter","Mage, Tank",1,0,1
10542,"Support, Mage","Mage, Support","Fighter, Assassin",Mage,0,1,1
10541,"Assassin, Fighter","Assassin, Mage",Marksman,"Mage, Support",0,1,1
10540,Fighter,"Tank, Mage","Assassin, Fighter",Marksman,1,0,1
10561,Marksman,"Mage, Assassin",Marksman,Mage,1,0,1
10562,Fighter,"Marksman, Mage",Marksman,Mage,1,0,1
10563,Marksman,"Mage, Marksman","Fighter, Assassin","Support, Mage",1,0,1
10564,"Assassin, Fighter",Mage,"Fighter, Mage","Mage, Marksman",1,0,1
10587,"Fighter, Mage","Mage, Marksman","Mage, Fighter",Marksman,1,0,1
10586,Marksman,"Mage, Marksman","Tank, Fighter",Fighter,1,0,1
10585,"Fighter, Mage","Assassin, Mage","Mage, Fighter","Support, Mage",0,1,1
10583,Marksman,"Assassin, Mage","Mage, Fighter","Marksman, Fighter",0,1,1
10582,"Fighter, Mage","Assassin, Mage","Mage, Fighter",Fighter,1,0,1
10581,"Fighter, Mage","Mage, Marksman",Marksman,Marksman,1,0,1
10580,"Assassin, Fighter","Assassin, Fighter","Fighter, Mage","Marksman, Fighter",1,0,1
10579,"Fighter, Assassin","Assassin, Mage","Fighter, Mage",Mage,1,0,1
10578,Fighter,Mage,"Fighter, Mage","Marksman, Fighter",0,1,1
10577,"Mage, Fighter",Mage,"Fighter, Mage","Marksman, Fighter",1,0,1
10575,Marksman,"Tank, Fighter","Fighter, Mage","Mage, Support",1,0,1
10574,"Assassin, Fighter","Support, Mage","Mage, Fighter","Marksman, Fighter",0,1,1
10573,"Fighter, Mage","Tank, Fighter","Mage, Fighter","Support, Mage",1,0,1
10572,"Assassin, Fighter","Assassin, Fighter","Tank, Fighter",Fighter,1,0,1
10571,Fighter,"Tank, Fighter","Mage, Fighter","Support, Mage",1,0,1
10568,"Fighter, Tank","Mage, Tank",Marksman,"Mage, Support",0,1,1
10567,Marksman,"Mage, Support","Fighter, Tank","Assassin, Mage",0,1,1
10566,"Fighter, Mage","Mage, Tank",Marksman,"Assassin, Mage",0,1,1
10565,"Fighter, Mage",Mage,Marksman,"Assassin, Mage",0,1,1
10539,"Fighter, Assassin","Tank, Mage",Marksman,Mage,1,0,1
10537,"Fighter, Assassin","Tank, Mage","Fighter, Mage",Mage,0,1,1
10485,"Fighter, Mage",Marksman,"Mage, Fighter",Marksman,0,1,1
10499,"Mage, Fighter","Fighter, Marksman",Marksman,"Mage, Fighter",0,1,1
10511,"Mage, Fighter",Marksman,Marksman,"Mage, Fighter",0,1,1
10510,"Mage, Fighter",Marksman,Fighter,"Mage, Fighter",0,1,1
10509,Marksman,Marksman,"Assassin, Fighter","Assassin, Mage",1,0,1
10508,"Assassin, Fighter","Mage, Fighter","Fighter, Assassin","Fighter, Marksman",1,0,1
10506,"Assassin, Fighter","Mage, Tank","Mage, Fighter","Fighter, Marksman",0,1,1
10505,Marksman,"Assassin, Fighter","Assassin, Fighter","Mage, Tank",1,0,1
10504,"Assassin, Fighter","Mage, Tank","Fighter, Assassin",Mage,0,1,1
10502,Marksman,"Mage, Fighter","Fighter, Assassin",Mage,1,0,1
10501,Fighter,"Fighter, Marksman",Marksman,Marksman,0,1,1
10498,"Assassin, Fighter",Marksman,"Fighter, Tank",Mage,1,0,1
10536,"Support, Mage","Mage, Support",Marksman,Mage,0,1,1
10497,Marksman,"Support, Mage","Assassin, Fighter","Fighter, Marksman",1,0,1
10495,"Fighter, Assassin","Fighter, Marksman","Assassin, Fighter",Mage,1,0,1
10493,"Fighter, Mage","Assassin, Fighter","Tank, Fighter","Mage, Support",1,0,1
10492,"Tank, Fighter","Assassin, Mage","Tank, Mage","Assassin, Mage",1,0,1
10491,"Tank, Fighter","Tank, Mage","Fighter, Mage",Fighter,0,1,1
10489,"Mage, Fighter","Mage, Support","Tank, Fighter",Mage,1,0,1
10488,Fighter,"Tank, Mage","Fighter, Mage",Mage,0,1,1
10487,"Mage, Fighter","Mage, Assassin",Fighter,"Tank, Mage",1,0,1
10486,"Mage, Fighter","Tank, Mage",Fighter,Mage,1,0,1
10512,"Mage, Fighter","Fighter, Marksman","Assassin, Fighter",Mage,1,0,1
10514,"Assassin, Fighter",Marksman,"Mage, Fighter","Mage, Fighter",1,0,1
10515,"Assassin, Fighter","Mage, Marksman","Assassin, Fighter","Mage, Fighter",1,0,1
10516,"Assassin, Fighter","Support, Mage",Marksman,Marksman,1,0,1
10535,"Fighter, Assassin","Mage, Support","Fighter, Tank","Tank, Mage",1,0,1
10534,"Fighter, Assassin","Tank, Mage","Assassin, Fighter","Mage, Marksman",1,0,1
10533,"Assassin, Fighter","Tank, Mage","Fighter, Tank",Marksman,1,0,1
10532,"Fighter, Mage","Mage, Support","Fighter, Assassin","Fighter, Marksman",1,0,1
10531,"Mage, Fighter","Assassin, Mage","Fighter, Mage","Tank, Mage",0,1,1
10530,Marksman,"Mage, Fighter","Fighter, Assassin","Mage, Assassin",0,1,1
10529,"Assassin, Fighter","Assassin, Mage",Marksman,"Support, Mage",0,1,1
10528,"Fighter, Tank","Tank, Mage",Marksman,"Mage, Support",1,0,1
10527,"Fighter, Tank","Tank, Mage","Fighter, Mage","Mage, Support",0,1,1
10526,"Fighter, Assassin","Mage, Tank",Fighter,"Assassin, Mage",1,0,1
10525,Marksman,"Tank, Mage","Assassin, Fighter",Mage,1,0,1
10524,"Mage, Fighter","Tank, Mage","Fighter, Assassin",Marksman,1,0,1
10523,Fighter,"Mage, Support","Fighter, Assassin","Assassin, Mage",1,0,1
10522,"Assassin, Fighter","Assassin, Fighter",Marksman,"Support, Mage",0,1,1
10521,"Assassin, Fighter","Mage, Fighter","Assassin, Fighter","Fighter, Marksman",0,1,1
10520,"Assassin, Fighter",Marksman,"Assassin, Fighter","Support, Mage",1,0,1
10519,"Assassin, Fighter","Support, Mage","Assassin, Fighter","Fighter, Marksman",0,1,1
10518,"Fighter, Assassin","Mage, Assassin",Fighter,"Mage, Fighter",1,0,1
10517,"Assassin, Fighter","Assassin, Fighter","Fighter, Tank","Fighter, Marksman",1,0,1
10382,"Assassin, Mage","Assassin, Fighter","Fighter, Assassin","Fighter, Marksman",1,0,1
10379,Marksman,Marksman,"Support, Mage","Mage, Fighter",1,0,1
10154,"Assassin, Fighter","Fighter, Marksman",Fighter,"Mage, Fighter",1,0,1
10223,"Fighter, Mage","Assassin, Fighter","Mage, Fighter","Marksman, Mage",1,0,1
10235,"Fighter, Mage","Assassin, Mage","Fighter, Tank",Mage,1,0,1
10233,"Fighter, Assassin","Fighter, Assassin","Fighter, Mage","Assassin, Mage",0,1,1
10232,"Fighter, Tank","Mage, Fighter","Fighter, Mage",Mage,1,0,1
10231,Fighter,"Mage, Support","Fighter, Mage","Assassin, Fighter",1,0,1
10230,Fighter,"Mage, Support","Assassin, Fighter","Marksman, Assassin",1,0,1
10229,Fighter,"Mage, Tank","Tank, Fighter",Mage,0,1,1
10228,"Fighter, Mage","Mage, Support","Assassin, Fighter","Marksman, Mage",1,0,1
10226,"Fighter, Tank",Mage,"Assassin, Fighter","Mage, Tank",1,0,1
10224,"Assassin, Fighter","Mage, Marksman",Marksman,"Assassin, Fighter",1,0,1
10222,"Assassin, Fighter","Mage, Fighter",Marksman,"Assassin, Mage",0,1,1
10238,Marksman,"Mage, Fighter","Fighter, Mage","Mage, Assassin",1,0,1
10221,"Fighter, Mage",Marksman,Marksman,"Support, Mage",0,1,1
10220,"Assassin, Fighter","Assassin, Fighter","Fighter, Mage","Fighter, Marksman",1,0,1
10217,Marksman,"Assassin, Mage",Marksman,"Assassin, Mage",0,1,1
10216,"Fighter, Tank","Mage, Marksman","Fighter, Tank","Mage, Support",1,0,1
10214,"Fighter, Tank","Mage, Tank",Fighter,"Mage, Support",1,0,1
10213,"Fighter, Tank","Mage, Tank","Assassin, Fighter","Mage, Support",1,0,1
10211,Fighter,"Mage, Marksman",Marksman,"Support, Mage",1,0,1
10210,"Fighter, Mage",Mage,Fighter,"Mage, Fighter",1,0,1
10209,"Assassin, Fighter","Mage, Fighter",Fighter,"Mage, Marksman",1,0,1
10236,"Assassin, Fighter","Marksman, Mage","Fighter, Mage","Mage, Assassin",0,1,1
10239,"Fighter, Tank",Mage,"Mage, Fighter","Mage, Support",1,0,1
10378,"Fighter, Tank","Mage, Fighter",Marksman,Mage,1,0,1
10253,"Assassin, Fighter","Assassin, Mage","Mage, Fighter","Support, Mage",0,1,1
10263,"Assassin, Mage","Mage, Support","Fighter, Mage","Fighter, Assassin",0,1,1
10262,"Fighter, Mage","Fighter, Mage","Mage, Fighter","Fighter, Assassin",1,0,1
10261,"Mage, Fighter","Fighter, Mage","Fighter, Mage",Mage,0,1,1
10260,"Assassin, Mage","Mage, Support","Fighter, Mage","Support, Mage",1,0,1
10259,"Tank, Fighter",Mage,"Tank, Fighter",Marksman,0,1,1
10258,"Fighter, Mage","Mage, Assassin","Tank, Fighter","Fighter, Marksman",0,1,1
10257,"Fighter, Mage",Marksman,"Tank, Fighter","Marksman, Mage",0,1,1
10256,"Tank, Fighter","Fighter, Marksman","Fighter, Mage","Support, Mage",1,0,1
10255,"Tank, Fighter","Assassin, Fighter","Fighter, Assassin","Tank, Mage",0,1,1
10252,"Assassin, Mage","Mage, Marksman","Assassin, Fighter","Support, Mage",0,1,1
10240,Fighter,Mage,"Fighter, Tank","Mage, Tank",0,1,1
10251,"Assassin, Mage","Fighter, Marksman","Mage, Fighter","Mage, Assassin",0,1,1
10250,"Mage, Fighter","Support, Mage","Assassin, Fighter","Mage, Marksman",0,1,1
10249,"Fighter, Mage","Mage, Marksman","Assassin, Mage","Mage, Assassin",1,0,1
10248,"Fighter, Tank","Mage, Assassin",Fighter,"Support, Mage",0,1,1
10246,Fighter,"Mage, Assassin","Fighter, Tank","Support, Mage",0,1,1
10245,"Fighter, Tank","Support, Mage","Fighter, Mage","Mage, Assassin",1,0,1
10244,Fighter,"Mage, Fighter","Fighter, Tank","Mage, Support",0,1,1
10243,"Fighter, Mage","Mage, Assassin",Fighter,"Mage, Assassin",1,0,1
10241,Fighter,"Mage, Assassin","Fighter, Tank","Mage, Assassin",1,0,1
10208,Marksman,"Assassin, Fighter",Fighter,Mage,0,1,1
10207,Fighter,"Mage, Fighter",Marksman,"Mage, Support",1,0,1
10206,Marksman,"Assassin, Fighter",Fighter,"Support, Mage",0,1,1
10167,"Assassin, Fighter","Mage, Support","Mage, Fighter","Fighter, Marksman",1,0,1
10176,Fighter,"Mage, Assassin","Fighter, Mage","Mage, Fighter",1,0,1
10175,"Assassin, Fighter","Assassin, Mage","Support, Mage","Fighter, Tank",1,0,1
10174,"Support, Mage","Mage, Assassin",Marksman,"Mage, Assassin",1,0,1
10173,"Fighter, Tank","Fighter, Marksman","Support, Mage","Assassin, Fighter",1,0,1
10172,Marksman,"Mage, Marksman","Support, Mage","Mage, Fighter",1,0,1
10171,"Support, Mage","Assassin, Mage","Fighter, Assassin","Mage, Assassin",1,0,1
10170,"Fighter, Assassin","Assassin, Mage",Marksman,"Mage, Fighter",1,0,1
10169,"Fighter, Tank","Mage, Marksman",Marksman,"Mage, Fighter",0,1,1
10168,Marksman,"Fighter, Marksman","Mage, Fighter","Mage, Support",0,1,1
10165,"Fighter, Assassin","Marksman, Mage","Assassin, Fighter",Mage,1,0,1
10204,Fighter,"Mage, Marksman",Marksman,"Mage, Tank",1,0,1
10164,Fighter,"Mage, Fighter",Marksman,Marksman,1,0,1
10163,"Assassin, Fighter","Mage, Fighter","Assassin, Fighter","Mage, Support",1,0,1
10162,"Assassin, Fighter",Marksman,"Fighter, Tank","Assassin, Mage",1,0,1
10161,"Support, Mage",Marksman,"Mage, Fighter","Assassin, Mage",1,0,1
10160,"Support, Mage","Mage, Fighter","Assassin, Fighter",Mage,1,0,1
10159,Fighter,"Mage, Fighter","Support, Mage","Mage, Support",1,0,1
10158,"Assassin, Fighter","Mage, Fighter","Support, Mage","Fighter, Tank",0,1,1
10157,"Assassin, Fighter",Marksman,"Support, Mage","Mage, Fighter",0,1,1
10156,"Support, Mage",Mage,"Fighter, Mage","Mage, Fighter",1,0,1
10177,"Fighter, Mage","Mage, Fighter","Assassin, Fighter","Mage, Support",1,0,1
10178,"Mage, Fighter","Mage, Fighter",Fighter,"Mage, Support",0,1,1
10179,Fighter,"Assassin, Fighter","Fighter, Mage","Mage, Tank",0,1,1
10181,Fighter,Mage,"Mage, Fighter","Mage, Tank",0,1,1
10203,Marksman,"Mage, Fighter",Marksman,"Mage, Tank",1,0,1
10201,"Assassin, Fighter","Mage, Fighter","Fighter, Mage","Mage, Tank",1,0,1
10200,"Fighter, Mage","Mage, Marksman","Assassin, Fighter","Mage, Fighter",1,0,1
10198,"Mage, Fighter","Mage, Support","Fighter, Tank",Mage,1,0,1
10197,"Mage, Fighter",Mage,"Fighter, Tank",Mage,1,0,1
10196,Fighter,"Mage, Tank","Fighter, Tank","Mage, Marksman",1,0,1
10195,"Fighter, Tank",Mage,"Assassin, Fighter","Mage, Support",0,1,1
10194,"Fighter, Assassin","Assassin, Mage",Fighter,"Mage, Fighter",1,0,1
10193,"Support, Mage","Assassin, Mage","Assassin, Fighter",Mage,0,1,1
10192,"Fighter, Tank",Mage,"Fighter, Mage","Mage, Fighter",0,1,1
10191,"Fighter, Tank","Fighter, Marksman","Tank, Fighter","Mage, Fighter",0,1,1
10190,"Assassin, Fighter",Marksman,"Support, Mage","Fighter, Marksman",1,0,1
10189,"Assassin, Fighter",Fighter,"Fighter, Tank","Assassin, Mage",1,0,1
10188,Fighter,"Mage, Support","Assassin, Fighter","Mage, Fighter",0,1,1
10186,Fighter,"Assassin, Mage","Assassin, Fighter",Marksman,1,0,1
10185,"Support, Mage","Mage, Fighter",Fighter,"Marksman, Mage",1,0,1
10184,"Fighter, Assassin","Mage, Fighter",Fighter,"Mage, Support",1,0,1
10183,"Assassin, Fighter","Mage, Support",Fighter,"Assassin, Fighter",1,0,1
10182,"Mage, Fighter","Mage, Assassin","Fighter, Mage","Mage, Tank",1,0,1
10264,"Fighter, Mage","Mage, Marksman","Mage, Fighter","Marksman, Mage",1,0,1
10265,"Mage, Fighter","Mage, Marksman","Fighter, Assassin","Assassin, Fighter",1,0,1
10267,"Tank, Mage","Fighter, Assassin","Fighter, Mage",Mage,0,1,1
10341,"Support, Mage","Mage, Support","Assassin, Fighter","Mage, Assassin",0,1,1
10351,Marksman,"Assassin, Mage","Mage, Fighter","Mage, Support",1,0,1
10350,"Fighter, Assassin","Fighter, Assassin","Assassin, Fighter","Tank, Mage",1,0,1
10349,"Mage, Fighter","Tank, Mage","Assassin, Fighter",Mage,1,0,1
10347,"Support, Mage",Marksman,"Fighter, Assassin",Mage,0,1,1
10346,"Mage, Fighter","Tank, Mage","Fighter, Assassin","Mage, Support",0,1,1
10345,"Fighter, Tank","Tank, Mage","Assassin, Fighter","Mage, Assassin",1,0,1
10344,"Fighter, Tank","Assassin, Fighter","Fighter, Assassin","Mage, Support",0,1,1
10343,"Fighter, Assassin","Mage, Assassin","Fighter, Tank","Tank, Mage",1,0,1
10342,"Support, Mage","Assassin, Mage","Tank, Fighter","Mage, Support",1,0,1
10340,"Fighter, Mage","Mage, Assassin","Mage, Fighter","Assassin, Fighter",1,0,1
10325,Marksman,Marksman,"Mage, Fighter","Mage, Assassin",1,0,1
10339,"Tank, Fighter","Mage, Assassin",Marksman,"Mage, Support",1,0,1
10338,"Tank, Fighter",Marksman,Fighter,"Mage, Assassin",0,1,1
10337,Fighter,Marksman,"Fighter, Mage","Assassin, Mage",0,1,1
10335,"Fighter, Mage",Marksman,"Fighter, Tank",Mage,0,1,1
10334,Fighter,Marksman,"Fighter, Mage","Tank, Mage",0,1,1
10333,"Tank, Fighter",Marksman,"Fighter, Assassin","Mage, Support",1,0,1
10332,"Fighter, Mage","Tank, Mage","Assassin, Fighter","Mage, Support",1,0,1
10331,"Fighter, Assassin","Assassin, Mage","Assassin, Fighter","Tank, Mage",0,1,1
10330,Fighter,"Mage, Fighter","Assassin, Fighter",Mage,1,0,1
10352,"Tank, Fighter",Mage,"Fighter, Tank",Marksman,1,0,1
10353,"Tank, Mage","Mage, Support","Fighter, Assassin",Marksman,1,0,1
10354,"Assassin, Fighter","Tank, Mage","Fighter, Mage",Marksman,1,0,1
10356,"Tank, Fighter",Marksman,"Tank, Fighter","Assassin, Mage",1,0,1
10376,Fighter,"Mage, Fighter","Assassin, Fighter","Assassin, Mage",0,1,1
10375,"Assassin, Fighter","Fighter, Marksman","Mage, Fighter",Marksman,1,0,1
10374,"Assassin, Fighter","Assassin, Mage","Mage, Fighter",Marksman,0,1,1
10373,"Fighter, Assassin","Fighter, Marksman",Marksman,Marksman,0,1,1
10372,"Mage, Fighter","Assassin, Mage","Support, Mage",Marksman,0,1,1
10371,"Fighter, Assassin",Marksman,"Mage, Fighter","Tank, Mage",0,1,1
10370,"Tank, Fighter",Mage,"Tank, Mage",Mage,0,1,1
10369,Fighter,"Mage, Support","Tank, Mage",Mage,1,0,1
10368,"Assassin, Fighter",Marksman,"Tank, Mage","Mage, Support",0,1,1
10367,"Tank, Fighter","Fighter, Marksman","Fighter, Assassin","Mage, Support",1,0,1
10366,"Fighter, Mage","Mage, Support","Tank, Mage","Mage, Tank",1,0,1
10365,"Tank, Mage","Assassin, Mage","Fighter, Assassin","Mage, Support",1,0,1
10364,"Tank, Mage","Mage, Support",Marksman,Mage,1,0,1
10363,"Tank, Fighter","Mage, Assassin",Marksman,Mage,0,1,1
10362,"Mage, Fighter","Mage, Support","Fighter, Mage","Fighter, Marksman",1,0,1
10361,"Tank, Fighter",Mage,"Mage, Fighter",Mage,1,0,1
10359,"Tank, Fighter","Marksman, Mage","Fighter, Mage",Marksman,0,1,1
10358,"Tank, Mage",Mage,"Fighter, Mage",Mage,0,1,1
10357,"Mage, Fighter","Mage, Support","Fighter, Mage","Assassin, Mage",0,1,1
10326,"Tank, Fighter","Tank, Mage","Tank, Fighter","Fighter, Assassin",1,0,1
10324,Fighter,"Assassin, Mage","Mage, Fighter",Marksman,1,0,1
10268,"Tank, Mage","Fighter, Mage","Fighter, Mage",Mage,0,1,1
10282,"Assassin, Fighter","Mage, Support","Fighter, Assassin","Fighter, Mage",1,0,1
10293,"Mage, Fighter",Mage,"Tank, Fighter",Mage,1,0,1
10291,"Assassin, Fighter",Mage,"Tank, Fighter",Mage,1,0,1
10290,"Fighter, Assassin",Mage,"Tank, Fighter","Fighter, Marksman",0,1,1
10289,"Tank, Fighter","Marksman, Mage","Tank, Fighter","Mage, Tank",0,1,1
10287,Fighter,"Assassin, Fighter","Fighter, Assassin","Mage, Tank",1,0,1
10286,"Tank, Fighter","Mage, Tank",Fighter,"Mage, Support",0,1,1
10285,"Fighter, Mage","Mage, Marksman","Fighter, Assassin",Mage,1,0,1
10284,"Tank, Fighter","Support, Mage","Fighter, Mage","Fighter, Marksman",0,1,1
10283,"Fighter, Mage","Tank, Fighter","Mage, Fighter","Fighter, Assassin",0,1,1
10280,"Fighter, Assassin","Mage, Assassin","Fighter, Mage",Mage,1,0,1
10323,"Assassin, Fighter","Support, Mage","Mage, Fighter",Marksman,1,0,1
10279,"Fighter, Tank","Mage, Assassin","Assassin, Mage","Assassin, Fighter",1,0,1
10278,"Fighter, Assassin","Fighter, Mage",Fighter,"Mage, Assassin",0,1,1
10277,"Assassin, Mage","Fighter, Marksman","Fighter, Mage","Marksman, Mage",0,1,1
10276,"Assassin, Fighter","Mage, Marksman","Fighter, Assassin","Marksman, Mage",0,1,1
10275,"Assassin, Fighter","Mage, Support","Assassin, Mage","Mage, Marksman",0,1,1
10274,"Assassin, Fighter",Mage,"Fighter, Mage","Marksman, Mage",0,1,1
10271,"Assassin, Mage","Fighter, Mage","Fighter, Mage","Mage, Support",0,1,1
10270,"Assassin, Fighter","Fighter, Assassin","Fighter, Mage",Mage,0,1,1
10269,"Assassin, Fighter",Mage,"Fighter, Mage","Fighter, Assassin",1,0,1
10295,"Fighter, Mage","Assassin, Mage","Fighter, Assassin",Marksman,0,1,1
10296,"Mage, Fighter","Support, Mage","Fighter, Mage","Marksman, Mage",0,1,1
10298,"Fighter, Mage","Mage, Support","Fighter, Tank","Assassin, Mage",0,1,1
10299,"Mage, Fighter","Support, Mage","Fighter, Mage",Fighter,0,1,1
10322,"Tank, Fighter",Marksman,Fighter,Mage,1,0,1
10320,Marksman,Marksman,"Assassin, Mage",Fighter,1,0,1
10318,"Fighter, Mage","Mage, Support","Fighter, Mage","Mage, Support",0,1,1
10317,"Fighter, Assassin",Fighter,"Mage, Fighter","Mage, Support",0,1,1
10316,"Fighter, Mage","Assassin, Mage","Fighter, Assassin",Mage,0,1,1
10315,Marksman,"Assassin, Mage","Assassin, Fighter",Fighter,0,1,1
10314,"Tank, Fighter",Mage,"Assassin, Fighter",Marksman,1,0,1
10313,"Mage, Fighter","Mage, Assassin","Tank, Fighter",Mage,1,0,1
10312,"Fighter, Assassin","Support, Mage","Assassin, Fighter","Marksman, Mage",1,0,1
10311,Fighter,"Mage, Fighter","Mage, Fighter",Marksman,0,1,1
10310,"Assassin, Fighter","Marksman, Mage","Assassin, Fighter","Assassin, Fighter",0,1,1
10309,"Mage, Fighter","Mage, Assassin","Assassin, Fighter","Marksman, Mage",0,1,1
10308,"Fighter, Tank",Marksman,"Mage, Fighter","Support, Mage",0,1,1
10307,"Fighter, Assassin","Assassin, Mage","Fighter, Mage",Marksman,1,0,1
10306,Fighter,"Assassin, Fighter","Fighter, Assassin","Mage, Marksman",1,0,1
10305,"Assassin, Fighter","Mage, Marksman","Fighter, Mage",Fighter,1,0,1
10303,Marksman,Mage,Fighter,Fighter,1,0,1
10302,Fighter,"Mage, Marksman","Fighter, Tank","Assassin, Mage",0,1,1
10301,"Fighter, Tank","Marksman, Mage",Fighter,"Assassin, Fighter",0,1,1
10588,"Fighter, Mage","Mage, Marksman","Mage, Fighter","Fighter, Marksman",1,0,1
10589,"Fighter, Mage","Support, Mage",Marksman,"Assassin, Fighter",0,1,1
10590,"Fighter, Mage",Marksman,"Tank, Fighter",Fighter,1,0,1
10861,"Fighter, Assassin",Mage,"Fighter, Assassin","Assassin, Mage",1,0,1
10870,Fighter,"Marksman, Mage","Fighter, Mage","Mage, Assassin",0,1,1
10869,Marksman,"Mage, Assassin","Mage, Fighter","Marksman, Mage",0,1,1
10868,"Assassin, Fighter","Marksman, Mage",Fighter,"Assassin, Mage",1,0,1
10867,"Fighter, Assassin",Marksman,Marksman,"Support, Mage",1,0,1
10866,"Assassin, Fighter","Fighter, Marksman","Mage, Fighter",Mage,0,1,1
10865,"Tank, Fighter","Support, Mage","Fighter, Assassin","Assassin, Mage",1,0,1
10864,"Fighter, Assassin","Marksman, Mage","Tank, Fighter",Mage,0,1,1
10863,"Tank, Fighter","Assassin, Mage","Fighter, Assassin","Support, Mage",1,0,1
10862,"Tank, Fighter","Mage, Assassin","Tank, Fighter","Marksman, Mage",1,0,1
10860,"Assassin, Fighter","Mage, Assassin","Fighter, Assassin","Marksman, Mage",0,1,1
10872,"Fighter, Mage","Mage, Tank",Marksman,"Mage, Fighter",0,1,1
10859,"Tank, Fighter","Marksman, Mage","Assassin, Fighter","Assassin, Mage",1,0,1
10858,"Tank, Fighter","Assassin, Mage","Fighter, Assassin","Mage, Assassin",1,0,1
10857,"Fighter, Assassin","Fighter, Marksman","Tank, Fighter","Mage, Assassin",0,1,1
10856,Fighter,"Mage, Marksman","Tank, Fighter","Mage, Support",1,0,1
10855,"Tank, Fighter","Marksman, Mage","Fighter, Assassin","Assassin, Mage",0,1,1
10854,"Tank, Fighter","Marksman, Mage",Fighter,"Mage, Support",1,0,1
10853,Fighter,"Assassin, Mage","Assassin, Fighter","Support, Mage",1,0,1
10852,"Assassin, Fighter","Tank, Fighter",Fighter,"Mage, Assassin",1,0,1
10851,"Tank, Fighter","Marksman, Mage",Fighter,"Mage, Assassin",0,1,1
10871,Marksman,"Mage, Tank",Fighter,Mage,1,0,1
10873,"Fighter, Tank","Mage, Support","Fighter, Mage","Mage, Marksman",0,1,1
10591,Marksman,"Assassin, Mage","Fighter, Tank","Mage, Support",1,0,1
10887,Fighter,"Assassin, Mage","Mage, Fighter","Marksman, Mage",1,0,1
10896,Fighter,Mage,"Tank, Mage","Marksman, Mage",1,0,1
10895,Fighter,"Mage, Marksman","Fighter, Mage","Mage, Tank",0,1,1
10894,"Fighter, Mage","Assassin, Mage","Mage, Fighter","Mage, Marksman",0,1,1
10893,Marksman,"Assassin, Mage",Marksman,"Mage, Tank",0,1,1
10892,"Mage, Fighter","Mage, Tank",Fighter,"Support, Mage",1,0,1
10891,Marksman,"Mage, Fighter","Assassin, Fighter","Marksman, Mage",0,1,1
10890,"Mage, Fighter","Mage, Fighter","Assassin, Fighter","Mage, Marksman",1,0,1
10889,"Mage, Fighter","Mage, Support",Marksman,"Marksman, Mage",1,0,1
10888,"Fighter, Assassin",Mage,"Mage, Fighter","Mage, Marksman",0,1,1
10886,"Assassin, Fighter","Mage, Tank",Marksman,"Assassin, Mage",1,0,1
10874,Marksman,"Mage, Fighter","Fighter, Mage",Mage,0,1,1
10885,"Fighter, Mage","Mage, Fighter","Mage, Fighter","Mage, Marksman",1,0,1
10884,"Assassin, Fighter",Mage,"Fighter, Tank","Assassin, Mage",0,1,1
10883,"Fighter, Mage","Mage, Fighter","Fighter, Tank","Mage, Tank",1,0,1
10881,"Fighter, Mage","Marksman, Mage","Mage, Fighter","Mage, Support",1,0,1
10880,"Tank, Fighter","Mage, Marksman",Fighter,"Mage, Tank",0,1,1
10879,"Fighter, Mage","Mage, Marksman","Mage, Fighter","Mage, Support",0,1,1
10878,"Mage, Fighter","Assassin, Mage","Fighter, Tank",Mage,0,1,1
10877,"Assassin, Fighter","Marksman, Mage","Mage, Fighter","Mage, Assassin",0,1,1
10876,"Fighter, Mage","Marksman, Mage","Fighter, Tank",Mage,1,0,1
10850,"Tank, Fighter","Marksman, Mage","Assassin, Fighter","Support, Mage",1,0,1
10849,"Tank, Fighter","Mage, Assassin","Fighter, Assassin","Support, Mage",1,0,1
10848,"Tank, Fighter","Assassin, Mage",Fighter,"Mage, Marksman",0,1,1
10812,"Fighter, Assassin","Assassin, Mage","Mage, Fighter","Mage, Assassin",1,0,1
10822,"Tank, Fighter","Mage, Support","Tank, Fighter","Mage, Tank",0,1,1
10821,"Fighter, Mage",Mage,"Support, Mage","Mage, Support",1,0,1
10820,"Assassin, Fighter","Fighter, Marksman","Tank, Fighter","Assassin, Mage",0,1,1
10819,Fighter,"Mage, Marksman","Tank, Fighter","Assassin, Mage",1,0,1
10818,"Tank, Fighter","Mage, Assassin","Fighter, Assassin","Fighter, Marksman",0,1,1
10816,"Fighter, Mage",Marksman,"Support, Mage",Mage,0,1,1
10815,"Tank, Fighter",Mage,"Tank, Fighter","Support, Mage",1,0,1
10814,"Tank, Fighter","Mage, Marksman","Fighter, Mage","Mage, Tank",1,0,1
10813,"Tank, Fighter","Mage, Assassin","Fighter, Mage","Mage, Tank",0,1,1
10811,"Fighter, Assassin","Mage, Support","Fighter, Assassin",Mage,0,1,1
10847,"Tank, Fighter","Mage, Tank","Fighter, Assassin","Mage, Assassin",1,0,1
10810,"Tank, Fighter","Fighter, Marksman","Assassin, Fighter","Support, Mage",0,1,1
10809,"Tank, Fighter","Support, Mage","Tank, Fighter","Marksman, Mage",0,1,1
10808,Fighter,"Mage, Assassin","Fighter, Mage","Assassin, Mage",0,1,1
10807,"Fighter, Mage","Support, Mage","Assassin, Mage","Marksman, Mage",0,1,1
10806,"Assassin, Mage","Marksman, Mage",Fighter,"Marksman, Mage",0,1,1
10805,"Fighter, Assassin",Mage,"Assassin, Mage",Mage,1,0,1
10804,"Fighter, Assassin",Mage,"Assassin, Mage","Mage, Marksman",1,0,1
10803,Fighter,"Mage, Marksman","Fighter, Mage","Fighter, Marksman",1,0,1
10802,"Assassin, Mage","Support, Mage",Fighter,"Mage, Marksman",0,1,1
10823,"Support, Mage","Mage, Support","Fighter, Assassin","Marksman, Mage",1,0,1
10824,"Mage, Support","Fighter, Assassin","Support, Mage","Marksman, Assassin",0,1,1
10825,"Fighter, Assassin","Assassin, Mage","Tank, Mage","Assassin, Mage",0,1,1
10826,"Tank, Fighter","Mage, Support","Fighter, Tank","Tank, Mage",0,1,1
10846,"Tank, Fighter","Tank, Mage","Assassin, Fighter","Support, Mage",1,0,1
10845,"Fighter, Mage",Mage,"Assassin, Mage","Mage, Assassin",0,1,1
10844,"Assassin, Mage","Assassin, Mage","Tank, Fighter","Fighter, Marksman",0,1,1
10843,"Fighter, Mage","Mage, Tank","Tank, Fighter",Mage,0,1,1
10842,"Tank, Fighter","Mage, Marksman","Fighter, Assassin",Mage,1,0,1
10841,"Fighter, Tank","Fighter, Mage","Tank, Fighter","Marksman, Mage",1,0,1
10840,"Tank, Fighter","Mage, Assassin",Fighter,"Tank, Mage",0,1,1
10839,"Fighter, Assassin","Assassin, Mage","Tank, Fighter","Fighter, Mage",1,0,1
10838,"Assassin, Fighter","Assassin, Mage","Tank, Fighter","Tank, Fighter",0,1,1
10837,"Fighter, Assassin","Tank, Fighter","Tank, Fighter","Mage, Tank",0,1,1
10836,"Tank, Fighter","Mage, Tank","Tank, Fighter","Mage, Marksman",1,0,1
10835,"Tank, Fighter",Mage,"Tank, Fighter","Fighter, Marksman",1,0,1
10834,"Fighter, Assassin","Mage, Tank","Tank, Fighter","Support, Mage",0,1,1
10833,"Tank, Fighter","Mage, Tank","Tank, Fighter","Assassin, Fighter",1,0,1
10832,"Tank, Fighter","Tank, Mage",Fighter,"Mage, Marksman",0,1,1
10831,"Tank, Fighter","Tank, Mage",Fighter,Mage,1,0,1
10830,"Tank, Fighter","Marksman, Mage","Fighter, Assassin","Mage, Support",1,0,1
10829,"Tank, Fighter",Mage,"Fighter, Assassin","Marksman, Mage",0,1,1
10827,"Fighter, Assassin","Assassin, Mage","Fighter, Mage","Mage, Support",1,0,1
10897,Marksman,"Mage, Tank",Marksman,"Mage, Fighter",1,0,1
10898,"Fighter, Mage","Mage, Marksman",Marksman,"Mage, Fighter",0,1,1
10899,Marksman,"Mage, Tank",Marksman,"Mage, Support",0,1,1
10960,Fighter,"Mage, Fighter","Assassin, Fighter","Support, Mage",0,1,1
10970,"Tank, Mage","Marksman, Mage",Fighter,Mage,1,0,1
10969,Marksman,Marksman,Fighter,"Assassin, Fighter",1,0,1
10968,"Fighter, Assassin",Marksman,"Mage, Fighter","Mage, Marksman",1,0,1
10967,"Assassin, Fighter","Marksman, Mage",Marksman,"Assassin, Mage",0,1,1
10966,"Assassin, Fighter","Marksman, Mage","Assassin, Fighter","Assassin, Mage",1,0,1
10965,"Mage, Fighter",Mage,Marksman,Fighter,0,1,1
10964,"Assassin, Fighter","Mage, Marksman","Mage, Fighter","Tank, Fighter",0,1,1
10963,"Assassin, Fighter",Marksman,"Mage, Fighter","Mage, Marksman",0,1,1
10962,"Assassin, Fighter","Assassin, Mage","Mage, Fighter","Mage, Marksman",0,1,1
10959,Fighter,"Assassin, Fighter","Mage, Fighter","Support, Mage",0,1,1
10948,"Fighter, Mage",Mage,"Assassin, Fighter","Marksman, Fighter",0,1,1
10958,Marksman,Marksman,"Mage, Fighter",Mage,0,1,1
10957,Fighter,Marksman,"Assassin, Fighter","Support, Mage",1,0,1
10956,Marksman,Fighter,"Mage, Fighter",Marksman,0,1,1
10955,"Fighter, Assassin",Mage,Marksman,"Mage, Support",1,0,1
10954,Marksman,Fighter,"Mage, Fighter",Mage,0,1,1
10953,"Fighter, Assassin",Marksman,"Mage, Fighter","Assassin, Mage",1,0,1
10952,"Fighter, Assassin","Marksman, Mage",Fighter,Mage,0,1,1
10951,"Assassin, Fighter",Marksman,"Mage, Fighter","Marksman, Mage",1,0,1
10950,"Assassin, Fighter","Marksman, Mage","Fighter, Mage","Support, Mage",1,0,1
10972,Fighter,"Assassin, Fighter","Mage, Fighter","Mage, Marksman",1,0,1
10973,"Mage, Fighter","Marksman, Mage",Marksman,"Assassin, Mage",1,0,1
10974,"Assassin, Fighter",Fighter,Marksman,"Support, Mage",1,0,1
10975,Marksman,"Support, Mage",Marksman,"Assassin, Mage",1,0,1
10994,Marksman,"Mage, Marksman","Fighter, Mage","Fighter, Assassin",1,0,1
10993,"Mage, Fighter",Marksman,"Fighter, Mage","Support, Mage",0,1,1
10992,Marksman,"Marksman, Mage","Fighter, Assassin",Mage,1,0,1
10991,"Fighter, Mage","Marksman, Mage","Mage, Fighter",Mage,1,0,1
10990,"Fighter, Mage","Marksman, Mage",Marksman,"Assassin, Fighter",0,1,1
10989,"Fighter, Mage","Mage, Marksman",Marksman,"Marksman, Mage",0,1,1
10988,"Fighter, Assassin","Assassin, Mage","Fighter, Mage","Mage, Marksman",1,0,1
10987,"Fighter, Mage","Mage, Marksman",Marksman,"Support, Mage",1,0,1
10986,"Fighter, Mage",Fighter,Marksman,"Support, Mage",1,0,1
10985,Marksman,"Marksman, Mage","Mage, Fighter","Support, Mage",0,1,1
10984,"Assassin, Fighter","Support, Mage","Fighter, Mage","Mage, Marksman",1,0,1
10983,Marksman,Marksman,"Mage, Fighter","Mage, Marksman",0,1,1
10982,"Tank, Fighter",Mage,"Mage, Fighter","Marksman, Fighter",0,1,1
10981,"Mage, Fighter",Marksman,Marksman,"Marksman, Fighter",0,1,1
10980,"Mage, Fighter","Support, Mage",Marksman,Fighter,1,0,1
10979,Marksman,"Assassin, Mage","Fighter, Mage","Assassin, Fighter",1,0,1
10978,Marksman,"Marksman, Mage",Marksman,"Support, Mage",1,0,1
10977,"Fighter, Mage","Assassin, Mage","Mage, Fighter","Marksman, Mage",1,0,1
10976,"Mage, Fighter","Fighter, Marksman",Marksman,"Marksman, Mage",1,0,1
10949,Marksman,"Support, Mage","Mage, Fighter",Marksman,1,0,1
10947,"Mage, Fighter",Marksman,"Assassin, Fighter","Support, Mage",1,0,1
10900,"Fighter, Mage","Assassin, Mage",Fighter,"Mage, Marksman",1,0,1
10912,Marksman,"Marksman, Mage",Fighter,Mage,0,1,1
10921,"Assassin, Fighter",Marksman,"Mage, Fighter","Support, Mage",0,1,1
10920,Marksman,"Assassin, Fighter",Marksman,Marksman,1,0,1
10919,Marksman,"Support, Mage",Marksman,Marksman,1,0,1
10918,"Mage, Fighter",Marksman,Marksman,"Mage, Marksman",1,0,1
10917,"Mage, Fighter","Mage, Tank",Marksman,Mage,1,0,1
10916,"Mage, Fighter",Mage,"Fighter, Mage","Fighter, Assassin",0,1,1
10915,"Fighter, Mage","Mage, Tank","Fighter, Tank","Mage, Support",1,0,1
10914,"Assassin, Fighter","Marksman, Mage","Mage, Fighter","Mage, Tank",1,0,1
10913,"Mage, Fighter","Mage, Assassin",Marksman,Mage,0,1,1
10911,Marksman,"Assassin, Mage","Fighter, Tank","Mage, Assassin",0,1,1
10946,"Assassin, Fighter","Fighter, Marksman","Mage, Fighter","Assassin, Mage",0,1,1
10910,"Fighter, Mage","Mage, Fighter",Fighter,"Mage, Assassin",0,1,1
10909,Fighter,"Fighter, Marksman","Mage, Fighter","Mage, Fighter",0,1,1
10907,"Fighter, Tank","Fighter, Marksman","Assassin, Fighter",Marksman,0,1,1
10906,"Mage, Fighter","Mage, Fighter","Fighter, Assassin","Assassin, Mage",0,1,1
10905,"Fighter, Assassin","Assassin, Fighter","Assassin, Fighter",Marksman,0,1,1
10904,"Fighter, Mage","Marksman, Mage",Fighter,"Mage, Assassin",0,1,1
10903,"Fighter, Tank","Mage, Support",Marksman,"Mage, Fighter",1,0,1
10902,Marksman,"Assassin, Mage",Fighter,"Mage, Marksman",0,1,1
10901,"Mage, Fighter","Mage, Assassin","Fighter, Tank","Mage, Support",0,1,1
10923,"Assassin, Fighter","Support, Mage",Marksman,"Mage, Marksman",0,1,1
10924,Fighter,"Mage, Tank","Fighter, Mage","Mage, Fighter",0,1,1
10925,"Fighter, Tank","Mage, Support","Fighter, Mage","Mage, Tank",1,0,1
10926,"Mage, Fighter","Mage, Fighter",Fighter,"Marksman, Mage",1,0,1
10945,"Fighter, Mage",Mage,Marksman,"Tank, Fighter",1,0,1
10944,"Assassin, Fighter","Marksman, Mage","Mage, Fighter","Support, Mage",1,0,1
10943,"Assassin, Fighter","Marksman, Mage","Mage, Fighter","Assassin, Mage",1,0,1
10942,"Mage, Fighter","Fighter, Assassin",Marksman,Mage,0,1,1
10941,"Mage, Fighter","Mage, Marksman",Marksman,"Marksman, Mage",1,0,1
10940,"Fighter, Assassin","Marksman, Mage","Mage, Fighter","Mage, Marksman",1,0,1
10939,Marksman,"Assassin, Fighter","Mage, Fighter","Tank, Fighter",1,0,1
10938,"Assassin, Fighter","Assassin, Mage",Marksman,"Marksman, Mage",1,0,1
10937,"Mage, Fighter","Tank, Fighter","Fighter, Mage","Mage, Marksman",0,1,1
10936,"Fighter, Mage",Mage,Marksman,"Marksman, Mage",0,1,1
10935,"Fighter, Assassin",Marksman,Marksman,Mage,1,0,1
10934,Marksman,"Support, Mage","Assassin, Fighter",Marksman,0,1,1
10933,"Assassin, Fighter","Assassin, Mage",Marksman,Mage,1,0,1
10932,Marksman,"Assassin, Mage",Fighter,"Mage, Support",1,0,1
10931,"Fighter, Tank","Marksman, Mage","Mage, Fighter",Mage,0,1,1
10930,"Fighter, Mage",Mage,"Mage, Fighter","Mage, Fighter",0,1,1
10929,"Assassin, Fighter",Mage,"Mage, Fighter",Fighter,1,0,1
10928,Marksman,"Assassin, Mage","Fighter, Mage",Marksman,1,0,1
10927,"Assassin, Mage",Fighter,"Mage, Fighter",Mage,0,1,1
10801,"Assassin, Mage","Marksman, Mage",Fighter,"Support, Mage",1,0,1
10800,Fighter,"Mage, Marksman","Assassin, Fighter","Support, Mage",0,1,1
10799,"Assassin, Mage","Marksman, Mage","Assassin, Fighter",Mage,0,1,1
10659,Fighter,"Assassin, Mage","Fighter, Mage","Fighter, Assassin",1,0,1
10670,"Mage, Fighter",Marksman,"Fighter, Assassin","Support, Mage",0,1,1
10669,"Fighter, Assassin","Assassin, Fighter","Mage, Fighter","Fighter, Assassin",1,0,1
10668,Marksman,Marksman,"Fighter, Assassin",Mage,1,0,1
10667,"Mage, Fighter",Fighter,Fighter,Marksman,0,1,1
10666,"Mage, Fighter","Marksman, Mage","Fighter, Assassin","Mage, Assassin",1,0,1
10664,"Fighter, Mage","Assassin, Fighter","Assassin, Fighter","Support, Mage",1,0,1
10663,"Assassin, Fighter","Assassin, Fighter","Assassin, Fighter","Marksman, Mage",1,0,1
10661,"Fighter, Mage","Tank, Mage",Fighter,"Assassin, Mage",1,0,1
10660,"Tank, Fighter","Assassin, Mage","Fighter, Mage","Assassin, Mage",0,1,1
10658,"Fighter, Mage","Tank, Mage",Fighter,Mage,1,0,1
10644,"Assassin, Mage",Mage,"Fighter, Mage","Mage, Support",0,1,1
10657,Fighter,"Support, Mage","Fighter, Mage","Assassin, Mage",1,0,1
10656,Fighter,"Tank, Mage","Tank, Fighter","Support, Mage",0,1,1
10655,"Fighter, Mage","Assassin, Mage","Tank, Fighter",Mage,1,0,1
10653,"Fighter, Mage","Mage, Marksman",Fighter,"Fighter, Marksman",1,0,1
10652,Fighter,"Mage, Fighter","Tank, Fighter",Mage,1,0,1
10651,Fighter,"Assassin, Mage","Fighter, Mage","Assassin, Fighter",0,1,1
10648,"Fighter, Mage",Mage,"Tank, Fighter","Mage, Tank",1,0,1
10647,"Fighter, Mage","Tank, Mage","Tank, Fighter","Mage, Marksman",0,1,1
10646,"Fighter, Mage","Mage, Tank","Tank, Fighter","Tank, Mage",0,1,1
10671,"Fighter, Tank",Mage,"Fighter, Tank","Marksman, Mage",0,1,1
10672,"Mage, Fighter",Mage,"Fighter, Tank","Fighter, Marksman",1,0,1
10673,Marksman,"Assassin, Mage","Mage, Fighter",Mage,0,1,1
10674,"Mage, Fighter",Mage,"Fighter, Tank","Marksman, Mage",0,1,1
10695,"Assassin, Fighter","Marksman, Mage","Fighter, Mage","Fighter, Assassin",0,1,1
10694,"Tank, Fighter","Marksman, Mage",Fighter,"Fighter, Assassin",1,0,1
10693,"Fighter, Mage","Marksman, Mage",Fighter,"Fighter, Mage",0,1,1
10692,Fighter,"Marksman, Mage","Assassin, Mage","Mage, Tank",0,1,1
10691,"Assassin, Fighter",Mage,"Assassin, Fighter","Mage, Marksman",1,0,1
10690,"Tank, Fighter",Mage,Fighter,"Fighter, Mage",1,0,1
10689,"Tank, Fighter",Mage,Fighter,"Tank, Mage",1,0,1
10687,"Tank, Fighter","Mage, Tank","Fighter, Mage","Assassin, Fighter",0,1,1
10686,"Fighter, Mage",Mage,"Assassin, Fighter","Fighter, Mage",0,1,1
10685,Fighter,"Marksman, Mage",Marksman,"Assassin, Mage",1,0,1
10684,Fighter,Marksman,"Mage, Fighter","Assassin, Fighter",1,0,1
10682,"Fighter, Tank",Mage,"Mage, Fighter","Support, Mage",0,1,1
10681,"Tank, Fighter",Fighter,"Fighter, Mage",Mage,0,1,1
10680,"Fighter, Mage",Fighter,Fighter,Mage,1,0,1
10679,"Fighter, Mage","Support, Mage","Mage, Fighter",Fighter,0,1,1
10678,"Mage, Fighter","Support, Mage",Marksman,"Mage, Marksman",1,0,1
10677,Fighter,Mage,Marksman,"Marksman, Mage",0,1,1
10676,Marksman,Marksman,"Assassin, Fighter","Marksman, Mage",0,1,1
10675,Marksman,"Fighter, Mage",Fighter,Mage,1,0,1
10645,"Tank, Fighter","Tank, Mage","Assassin, Mage","Marksman, Mage",1,0,1
10642,"Fighter, Mage","Mage, Fighter","Tank, Fighter","Mage, Tank",1,0,1
10697,"Assassin, Mage","Marksman, Mage","Fighter, Mage",Mage,0,1,1
10604,Fighter,"Assassin, Mage","Fighter, Tank","Mage, Support",1,0,1
10613,"Fighter, Mage","Mage, Assassin","Fighter, Tank","Mage, Tank",1,0,1
10612,Marksman,"Mage, Assassin","Fighter, Mage","Mage, Support",1,0,1
10611,Marksman,"Mage, Marksman","Mage, Fighter","Mage, Tank",0,1,1
10610,"Fighter, Tank","Mage, Support",Fighter,"Assassin, Fighter",1,0,1
10609,"Mage, Fighter","Assassin, Mage",Marksman,"Mage, Marksman",0,1,1
10608,Marksman,"Assassin, Mage","Fighter, Mage",Mage,0,1,1
10607,"Fighter, Mage",Mage,Marksman,"Mage, Assassin",1,0,1
10606,"Assassin, Fighter","Mage, Tank","Fighter, Assassin","Assassin, Mage",1,0,1
10605,"Assassin, Fighter","Assassin, Mage","Fighter, Mage","Assassin, Mage",0,1,1
10603,Marksman,"Assassin, Mage","Assassin, Fighter","Support, Mage",1,0,1
10641,"Tank, Fighter","Mage, Tank",Fighter,"Mage, Assassin",0,1,1
10602,Marksman,"Mage, Assassin","Fighter, Mage","Marksman, Mage",1,0,1
10601,"Mage, Fighter","Marksman, Mage","Fighter, Mage","Assassin, Mage",0,1,1
10600,"Assassin, Fighter","Assassin, Mage","Fighter, Mage","Marksman, Mage",1,0,1
10598,"Mage, Fighter","Mage, Fighter","Fighter, Mage","Assassin, Mage",0,1,1
10597,Marksman,Mage,"Fighter, Assassin",Marksman,0,1,1
10596,Marksman,"Assassin, Fighter","Mage, Fighter","Fighter, Marksman",1,0,1
10595,Marksman,"Assassin, Fighter","Assassin, Fighter","Support, Mage",1,0,1
10594,"Fighter, Mage","Marksman, Mage","Mage, Fighter","Mage, Assassin",0,1,1
10592,"Assassin, Fighter","Assassin, Fighter","Support, Mage","Assassin, Fighter",1,0,1
10614,Marksman,"Assassin, Fighter","Mage, Fighter",Mage,0,1,1
10615,"Fighter, Mage","Assassin, Fighter","Fighter, Mage",Mage,1,0,1
10616,Fighter,"Fighter, Mage","Fighter, Assassin","Mage, Support",1,0,1
10617,"Fighter, Mage","Fighter, Marksman","Assassin, Fighter",Mage,0,1,1
10640,Fighter,"Assassin, Fighter","Tank, Fighter","Tank, Mage",1,0,1
10639,"Tank, Fighter","Support, Mage","Fighter, Mage","Tank, Mage",1,0,1
10638,"Tank, Fighter","Support, Mage",Fighter,"Mage, Tank",0,1,1
10636,"Fighter, Mage","Assassin, Mage",Fighter,"Support, Mage",0,1,1
10635,"Fighter, Mage","Marksman, Mage",Fighter,"Assassin, Fighter",1,0,1
10634,"Assassin, Fighter","Fighter, Marksman","Fighter, Mage",Mage,0,1,1
10630,"Fighter, Mage","Fighter, Marksman","Assassin, Fighter","Assassin, Fighter",1,0,1
10629,"Assassin, Fighter","Mage, Marksman","Tank, Fighter","Fighter, Marksman",1,0,1
10628,"Fighter, Mage","Fighter, Mage","Assassin, Fighter","Marksman, Mage",1,0,1
10627,"Assassin, Fighter",Mage,"Fighter, Mage","Fighter, Mage",0,1,1
10626,"Assassin, Fighter",Mage,"Assassin, Fighter",Mage,0,1,1
10625,"Assassin, Fighter","Fighter, Mage","Fighter, Mage","Mage, Marksman",0,1,1
10624,"Fighter, Assassin","Marksman, Mage",Fighter,"Fighter, Mage",1,0,1
10623,"Fighter, Mage","Fighter, Marksman",Fighter,"Mage, Assassin",1,0,1
10622,"Fighter, Mage","Mage, Marksman","Assassin, Fighter","Marksman, Mage",0,1,1
10621,"Tank, Fighter","Support, Mage","Assassin, Mage",Mage,0,1,1
10620,"Assassin, Fighter","Fighter, Marksman","Fighter, Mage","Support, Mage",1,0,1
10619,"Fighter, Mage","Assassin, Fighter","Assassin, Fighter",Mage,0,1,1
10618,Fighter,"Mage, Fighter","Assassin, Fighter","Marksman, Mage",1,0,1
10696,"Assassin, Fighter","Mage, Marksman","Assassin, Fighter","Assassin, Fighter",0,1,1
10698,"Assassin, Fighter","Fighter, Marksman","Assassin, Mage","Marksman, Mage",0,1,1
10798,"Assassin, Mage","Mage, Marksman","Tank, Fighter","Marksman, Mage",0,1,1
10764,"Assassin, Fighter","Support, Mage","Mage, Fighter","Fighter, Assassin",0,1,1
10774,"Mage, Fighter",Mage,Fighter,"Fighter, Marksman",0,1,1
10773,Fighter,Mage,Marksman,Fighter,1,0,1
10772,Fighter,"Support, Mage","Assassin, Mage","Mage, Support",1,0,1
10771,"Mage, Fighter","Mage, Assassin","Fighter, Assassin","Fighter, Assassin",1,0,1
10770,"Fighter, Assassin","Mage, Marksman",Fighter,Mage,1,0,1
10769,"Mage, Fighter",Mage,"Fighter, Assassin","Mage, Marksman",1,0,1
10767,"Mage, Fighter","Mage, Marksman","Fighter, Mage","Mage, Assassin",1,0,1
10766,"Fighter, Assassin","Mage, Marksman","Assassin, Mage",Mage,1,0,1
10765,"Fighter, Mage","Mage, Marksman","Assassin, Mage",Mage,1,0,1
10763,"Fighter, Mage","Fighter, Assassin","Mage, Fighter","Mage, Marksman",1,0,1
10752,"Assassin, Fighter","Assassin, Mage","Tank, Fighter","Marksman, Mage",1,0,1
10762,"Assassin, Mage",Mage,"Mage, Fighter","Mage, Support",0,1,1
10761,"Mage, Fighter",Mage,Fighter,"Assassin, Fighter",0,1,1
10760,"Fighter, Assassin","Fighter, Assassin","Fighter, Mage","Fighter, Assassin",0,1,1
10759,"Assassin, Mage","Assassin, Mage",Fighter,"Assassin, Mage",0,1,1
10758,"Assassin, Mage",Mage,"Fighter, Mage","Mage, Marksman",1,0,1
10757,"Tank, Fighter","Fighter, Marksman","Fighter, Mage","Mage, Marksman",1,0,1
10756,"Fighter, Assassin",Mage,"Tank, Fighter","Mage, Marksman",1,0,1
10755,"Assassin, Mage","Mage, Assassin","Fighter, Mage","Mage, Tank",0,1,1
10754,"Assassin, Mage",Mage,"Fighter, Mage","Assassin, Fighter",0,1,1
10775,"Mage, Fighter","Assassin, Mage",Fighter,"Mage, Assassin",1,0,1
10776,Marksman,Mage,Fighter,Marksman,0,1,1
10777,"Fighter, Mage","Mage, Support","Mage, Fighter","Mage, Marksman",0,1,1
10778,"Mage, Fighter","Mage, Marksman","Mage, Fighter",Fighter,0,1,1
10797,"Assassin, Fighter","Mage, Marksman","Tank, Fighter","Marksman, Mage",1,0,1
10796,"Assassin, Mage",Mage,"Fighter, Assassin","Mage, Assassin",1,0,1
10795,"Assassin, Mage",Mage,"Fighter, Mage","Mage, Assassin",1,0,1
10794,"Assassin, Mage","Fighter, Assassin","Fighter, Mage","Assassin, Mage",1,0,1
10793,Fighter,"Mage, Marksman","Assassin, Fighter",Mage,1,0,1
10792,Fighter,"Marksman, Mage","Assassin, Mage","Assassin, Fighter",1,0,1
10791,Fighter,"Mage, Marksman","Assassin, Mage","Marksman, Mage",1,0,1
10790,Fighter,"Mage, Marksman","Assassin, Mage","Assassin, Mage",1,0,1
10789,"Assassin, Fighter","Assassin, Fighter",Fighter,"Fighter, Assassin",1,0,1
10788,"Assassin, Mage",Mage,"Fighter, Mage",Mage,0,1,1
10787,"Fighter, Mage","Mage, Fighter","Assassin, Fighter","Marksman, Mage",1,0,1
10786,"Assassin, Mage","Mage, Fighter","Fighter, Mage",Mage,0,1,1
10785,"Fighter, Mage",Mage,"Assassin, Fighter","Assassin, Fighter",0,1,1
10784,"Mage, Fighter","Mage, Marksman","Fighter, Assassin","Assassin, Mage",1,0,1
10783,"Mage, Fighter","Fighter, Assassin","Fighter, Mage",Mage,1,0,1
10782,Fighter,"Mage, Fighter","Assassin, Mage",Mage,0,1,1
10781,"Mage, Fighter",Mage,"Fighter, Mage","Assassin, Fighter",1,0,1
10780,"Mage, Fighter","Fighter, Mage",Fighter,"Tank, Mage",1,0,1
10779,Fighter,"Fighter, Mage","Assassin, Mage","Mage, Fighter",1,0,1
10753,"Fighter, Mage","Marksman, Mage","Tank, Fighter",Mage,1,0,1
10751,Fighter,Mage,"Assassin, Mage","Assassin, Mage",0,1,1
10699,"Assassin, Fighter","Marksman, Mage",Marksman,"Mage, Support",0,1,1
10711,"Assassin, Mage",Mage,"Assassin, Fighter","Assassin, Fighter",1,0,1
10720,"Assassin, Fighter",Mage,"Tank, Fighter","Mage, Marksman",1,0,1
10719,"Assassin, Mage",Mage,"Fighter, Assassin","Mage, Marksman",1,0,1
10718,"Fighter, Mage","Support, Mage","Assassin, Fighter","Assassin, Fighter",1,0,1
10717,Fighter,"Assassin, Fighter","Assassin, Fighter","Fighter, Marksman",1,0,1
10716,"Assassin, Mage","Assassin, Fighter","Fighter, Assassin","Assassin, Fighter",1,0,1
10715,"Assassin, Mage",Mage,Fighter,"Mage, Assassin",1,0,1
10714,Fighter,"Support, Mage","Assassin, Mage","Assassin, Mage",1,0,1
10713,"Assassin, Fighter",Mage,"Assassin, Mage","Assassin, Fighter",1,0,1
10712,"Fighter, Mage","Mage, Marksman","Assassin, Mage","Marksman, Mage",0,1,1
10710,"Fighter, Assassin","Assassin, Mage",Fighter,Mage,1,0,1
10749,"Tank, Fighter","Mage, Support","Fighter, Mage","Marksman, Mage",0,1,1
10709,"Fighter, Mage","Mage, Marksman",Fighter,"Assassin, Fighter",0,1,1
10708,"Assassin, Mage","Marksman, Mage","Fighter, Assassin","Assassin, Mage",0,1,1
10706,Fighter,Mage,"Assassin, Mage","Mage, Marksman",1,0,1
10705,"Fighter, Mage","Fighter, Marksman","Assassin, Fighter","Fighter, Mage",0,1,1
10704,"Fighter, Mage","Fighter, Marksman",Fighter,"Fighter, Mage",0,1,1
10703,"Mage, Fighter","Fighter, Mage","Fighter, Mage","Fighter, Marksman",0,1,1
10702,Fighter,"Mage, Assassin","Mage, Fighter","Mage, Fighter",1,0,1
10701,"Mage, Fighter",Mage,"Tank, Fighter","Mage, Marksman",0,1,1
10700,"Assassin, Mage",Mage,"Mage, Fighter","Assassin, Fighter",0,1,1
10721,"Assassin, Mage","Mage, Fighter","Assassin, Fighter",Mage,1,0,1
10722,Fighter,"Mage, Marksman","Fighter, Mage","Fighter, Assassin",1,0,1
10723,Fighter,"Assassin, Mage","Assassin, Mage",Mage,0,1,1
10725,"Fighter, Assassin",Mage,"Assassin, Fighter","Mage, Marksman",0,1,1
10748,"Fighter, Mage","Marksman, Mage","Assassin, Mage","Mage, Assassin",1,0,1
10747,"Fighter, Mage",Mage,"Tank, Fighter","Mage, Marksman",1,0,1
10746,Fighter,"Support, Mage","Tank, Fighter","Marksman, Mage",0,1,1
10745,"Assassin, Mage","Mage, Marksman","Fighter, Mage","Marksman, Mage",0,1,1
10744,Fighter,"Support, Mage","Tank, Fighter","Mage, Assassin",0,1,1
10743,"Fighter, Mage","Support, Mage",Fighter,"Mage, Tank",1,0,1
10742,"Assassin, Mage","Assassin, Mage","Tank, Fighter","Support, Mage",0,1,1
10740,Fighter,"Support, Mage","Assassin, Mage",Mage,0,1,1
10739,"Tank, Fighter","Marksman, Mage",Fighter,"Support, Mage",1,0,1
10738,"Fighter, Mage","Support, Mage","Tank, Fighter","Assassin, Mage",0,1,1
10736,"Tank, Fighter","Mage, Tank","Tank, Fighter","Marksman, Mage",0,1,1
10735,"Assassin, Mage",Mage,Fighter,"Fighter, Assassin",1,0,1
10734,"Assassin, Mage","Fighter, Assassin","Fighter, Mage","Mage, Marksman",1,0,1
10733,"Assassin, Fighter","Assassin, Mage","Assassin, Mage","Mage, Marksman",1,0,1
10732,"Fighter, Assassin",Mage,"Assassin, Mage","Mage, Support",0,1,1
10731,"Assassin, Mage","Assassin, Fighter","Fighter, Assassin",Mage,1,0,1
10728,"Fighter, Mage","Marksman, Mage","Assassin, Mage","Assassin, Fighter",0,1,1
10727,"Fighter, Mage","Mage, Marksman","Assassin, Mage","Mage, Fighter",0,1,1
10726,"Assassin, Mage",Mage,Fighter,"Mage, Marksman",1,0,1
10155,"Fighter, Mage","Mage, Support","Support, Mage","Mage, Marksman",1,0,1
10153,"Mage, Fighter","Mage, Tank","Assassin, Fighter",Mage,1,0,1
9134,"Assassin, Fighter","Assassin, Fighter","Support, Mage","Mage, Support",1,0,1
9490,"Tank, Fighter","Mage, Marksman","Assassin, Fighter","Mage, Assassin",1,0,1
9501,"Fighter, Assassin","Assassin, Fighter","Tank, Fighter","Fighter, Tank",0,1,1
9500,"Tank, Fighter",Mage,"Assassin, Fighter","Mage, Assassin",0,1,1
9499,"Tank, Fighter","Mage, Assassin","Fighter, Assassin","Mage, Marksman",0,1,1
9498,"Fighter, Assassin","Mage, Marksman","Tank, Fighter","Mage, Fighter",1,0,1
9497,"Tank, Fighter","Mage, Marksman","Fighter, Tank","Mage, Support",1,0,1
9496,"Fighter, Tank",Marksman,"Tank, Fighter","Mage, Assassin",0,1,1
9494,"Assassin, Mage","Mage, Marksman","Tank, Fighter","Assassin, Mage",1,0,1
9493,"Fighter, Tank","Mage, Assassin","Tank, Fighter","Mage, Fighter",0,1,1
9492,"Fighter, Tank","Mage, Assassin","Tank, Fighter",Mage,0,1,1
9489,"Tank, Fighter","Mage, Support","Assassin, Mage","Mage, Fighter",0,1,1
9506,"Assassin, Fighter","Marksman, Assassin","Fighter, Assassin","Mage, Support",1,0,1
9488,"Tank, Fighter","Mage, Marksman","Assassin, Fighter","Mage, Fighter",1,0,1
9487,"Fighter, Assassin","Mage, Marksman","Tank, Fighter","Fighter, Marksman",1,0,1
9486,"Tank, Fighter","Mage, Assassin","Assassin, Fighter","Fighter, Marksman",0,1,1
9484,"Assassin, Fighter","Mage, Support","Mage, Fighter","Marksman, Mage",1,0,1
9480,"Fighter, Mage","Assassin, Mage","Tank, Fighter","Assassin, Mage",1,0,1
9478,"Tank, Fighter",Mage,"Fighter, Mage","Fighter, Marksman",1,0,1
9476,"Fighter, Mage",Mage,"Tank, Fighter","Marksman, Mage",0,1,1
9475,"Assassin, Fighter","Mage, Assassin","Fighter, Mage","Fighter, Assassin",0,1,1
9474,"Assassin, Fighter","Fighter, Assassin","Fighter, Assassin","Mage, Assassin",1,0,1
9504,"Mage, Fighter","Mage, Support","Fighter, Assassin","Fighter, Marksman",1,0,1
9507,"Assassin, Fighter","Assassin, Fighter","Fighter, Assassin",Mage,1,0,1
9413,"Assassin, Fighter",Mage,"Fighter, Mage",Marksman,1,0,1
9531,"Fighter, Mage","Mage, Fighter",Marksman,Marksman,1,0,1
9544,"Mage, Fighter","Assassin, Fighter",Marksman,"Mage, Marksman",0,1,1
9542,Marksman,"Mage, Support",Marksman,Marksman,1,0,1
9541,"Mage, Fighter","Marksman, Mage",Fighter,"Mage, Fighter",1,0,1
9539,"Mage, Fighter","Assassin, Mage","Assassin, Fighter","Mage, Assassin",1,0,1
9537,"Mage, Fighter","Support, Mage",Marksman,Mage,0,1,1
9536,Marksman,Marksman,"Fighter, Mage",Mage,0,1,1
9535,"Assassin, Fighter","Mage, Marksman",Marksman,"Support, Mage",1,0,1
9534,Marksman,"Tank, Fighter",Marksman,"Assassin, Mage",0,1,1
9532,"Fighter, Tank","Mage, Marksman",Marksman,"Support, Mage",0,1,1
9530,"Fighter, Mage",Marksman,Marksman,"Assassin, Mage",1,0,1
9508,"Assassin, Fighter",Mage,"Fighter, Assassin","Fighter, Tank",1,0,1
9527,Marksman,"Mage, Fighter","Fighter, Assassin",Marksman,1,0,1
9525,"Assassin, Fighter","Assassin, Fighter",Marksman,"Fighter, Marksman",1,0,1
9524,Marksman,"Fighter, Marksman","Mage, Fighter","Assassin, Fighter",0,1,1
9520,"Fighter, Mage","Mage, Support","Fighter, Tank","Mage, Tank",0,1,1
9518,Marksman,"Mage, Support","Fighter, Assassin","Mage, Fighter",1,0,1
9514,"Fighter, Tank","Mage, Support","Assassin, Fighter","Assassin, Fighter",0,1,1
9511,"Support, Mage","Mage, Support",Marksman,"Fighter, Marksman",1,0,1
9510,"Fighter, Tank",Mage,"Fighter, Assassin","Mage, Fighter",0,1,1
9509,"Tank, Support","Mage, Fighter","Mage, Fighter","Mage, Assassin",1,0,1
9473,"Support, Mage",Mage,"Fighter, Assassin","Mage, Assassin",0,1,1
9472,"Tank, Fighter","Mage, Marksman","Fighter, Tank","Marksman, Mage",1,0,1
9471,"Assassin, Fighter","Mage, Support","Tank, Fighter","Assassin, Fighter",0,1,1
9433,"Assassin, Mage","Mage, Marksman","Assassin, Fighter","Mage, Fighter",0,1,1
9444,"Assassin, Fighter","Mage, Marksman","Tank, Fighter","Assassin, Mage",1,0,1
9442,"Fighter, Tank","Mage, Marksman","Tank, Fighter","Mage, Support",1,0,1
9441,"Tank, Fighter","Fighter, Marksman","Assassin, Fighter","Mage, Fighter",0,1,1
9440,"Assassin, Fighter","Mage, Assassin","Tank, Fighter","Support, Mage",0,1,1
9439,"Tank, Fighter","Mage, Assassin","Tank, Fighter","Mage, Support",0,1,1
9438,"Support, Mage","Mage, Assassin","Tank, Fighter","Mage, Support",1,0,1
9437,"Assassin, Fighter","Mage, Marksman","Tank, Fighter","Mage, Fighter",1,0,1
9436,"Assassin, Mage","Mage, Assassin","Assassin, Fighter","Mage, Marksman",1,0,1
9434,"Tank, Fighter","Mage, Fighter","Fighter, Assassin","Tank, Mage",1,0,1
9432,"Tank, Fighter","Mage, Fighter","Fighter, Mage","Mage, Marksman",0,1,1
9470,"Fighter, Assassin","Assassin, Fighter","Mage, Fighter","Assassin, Mage",1,0,1
9431,"Assassin, Fighter","Mage, Fighter","Support, Mage","Mage, Marksman",0,1,1
9429,"Tank, Fighter","Mage, Fighter","Assassin, Fighter",Mage,1,0,1
9428,"Assassin, Fighter",Mage,"Tank, Fighter","Mage, Fighter",0,1,1
9425,"Assassin, Fighter","Mage, Fighter","Tank, Fighter","Mage, Marksman",0,1,1
9421,"Assassin, Fighter","Assassin, Fighter","Fighter, Mage","Fighter, Assassin",0,1,1
9420,"Assassin, Fighter",Marksman,"Mage, Fighter","Marksman, Fighter",1,0,1
9419,Marksman,Mage,"Mage, Fighter","Marksman, Mage",0,1,1
9416,"Fighter, Mage","Mage, Marksman",Marksman,"Assassin, Fighter",1,0,1
9415,"Tank, Fighter",Mage,"Fighter, Mage","Mage, Marksman",1,0,1
9445,"Fighter, Tank","Mage, Fighter","Tank, Fighter","Mage, Fighter",0,1,1
9446,"Tank, Fighter","Mage, Assassin","Fighter, Tank","Mage, Marksman",1,0,1
9447,"Fighter, Assassin",Mage,Fighter,Marksman,1,0,1
9448,"Fighter, Assassin",Mage,"Assassin, Fighter",Marksman,1,0,1
9469,"Tank, Fighter","Assassin, Fighter","Fighter, Assassin","Mage, Marksman",0,1,1
9468,"Fighter, Assassin",Mage,"Tank, Fighter","Assassin, Fighter",0,1,1
9467,"Tank, Fighter","Assassin, Mage","Fighter, Assassin","Fighter, Marksman",1,0,1
9466,"Tank, Fighter","Assassin, Mage","Tank, Fighter","Marksman, Mage",0,1,1
9465,Mage,"Assassin, Fighter","Tank, Fighter","Mage, Support",1,0,1
9464,Mage,"Assassin, Fighter","Tank, Fighter","Marksman, Mage",0,1,1
9463,"Mage, Fighter","Assassin, Fighter","Tank, Fighter","Fighter, Tank",0,1,1
9462,"Assassin, Fighter","Mage, Assassin","Assassin, Fighter","Assassin, Fighter",1,0,1
9460,Fighter,"Assassin, Mage","Mage, Fighter","Fighter, Marksman",0,1,1
9459,"Tank, Fighter","Mage, Support","Support, Mage",Marksman,0,1,1
9458,"Fighter, Tank","Mage, Assassin","Mage, Fighter","Assassin, Mage",0,1,1
9457,"Mage, Fighter","Mage, Marksman","Support, Mage",Marksman,0,1,1
9456,"Mage, Fighter","Assassin, Mage",Marksman,"Mage, Fighter",0,1,1
9455,"Fighter, Tank","Mage, Support",Marksman,"Assassin, Mage",1,0,1
9454,"Support, Mage",Mage,"Mage, Fighter","Fighter, Marksman",1,0,1
9452,"Mage, Support","Mage, Support","Assassin, Fighter",Mage,1,0,1
9451,"Assassin, Fighter","Mage, Support",Fighter,"Tank, Mage",0,1,1
9450,"Tank, Fighter",Marksman,Fighter,"Tank, Mage",1,0,1
9449,Marksman,"Tank, Mage",Fighter,Marksman,1,0,1
9546,Marksman,"Mage, Marksman",Fighter,"Assassin, Fighter",1,0,1
9549,Fighter,"Mage, Marksman","Fighter, Assassin","Mage, Fighter",0,1,1
9551,Marksman,"Support, Mage",Fighter,"Assassin, Mage",1,0,1
9630,"Fighter, Assassin","Tank, Mage",Marksman,"Assassin, Fighter",0,1,1
9643,"Fighter, Mage","Assassin, Fighter","Fighter, Mage","Assassin, Mage",1,0,1
9642,Fighter,Marksman,"Fighter, Mage",Fighter,0,1,1
9640,"Tank, Fighter","Tank, Mage",Fighter,Marksman,1,0,1
9639,"Tank, Fighter","Mage, Tank","Tank, Mage","Mage, Support",0,1,1
9638,"Tank, Fighter","Tank, Mage","Tank, Mage",Mage,1,0,1
9636,Fighter,Mage,Marksman,"Assassin, Fighter",1,0,1
9635,"Mage, Fighter",Mage,Marksman,"Mage, Marksman",0,1,1
9633,"Mage, Fighter","Support, Mage","Fighter, Assassin","Assassin, Mage",0,1,1
9632,"Fighter, Mage",Marksman,Fighter,"Mage, Assassin",1,0,1
9628,"Fighter, Assassin","Mage, Assassin","Assassin, Fighter","Mage, Tank",1,0,1
9612,Fighter,"Mage, Tank","Fighter, Assassin","Mage, Support",1,0,1
9627,"Mage, Fighter","Mage, Support","Support, Mage","Fighter, Marksman",0,1,1
9626,"Fighter, Tank","Mage, Tank","Mage, Fighter","Mage, Support",0,1,1
9623,"Tank, Fighter",Marksman,"Mage, Fighter",Marksman,0,1,1
9622,"Assassin, Fighter","Assassin, Fighter","Fighter, Tank","Assassin, Fighter",0,1,1
9619,"Assassin, Fighter","Mage, Support",Fighter,"Fighter, Marksman",1,0,1
9617,"Fighter, Assassin","Assassin, Mage","Fighter, Mage","Mage, Assassin",1,0,1
9616,"Assassin, Fighter","Assassin, Mage","Assassin, Fighter","Assassin, Fighter",1,0,1
9615,"Assassin, Fighter","Mage, Tank","Fighter, Mage","Mage, Fighter",0,1,1
9614,Fighter,"Mage, Tank","Support, Mage","Mage, Support",0,1,1
9644,"Fighter, Mage",Marksman,"Mage, Fighter","Support, Mage",0,1,1
9647,Marksman,"Support, Mage","Fighter, Tank",Mage,1,0,1
9648,Marksman,Fighter,Fighter,"Mage, Support",1,0,1
9649,Fighter,"Assassin, Mage","Tank, Fighter",Marksman,0,1,1
9672,"Fighter, Assassin","Fighter, Assassin","Tank, Fighter","Mage, Support",1,0,1
9671,"Mage, Fighter","Marksman, Mage","Fighter, Assassin","Mage, Support",0,1,1
9669,"Tank, Fighter","Mage, Tank","Fighter, Mage","Mage, Support",0,1,1
9668,"Tank, Fighter","Mage, Support","Mage, Fighter","Fighter, Marksman",1,0,1
9667,"Mage, Fighter","Assassin, Mage","Tank, Fighter","Assassin, Mage",0,1,1
9666,"Mage, Fighter",Marksman,"Tank, Fighter","Mage, Assassin",1,0,1
9665,"Tank, Mage","Mage, Support","Tank, Fighter","Assassin, Fighter",0,1,1
9664,"Mage, Fighter","Assassin, Fighter","Tank, Mage","Mage, Support",0,1,1
9663,"Mage, Fighter",Marksman,"Tank, Fighter","Mage, Tank",1,0,1
9661,"Tank, Fighter",Marksman,Fighter,Marksman,1,0,1
9660,"Fighter, Assassin","Tank, Mage","Tank, Mage","Assassin, Fighter",1,0,1
9659,"Tank, Fighter",Mage,"Fighter, Mage","Assassin, Mage",0,1,1
9658,"Tank, Mage",Marksman,"Mage, Fighter","Mage, Support",1,0,1
9657,"Fighter, Assassin",Marksman,"Tank, Fighter","Assassin, Mage",1,0,1
9656,"Fighter, Mage","Assassin, Mage",Fighter,Marksman,1,0,1
9654,"Assassin, Fighter","Mage, Support","Mage, Fighter","Tank, Mage",0,1,1
9652,"Tank, Mage",Marksman,"Tank, Mage","Assassin, Mage",1,0,1
9651,"Fighter, Mage",Mage,"Tank, Mage","Mage, Support",1,0,1
9650,"Tank, Fighter","Assassin, Mage","Tank, Mage",Mage,1,0,1
9613,Assassin,"Assassin, Fighter","Fighter, Mage","Mage, Assassin",1,0,1
9611,"Fighter, Assassin","Mage, Support","Support, Mage","Assassin, Fighter",0,1,1
9552,"Fighter, Mage","Assassin, Fighter","Fighter, Mage","Mage, Support",1,0,1
9564,Marksman,"Mage, Assassin","Mage, Fighter","Assassin, Mage",1,0,1
9574,"Mage, Fighter","Assassin, Mage","Fighter, Assassin","Assassin, Mage",1,0,1
9573,"Fighter, Tank",Mage,"Mage, Fighter","Fighter, Marksman",1,0,1
9572,"Support, Mage","Assassin, Mage","Fighter, Tank","Assassin, Fighter",1,0,1
9571,"Support, Mage","Tank, Mage","Fighter, Assassin","Mage, Support",1,0,1
9570,"Tank, Fighter","Mage, Marksman","Assassin, Fighter",Marksman,0,1,1
9569,"Tank, Fighter",Marksman,"Fighter, Assassin","Assassin, Mage",1,0,1
9568,"Fighter, Assassin","Mage, Marksman",Fighter,"Mage, Assassin",1,0,1
9567,"Mage, Fighter","Mage, Assassin",Fighter,"Assassin, Mage",0,1,1
9566,"Mage, Fighter",Marksman,"Fighter, Tank","Mage, Marksman",0,1,1
9563,"Mage, Fighter","Mage, Support","Fighter, Tank","Marksman, Mage",0,1,1
9607,Fighter,"Mage, Assassin","Mage, Fighter","Assassin, Mage",0,1,1
9562,"Mage, Fighter","Marksman, Mage","Fighter, Mage","Mage, Assassin",1,0,1
9561,Marksman,Mage,Fighter,"Mage, Assassin",0,1,1
9560,"Fighter, Mage",Mage,"Assassin, Fighter","Assassin, Mage",1,0,1
9559,Fighter,"Mage, Support","Tank, Mage","Tank, Mage",0,1,1
9558,"Fighter, Tank","Fighter, Marksman","Fighter, Mage","Mage, Support",1,0,1
9557,"Fighter, Mage","Fighter, Marksman",Fighter,"Assassin, Mage",1,0,1
9556,"Fighter, Tank",Mage,"Tank, Mage",Mage,0,1,1
9555,"Tank, Fighter","Tank, Mage","Fighter, Tank",Marksman,1,0,1
9554,Fighter,"Mage, Support","Fighter, Assassin","Fighter, Assassin",1,0,1
9575,"Tank, Fighter","Mage, Support","Support, Mage","Tank, Mage",0,1,1
9576,"Assassin, Mage","Mage, Support","Fighter, Assassin","Mage, Fighter",0,1,1
9577,"Fighter, Assassin","Mage, Support","Fighter, Assassin","Mage, Assassin",0,1,1
9578,Fighter,"Mage, Assassin","Fighter, Assassin","Assassin, Fighter",0,1,1
9606,Fighter,"Tank, Fighter","Fighter, Assassin",Mage,1,0,1
9604,"Fighter, Assassin","Assassin, Mage","Mage, Fighter","Fighter, Marksman",0,1,1
9602,"Mage, Fighter","Mage, Tank","Fighter, Assassin","Assassin, Fighter",1,0,1
9600,"Mage, Fighter","Assassin, Mage","Fighter, Tank","Assassin, Mage",1,0,1
9599,"Mage, Fighter","Fighter, Marksman","Support, Mage","Mage, Assassin",0,1,1
9598,"Fighter, Mage","Fighter, Marksman","Fighter, Assassin","Mage, Assassin",0,1,1
9597,"Mage, Fighter","Assassin, Mage","Fighter, Assassin","Mage, Tank",1,0,1
9596,"Tank, Fighter","Assassin, Mage","Support, Mage","Mage, Tank",0,1,1
9595,"Support, Mage","Tank, Mage","Mage, Fighter","Assassin, Fighter",0,1,1
9594,"Mage, Fighter","Mage, Assassin","Assassin, Fighter","Assassin, Mage",1,0,1
9593,"Fighter, Tank",Mage,"Mage, Fighter","Assassin, Fighter",0,1,1
9592,"Tank, Fighter","Mage, Support","Support, Mage","Assassin, Fighter",1,0,1
9590,"Support, Mage","Assassin, Mage",Marksman,"Assassin, Fighter",0,1,1
9589,Marksman,Mage,"Tank, Fighter","Mage, Support",0,1,1
9586,"Fighter, Tank","Mage, Marksman","Fighter, Assassin","Mage, Support",0,1,1
9584,"Fighter, Mage","Mage, Support","Fighter, Mage",Mage,0,1,1
9583,"Tank, Fighter","Assassin, Fighter","Mage, Fighter","Tank, Mage",0,1,1
9580,Marksman,"Mage, Tank","Support, Mage","Mage, Fighter",0,1,1
9579,"Support, Mage","Assassin, Fighter","Assassin, Fighter","Mage, Assassin",0,1,1
9414,"Assassin, Fighter","Assassin, Mage","Fighter, Mage","Mage, Marksman",0,1,1
9412,"Fighter, Mage","Tank, Fighter","Assassin, Fighter",Marksman,0,1,1
10152,"Fighter, Tank","Assassin, Mage","Mage, Fighter","Mage, Fighter",0,1,1
9225,"Fighter, Mage","Assassin, Mage","Tank, Fighter","Assassin, Fighter",1,0,1
9240,"Tank, Fighter","Mage, Support","Tank, Fighter","Fighter, Assassin",0,1,1
9238,"Assassin, Fighter","Support, Mage","Fighter, Tank",Mage,1,0,1
9237,"Fighter, Assassin","Mage, Fighter","Fighter, Mage","Mage, Support",0,1,1
9236,"Fighter, Mage","Mage, Support","Fighter, Assassin","Mage, Fighter",1,0,1
9232,"Tank, Fighter","Mage, Support","Fighter, Assassin",Mage,0,1,1
9231,"Tank, Fighter",Mage,Fighter,"Mage, Fighter",1,0,1
9230,"Tank, Fighter",Mage,"Marksman, Mage","Mage, Fighter",0,1,1
9227,"Tank, Fighter","Tank, Mage",Marksman,"Mage, Fighter",1,0,1
9226,"Marksman, Mage","Mage, Support","Tank, Fighter","Assassin, Fighter",0,1,1
9224,"Assassin, Fighter","Mage, Support","Marksman, Mage","Mage, Fighter",1,0,1
9243,"Tank, Fighter","Fighter, Marksman",Fighter,"Mage, Fighter",1,0,1
9223,"Mage, Fighter","Mage, Fighter","Assassin, Fighter","Assassin, Mage",0,1,1
9222,"Assassin, Fighter","Assassin, Mage","Support, Mage","Mage, Fighter",0,1,1
9220,"Support, Mage",Marksman,"Mage, Fighter","Assassin, Fighter",0,1,1
9219,"Fighter, Assassin","Fighter, Marksman",Marksman,"Mage, Support",0,1,1
9217,"Assassin, Fighter","Fighter, Marksman",Fighter,Marksman,1,0,1
9215,Marksman,"Assassin, Mage","Fighter, Assassin","Mage, Fighter",1,0,1
9213,Marksman,"Mage, Support","Support, Mage","Assassin, Mage",1,0,1
9212,"Mage, Fighter","Fighter, Marksman","Assassin, Fighter","Mage, Assassin",0,1,1
9211,"Assassin, Fighter","Mage, Marksman","Support, Mage",Mage,0,1,1
9241,"Assassin, Fighter","Tank, Mage","Tank, Fighter","Mage, Fighter",1,0,1
9244,"Tank, Fighter","Assassin, Fighter","Marksman, Mage","Mage, Support",0,1,1
9411,"Mage, Fighter","Assassin, Mage","Fighter, Mage","Marksman, Fighter",0,1,1
9263,"Mage, Fighter",Mage,"Fighter, Tank","Mage, Support",0,1,1
9276,Fighter,Mage,"Fighter, Tank","Support, Mage",1,0,1
9275,"Mage, Fighter","Mage, Assassin","Fighter, Tank","Mage, Fighter",1,0,1
9272,"Fighter, Assassin",Mage,Fighter,"Mage, Tank",0,1,1
9271,"Fighter, Tank",Mage,"Tank, Fighter","Marksman, Mage",0,1,1
9270,"Fighter, Tank","Mage, Support","Fighter, Assassin","Mage, Tank",1,0,1
9269,"Fighter, Assassin","Mage, Fighter","Mage, Fighter","Mage, Assassin",0,1,1
9268,"Fighter, Tank","Mage, Fighter","Fighter, Assassin","Mage, Fighter",0,1,1
9266,"Fighter, Assassin","Fighter, Marksman","Fighter, Tank","Mage, Fighter",0,1,1
9265,"Fighter, Assassin","Mage, Tank","Fighter, Tank","Mage, Support",1,0,1
9262,Fighter,"Mage, Assassin","Fighter, Tank",Mage,0,1,1
9245,"Fighter, Mage","Mage, Fighter","Tank, Fighter",Mage,1,0,1
9261,"Fighter, Assassin","Mage, Support","Mage, Fighter","Marksman, Mage",1,0,1
9260,"Fighter, Tank","Marksman, Mage","Assassin, Fighter",Mage,1,0,1
9258,"Fighter, Tank","Mage, Support","Fighter, Tank","Support, Mage",1,0,1
9256,"Mage, Fighter","Mage, Fighter","Fighter, Tank",Mage,0,1,1
9251,"Fighter, Tank",Mage,"Fighter, Assassin","Mage, Support",0,1,1
9250,"Tank, Fighter","Mage, Fighter",Fighter,"Mage, Support",1,0,1
9249,Fighter,Mage,"Marksman, Mage","Mage, Support",1,0,1
9248,Fighter,"Mage, Assassin","Marksman, Mage","Mage, Fighter",1,0,1
9246,"Support, Mage",Marksman,"Fighter, Mage","Mage, Support",0,1,1
9210,"Fighter, Assassin","Mage, Support",Marksman,"Fighter, Marksman",1,0,1
9208,"Fighter, Mage","Mage, Support","Assassin, Mage","Mage, Support",1,0,1
9207,"Fighter, Tank","Mage, Fighter",Fighter,"Mage, Support",1,0,1
9156,"Fighter, Mage",Marksman,"Fighter, Assassin","Assassin, Fighter",1,0,1
9170,Fighter,"Fighter, Mage","Assassin, Fighter",Mage,1,0,1
9169,"Tank, Fighter","Fighter, Mage","Fighter, Assassin",Mage,1,0,1
9165,"Support, Mage",Marksman,"Fighter, Tank",Mage,0,1,1
9164,"Support, Mage","Mage, Support",Marksman,"Assassin, Mage",1,0,1
9163,"Tank, Fighter","Assassin, Mage",Marksman,"Assassin, Mage",0,1,1
9162,Marksman,"Mage, Support","Tank, Fighter","Assassin, Fighter",0,1,1
9160,Marksman,"Mage, Support","Fighter, Assassin","Mage, Tank",1,0,1
9158,"Support, Mage","Fighter, Marksman","Tank, Fighter","Mage, Support",0,1,1
9157,Marksman,"Assassin, Mage","Fighter, Tank",Mage,0,1,1
9152,"Fighter, Mage","Assassin, Mage",Marksman,Mage,1,0,1
9206,"Support, Mage","Mage, Support",Fighter,Mage,0,1,1
9151,"Mage, Fighter","Fighter, Assassin","Fighter, Mage","Marksman, Fighter",0,1,1
9150,Marksman,Mage,"Fighter, Mage","Assassin, Fighter",0,1,1
9149,Fighter,"Support, Mage","Fighter, Tank","Marksman, Mage",0,1,1
9147,Fighter,"Marksman, Mage","Assassin, Fighter","Support, Mage",1,0,1
9146,Fighter,"Mage, Fighter","Mage, Fighter","Assassin, Fighter",0,1,1
9144,"Fighter, Assassin","Assassin, Mage","Fighter, Mage","Assassin, Mage",0,1,1
9142,"Fighter, Mage","Assassin, Fighter",Marksman,"Assassin, Mage",0,1,1
9141,"Fighter, Assassin","Mage, Marksman","Mage, Fighter","Mage, Support",0,1,1
9138,"Fighter, Tank",Mage,"Assassin, Fighter","Mage, Marksman",1,0,1
9171,"Tank, Fighter","Fighter, Mage","Fighter, Assassin","Assassin, Fighter",0,1,1
9172,"Fighter, Assassin",Mage,"Assassin, Fighter","Marksman, Mage",0,1,1
9173,"Assassin, Fighter","Assassin, Mage",Fighter,"Marksman, Mage",0,1,1
9174,Fighter,"Fighter, Mage","Assassin, Fighter","Mage, Assassin",1,0,1
9205,"Fighter, Tank","Support, Mage","Fighter, Assassin",Mage,1,0,1
9204,"Fighter, Tank","Assassin, Mage","Fighter, Assassin",Mage,1,0,1
9201,"Support, Mage","Mage, Support",Fighter,"Assassin, Fighter",0,1,1
9200,"Fighter, Assassin","Mage, Support",Fighter,"Mage, Tank",1,0,1
9199,"Fighter, Assassin","Mage, Support",Fighter,Mage,1,0,1
9196,"Assassin, Fighter","Assassin, Fighter","Fighter, Assassin",Marksman,1,0,1
9195,"Support, Mage",Mage,Fighter,"Mage, Support",0,1,1
9194,Fighter,"Mage, Support","Mage, Fighter","Tank, Mage",0,1,1
9192,"Fighter, Mage","Mage, Support","Fighter, Tank",Marksman,1,0,1
9191,"Fighter, Mage","Assassin, Mage","Fighter, Assassin","Assassin, Mage",1,0,1
9190,"Fighter, Mage","Assassin, Fighter","Assassin, Fighter","Mage, Support",0,1,1
9189,"Fighter, Mage","Mage, Support","Support, Mage","Mage, Tank",0,1,1
9188,"Fighter, Mage","Assassin, Mage","Assassin, Fighter","Assassin, Mage",1,0,1
9187,Fighter,"Mage, Support","Assassin, Fighter","Tank, Mage",0,1,1
9186,"Assassin, Fighter",Marksman,"Fighter, Mage","Assassin, Mage",1,0,1
9184,Fighter,"Assassin, Fighter","Fighter, Tank",Mage,1,0,1
9180,"Mage, Fighter",Marksman,Fighter,"Assassin, Mage",0,1,1
9178,"Fighter, Assassin","Support, Mage","Fighter, Mage","Marksman, Mage",0,1,1
9177,"Fighter, Assassin",Mage,"Support, Mage","Fighter, Marksman",1,0,1
9278,"Fighter, Mage","Tank, Mage","Tank, Fighter","Mage, Tank",1,0,1
9280,"Fighter, Assassin","Assassin, Mage",Marksman,Mage,1,0,1
9281,Marksman,Mage,"Fighter, Assassin","Mage, Fighter",0,1,1
9361,"Fighter, Assassin","Fighter, Marksman","Assassin, Fighter","Mage, Assassin",0,1,1
9374,"Assassin, Fighter","Assassin, Mage","Fighter, Assassin","Mage, Tank",1,0,1
9372,"Fighter, Assassin","Assassin, Mage","Support, Mage",Mage,1,0,1
9371,"Mage, Fighter","Mage, Assassin","Fighter, Assassin","Mage, Marksman",0,1,1
9370,"Fighter, Assassin","Assassin, Fighter","Assassin, Fighter","Mage, Assassin",0,1,1
9369,"Tank, Fighter","Fighter, Marksman","Fighter, Assassin","Mage, Marksman",1,0,1
9367,"Tank, Fighter","Fighter, Marksman","Mage, Fighter","Mage, Assassin",0,1,1
9365,Fighter,Marksman,"Fighter, Mage","Support, Mage",0,1,1
9364,"Assassin, Fighter","Mage, Fighter","Fighter, Assassin","Mage, Assassin",0,1,1
9363,"Tank, Fighter","Mage, Support","Mage, Fighter","Assassin, Fighter",1,0,1
9360,"Tank, Fighter","Mage, Support","Fighter, Tank","Mage, Assassin",1,0,1
9346,"Assassin, Fighter","Mage, Assassin","Fighter, Assassin","Mage, Tank",1,0,1
9359,"Tank, Fighter","Assassin, Fighter","Assassin, Fighter","Mage, Assassin",1,0,1
9358,"Mage, Support",Marksman,"Assassin, Fighter","Assassin, Mage",0,1,1
9357,"Assassin, Fighter","Fighter, Marksman","Mage, Fighter","Mage, Assassin",1,0,1
7739,"Fighter, Marksman",Fighter,"Tank, Mage","Assassin, Fighter",0,1,1
9353,"Assassin, Fighter","Assassin, Fighter","Fighter, Assassin","Fighter, Support",0,1,1
9352,"Fighter, Mage","Mage, Assassin","Tank, Fighter","Fighter, Mage",0,1,1
9351,"Mage, Fighter",Marksman,Marksman,Marksman,1,0,1
9350,"Fighter, Mage","Mage, Assassin",Fighter,"Marksman, Mage",0,1,1
9349,"Fighter, Mage","Mage, Assassin",Fighter,"Mage, Support",0,1,1
9378,Fighter,"Assassin, Mage","Fighter, Assassin",Marksman,1,0,1
9379,"Fighter, Assassin","Assassin, Mage","Assassin, Fighter","Assassin, Mage",0,1,1
9380,Marksman,"Assassin, Mage","Fighter, Assassin","Assassin, Mage",0,1,1
9381,"Assassin, Fighter",Assassin,"Fighter, Assassin","Mage, Support",1,0,1
9410,"Mage, Fighter","Support, Mage","Fighter, Mage","Assassin, Mage",1,0,1
9408,"Fighter, Tank","Assassin, Mage",Fighter,"Support, Mage",1,0,1
9404,"Tank, Fighter",Mage,Fighter,Marksman,1,0,1
9403,"Mage, Fighter",Mage,"Assassin, Fighter","Mage, Assassin",1,0,1
9402,"Assassin, Fighter",Mage,"Assassin, Fighter","Mage, Assassin",1,0,1
9399,"Fighter, Mage","Mage, Support","Tank, Fighter","Mage, Tank",1,0,1
9396,"Fighter, Tank","Mage, Tank","Fighter, Tank","Mage, Assassin",1,0,1
9395,"Mage, Fighter","Assassin, Mage","Fighter, Mage","Mage, Tank",0,1,1
9394,"Tank, Mage","Mage, Tank","Tank, Fighter","Tank, Mage",0,1,1
9393,"Tank, Fighter",Marksman,"Mage, Fighter","Tank, Mage",1,0,1
9392,"Tank, Mage",Mage,"Fighter, Mage","Tank, Mage",1,0,1
9391,"Fighter, Mage","Assassin, Mage","Tank, Fighter",Marksman,1,0,1
9389,Fighter,"Assassin, Mage","Fighter, Mage","Support, Mage",1,0,1
9388,"Fighter, Assassin","Mage, Assassin","Fighter, Mage","Assassin, Mage",0,1,1
9387,Fighter,"Mage, Tank","Fighter, Mage","Support, Mage",1,0,1
9385,"Tank, Fighter","Mage, Support","Tank, Mage","Assassin, Fighter",0,1,1
9384,"Fighter, Tank","Mage, Tank",Marksman,"Assassin, Mage",1,0,1
9383,"Fighter, Tank","Assassin, Mage","Fighter, Mage","Marksman, Mage",0,1,1
9382,"Fighter, Assassin","Mage, Tank","Fighter, Mage","Mage, Support",1,0,1
9348,Fighter,"Mage, Assassin","Fighter, Tank","Assassin, Mage",0,1,1
9345,Marksman,"Mage, Assassin","Mage, Fighter","Mage, Tank",1,0,1
9282,Marksman,"Assassin, Fighter",Marksman,"Mage, Fighter",0,1,1
9300,"Fighter, Assassin","Mage, Fighter",Marksman,"Mage, Marksman",1,0,1
9313,"Fighter, Mage",Mage,"Tank, Fighter","Mage, Fighter",1,0,1
9312,"Tank, Fighter","Fighter, Marksman","Tank, Fighter","Mage, Fighter",1,0,1
9311,"Tank, Fighter",Mage,"Tank, Fighter","Mage, Fighter",1,0,1
9310,"Tank, Fighter","Tank, Mage","Tank, Fighter","Mage, Fighter",1,0,1
9306,Fighter,"Assassin, Fighter","Tank, Fighter","Support, Mage",1,0,1
9305,Marksman,"Support, Mage",Marksman,"Mage, Fighter",1,0,1
9304,Marksman,"Assassin, Mage","Fighter, Assassin","Mage, Marksman",1,0,1
9303,Marksman,"Mage, Marksman","Assassin, Fighter","Assassin, Fighter",1,0,1
9301,Marksman,"Mage, Support",Marksman,"Mage, Fighter",0,1,1
9299,Marksman,"Mage, Marksman","Fighter, Assassin","Assassin, Mage",0,1,1
9344,Marksman,"Mage, Marksman","Fighter, Mage","Tank, Fighter",1,0,1
9298,Marksman,"Assassin, Mage",Marksman,"Mage, Fighter",0,1,1
9297,"Assassin, Fighter","Assassin, Mage",Marksman,"Assassin, Fighter",1,0,1
9296,Marksman,Mage,"Mage, Fighter","Mage, Fighter",0,1,1
9294,Marksman,"Mage, Fighter",Marksman,"Assassin, Mage",1,0,1
9291,Fighter,"Tank, Mage","Fighter, Mage","Mage, Marksman",0,1,1
9287,"Fighter, Mage","Assassin, Fighter","Tank, Fighter","Assassin, Mage",0,1,1
9286,Fighter,"Support, Mage","Tank, Fighter","Mage, Marksman",0,1,1
9285,"Tank, Fighter","Mage, Marksman","Fighter, Mage","Assassin, Mage",0,1,1
9283,Marksman,Mage,Marksman,Fighter,1,0,1
9314,"Tank, Mage","Fighter, Marksman","Tank, Fighter","Mage, Support",0,1,1
9316,"Fighter, Mage","Assassin, Mage",Fighter,"Assassin, Fighter",1,0,1
9317,Fighter,Mage,"Fighter, Mage","Fighter, Mage",1,0,1
9318,Fighter,"Mage, Tank","Tank, Fighter","Support, Mage",1,0,1
9343,"Tank, Fighter","Support, Mage",Fighter,"Assassin, Mage",1,0,1
9341,"Fighter, Mage","Support, Mage","Mage, Fighter","Assassin, Mage",1,0,1
9339,Fighter,Fighter,"Mage, Fighter",Mage,0,1,1
9338,Fighter,"Mage, Marksman","Fighter, Assassin","Mage, Assassin",1,0,1
9336,"Tank, Fighter","Mage, Marksman","Mage, Fighter","Marksman, Mage",1,0,1
9335,"Fighter, Mage","Support, Mage","Mage, Fighter","Mage, Marksman",0,1,1
9334,"Assassin, Fighter","Assassin, Mage","Mage, Fighter",Mage,0,1,1
9333,Marksman,"Mage, Support","Mage, Fighter","Assassin, Mage",1,0,1
9332,"Fighter, Mage","Assassin, Fighter","Mage, Fighter","Mage, Support",1,0,1
9331,Marksman,"Mage, Marksman","Tank, Fighter",Mage,1,0,1
9330,Marksman,Mage,Fighter,"Fighter, Mage",0,1,1
9328,"Fighter, Tank","Mage, Support",Fighter,"Mage, Tank",1,0,1
9326,"Fighter, Mage","Tank, Mage","Assassin, Fighter","Mage, Assassin",1,0,1
9325,"Tank, Fighter","Mage, Fighter","Tank, Fighter","Tank, Mage",1,0,1
9324,"Fighter, Assassin",Marksman,"Tank, Fighter","Tank, Mage",0,1,1
9323,"Fighter, Mage","Mage, Assassin","Tank, Fighter","Tank, Mage",1,0,1
9322,"Tank, Fighter","Mage, Assassin","Fighter, Mage",Mage,1,0,1
9321,"Tank, Fighter","Mage, Assassin","Fighter, Mage","Mage, Fighter",1,0,1
9319,"Tank, Fighter","Support, Mage",Fighter,"Mage, Marksman",0,1,1
9673,"Fighter, Assassin","Fighter, Assassin","Assassin, Fighter","Mage, Assassin",1,0,1
9674,"Tank, Fighter","Mage, Support","Mage, Fighter","Fighter, Assassin",1,0,1
9675,"Fighter, Assassin","Assassin, Fighter","Assassin, Fighter","Fighter, Marksman",1,0,1
9986,"Fighter, Mage","Marksman, Mage",Fighter,"Assassin, Mage",1,0,1
9995,"Assassin, Mage","Mage, Marksman","Fighter, Assassin","Assassin, Mage",1,0,1
9994,"Fighter, Mage","Assassin, Mage","Assassin, Mage","Assassin, Mage",1,0,1
9993,"Tank, Fighter","Mage, Assassin","Fighter, Mage","Mage, Marksman",1,0,1
9992,"Fighter, Assassin","Mage, Marksman","Fighter, Tank",Mage,1,0,1
9991,"Tank, Fighter",Mage,"Assassin, Mage","Fighter, Mage",0,1,1
9990,"Assassin, Mage","Mage, Marksman","Fighter, Mage","Fighter, Assassin",1,0,1
9989,Fighter,"Assassin, Mage","Fighter, Tank","Assassin, Fighter",1,0,1
9988,"Fighter, Mage",Mage,"Assassin, Mage","Assassin, Mage",1,0,1
9987,"Assassin, Mage","Marksman, Mage","Tank, Fighter","Assassin, Fighter",1,0,1
9985,"Fighter, Mage","Mage, Tank","Assassin, Mage","Mage, Marksman",1,0,1
9997,"Fighter, Mage","Assassin, Fighter",Fighter,"Mage, Marksman",0,1,1
9984,"Fighter, Assassin","Mage, Marksman","Assassin, Mage","Marksman, Mage",0,1,1
9983,"Fighter, Assassin","Mage, Marksman","Assassin, Mage","Mage, Tank",1,0,1
9982,"Fighter, Mage","Fighter, Marksman","Fighter, Assassin","Marksman, Mage",1,0,1
9981,"Tank, Fighter","Mage, Support",Fighter,"Mage, Assassin",1,0,1
9980,"Assassin, Fighter","Fighter, Assassin","Fighter, Mage","Mage, Marksman",1,0,1
9979,"Fighter, Mage","Fighter, Marksman",Fighter,Mage,0,1,1
9978,Fighter,"Marksman, Mage","Fighter, Mage","Marksman, Mage",1,0,1
9977,"Fighter, Mage","Fighter, Assassin",Fighter,"Marksman, Mage",1,0,1
9976,Fighter,Mage,"Assassin, Fighter","Fighter, Assassin",0,1,1
9996,Fighter,"Assassin, Fighter","Fighter, Mage",Mage,1,0,1
9998,"Assassin, Fighter","Mage, Support","Fighter, Mage","Marksman, Mage",0,1,1
9676,"Fighter, Assassin",Mage,"Fighter, Assassin","Mage, Assassin",1,0,1
10010,"Fighter, Mage","Mage, Tank",Fighter,"Support, Mage",1,0,1
10022,Assassin,"Fighter, Assassin","Fighter, Mage","Assassin, Mage",0,1,1
10020,"Mage, Fighter","Marksman, Mage","Fighter, Assassin","Assassin, Fighter",0,1,1
10019,"Assassin, Fighter","Assassin, Mage","Mage, Fighter","Mage, Support",1,0,1
10018,"Assassin, Fighter","Assassin, Mage","Mage, Fighter","Mage, Fighter",0,1,1
10017,"Fighter, Assassin","Fighter, Support","Mage, Fighter",Mage,0,1,1
10016,Marksman,Marksman,"Fighter, Mage","Assassin, Mage",0,1,1
10015,"Support, Mage","Mage, Fighter",Marksman,"Assassin, Mage",1,0,1
10014,Marksman,Mage,"Fighter, Tank","Support, Mage",0,1,1
10011,Fighter,"Fighter, Mage","Assassin, Fighter","Support, Mage",0,1,1
10009,"Fighter, Mage","Mage, Marksman","Fighter, Tank",Mage,0,1,1
9999,Fighter,"Support, Mage","Fighter, Mage","Mage, Tank",1,0,1
10008,"Assassin, Fighter","Fighter, Marksman",Fighter,"Support, Mage",0,1,1
10007,"Fighter, Mage","Assassin, Fighter","Assassin, Mage","Marksman, Mage",1,0,1
10006,"Assassin, Fighter","Fighter, Marksman","Fighter, Tank",Mage,0,1,1
10005,"Tank, Fighter","Mage, Tank",Fighter,"Mage, Marksman",1,0,1
10004,Fighter,"Mage, Tank","Assassin, Fighter","Mage, Assassin",1,0,1
10003,"Fighter, Tank","Fighter, Marksman",Fighter,"Marksman, Mage",1,0,1
10002,Fighter,"Marksman, Mage","Fighter, Mage","Assassin, Fighter",1,0,1
10001,"Fighter, Mage","Fighter, Marksman","Fighter, Assassin","Mage, Marksman",1,0,1
10000,Fighter,"Marksman, Mage","Fighter, Mage",Mage,1,0,1
9975,"Fighter, Mage","Marksman, Mage","Assassin, Fighter","Marksman, Mage",1,0,1
9973,Fighter,"Tank, Mage","Tank, Fighter","Marksman, Mage",1,0,1
9972,"Fighter, Tank","Mage, Support",Fighter,"Tank, Mage",1,0,1
9929,"Fighter, Tank","Assassin, Fighter",Fighter,"Mage, Assassin",0,1,1
9940,"Tank, Fighter",Mage,"Mage, Fighter","Assassin, Mage",1,0,1
9939,"Tank, Fighter","Assassin, Mage","Fighter, Assassin","Assassin, Mage",1,0,1
9938,"Fighter, Assassin","Mage, Assassin","Fighter, Tank","Mage, Assassin",1,0,1
9936,"Fighter, Tank","Assassin, Fighter","Assassin, Fighter","Support, Mage",1,0,1
9935,"Tank, Fighter","Mage, Support","Fighter, Tank","Assassin, Mage",0,1,1
9934,"Tank, Fighter","Support, Mage","Assassin, Fighter","Assassin, Mage",1,0,1
9933,Fighter,"Assassin, Mage","Fighter, Assassin","Assassin, Mage",1,0,1
9932,"Assassin, Fighter","Mage, Assassin","Mage, Fighter","Assassin, Mage",1,0,1
9931,Fighter,"Mage, Assassin","Tank, Fighter","Mage, Assassin",1,0,1
9928,"Tank, Fighter","Assassin, Mage",Fighter,"Fighter, Marksman",1,0,1
9971,"Fighter, Tank","Marksman, Mage",Fighter,"Mage, Assassin",1,0,1
9926,"Tank, Fighter","Assassin, Mage","Assassin, Fighter","Marksman, Mage",0,1,1
9925,"Tank, Fighter","Mage, Assassin","Fighter, Mage","Assassin, Mage",1,0,1
9924,"Tank, Fighter","Mage, Assassin","Tank, Fighter","Assassin, Mage",0,1,1
9923,"Assassin, Fighter","Tank, Mage","Fighter, Assassin","Mage, Assassin",0,1,1
9922,"Tank, Fighter","Mage, Assassin","Tank, Fighter","Fighter, Mage",0,1,1
9920,"Fighter, Tank","Fighter, Mage","Fighter, Tank",Mage,0,1,1
9919,"Tank, Fighter","Assassin, Mage",Fighter,"Marksman, Mage",1,0,1
9918,"Assassin, Fighter","Assassin, Mage",Fighter,Mage,1,0,1
9915,"Tank, Fighter","Assassin, Mage",Fighter,"Assassin, Mage",1,0,1
9941,"Mage, Fighter","Assassin, Mage","Fighter, Tank","Mage, Assassin",1,0,1
9942,"Tank, Fighter","Support, Mage","Assassin, Fighter","Mage, Assassin",0,1,1
9943,"Assassin, Fighter","Marksman, Mage","Tank, Fighter","Mage, Assassin",0,1,1
9944,"Fighter, Assassin","Mage, Assassin","Assassin, Fighter","Marksman, Mage",0,1,1
9970,Assassin,"Mage, Support","Assassin, Fighter","Marksman, Mage",1,0,1
9969,"Fighter, Tank","Tank, Mage","Fighter, Mage","Fighter, Mage",0,1,1
9967,Fighter,"Fighter, Marksman","Fighter, Mage","Mage, Marksman",0,1,1
9966,Fighter,Mage,"Mage, Fighter","Fighter, Assassin",0,1,1
9965,"Fighter, Assassin","Marksman, Mage","Assassin, Fighter","Fighter, Marksman",0,1,1
9963,Fighter,"Marksman, Mage","Fighter, Assassin","Fighter, Marksman",1,0,1
9962,Fighter,"Fighter, Marksman","Fighter, Mage","Marksman, Mage",0,1,1
9961,Fighter,"Mage, Tank","Assassin, Fighter","Marksman, Mage",0,1,1
9960,"Fighter, Mage","Fighter, Marksman",Fighter,"Mage, Support",1,0,1
9959,"Fighter, Mage",Mage,"Fighter, Assassin","Marksman, Mage",0,1,1
9958,"Assassin, Fighter","Fighter, Marksman","Assassin, Mage",Mage,0,1,1
9957,Fighter,"Fighter, Mage","Fighter, Mage","Fighter, Assassin",1,0,1
9956,"Fighter, Assassin",Mage,"Fighter, Tank","Fighter, Marksman",1,0,1
9955,"Mage, Fighter","Marksman, Mage","Assassin, Mage","Mage, Fighter",1,0,1
9953,"Fighter, Assassin","Mage, Marksman",Fighter,"Marksman, Mage",0,1,1
9952,"Tank, Fighter","Marksman, Mage","Fighter, Mage","Assassin, Mage",0,1,1
9951,Fighter,"Assassin, Mage","Assassin, Fighter","Mage, Assassin",0,1,1
9949,"Assassin, Fighter","Assassin, Mage",Fighter,"Mage, Assassin",1,0,1
9947,"Fighter, Assassin","Mage, Marksman","Tank, Fighter","Assassin, Fighter",0,1,1
10023,Assassin,Mage,"Fighter, Tank","Assassin, Mage",0,1,1
10024,"Assassin, Fighter","Mage, Tank",Marksman,"Fighter, Support",1,0,1
10025,"Support, Mage","Assassin, Mage",Marksman,"Support, Mage",1,0,1
10102,"Fighter, Tank","Assassin, Mage",Fighter,"Marksman, Mage",1,0,1
10112,"Fighter, Tank","Mage, Assassin","Fighter, Tank","Mage, Support",1,0,1
10111,"Fighter, Mage","Assassin, Mage","Fighter, Tank","Assassin, Mage",0,1,1
10110,"Fighter, Tank","Assassin, Mage","Mage, Fighter",Mage,1,0,1
10109,"Fighter, Tank","Assassin, Mage","Mage, Fighter","Fighter, Support",1,0,1
10108,"Fighter, Tank","Assassin, Mage",Fighter,"Mage, Tank",0,1,1
10107,"Fighter, Tank","Mage, Tank","Fighter, Tank","Assassin, Mage",1,0,1
10106,"Fighter, Mage","Mage, Tank","Fighter, Mage","Support, Mage",0,1,1
10105,Fighter,"Mage, Fighter","Fighter, Assassin","Mage, Tank",0,1,1
10103,"Fighter, Tank","Mage, Tank",Marksman,"Mage, Fighter",0,1,1
10101,"Assassin, Fighter",Marksman,Fighter,"Mage, Fighter",1,0,1
10089,"Fighter, Mage","Tank, Mage","Support, Mage","Mage, Assassin",0,1,1
10100,"Mage, Fighter",Marksman,"Fighter, Mage","Assassin, Mage",1,0,1
10099,Fighter,"Marksman, Mage","Fighter, Tank",Marksman,1,0,1
10098,"Mage, Fighter",Marksman,"Fighter, Mage",Marksman,0,1,1
10097,Fighter,Marksman,"Assassin, Fighter","Tank, Mage",1,0,1
10096,Fighter,Marksman,"Assassin, Fighter","Assassin, Mage",0,1,1
10095,"Fighter, Assassin",Mage,"Assassin, Fighter","Mage, Tank",0,1,1
10094,"Tank, Fighter","Assassin, Mage","Assassin, Fighter","Mage, Tank",1,0,1
10093,"Assassin, Fighter","Mage, Support","Fighter, Assassin","Tank, Mage",0,1,1
10092,"Assassin, Fighter","Mage, Tank","Support, Mage","Mage, Support",1,0,1
10113,"Fighter, Tank","Mage, Tank","Assassin, Fighter","Mage, Fighter",1,0,1
10115,"Fighter, Mage","Mage, Marksman","Fighter, Mage","Marksman, Mage",1,0,1
10116,"Mage, Fighter",Fighter,"Fighter, Mage","Mage, Marksman",1,0,1
10118,Marksman,"Mage, Marksman",Marksman,"Assassin, Fighter",0,1,1
10151,"Fighter, Mage","Mage, Fighter","Mage, Fighter","Mage, Tank",1,0,1
10148,"Mage, Fighter","Mage, Marksman","Fighter, Mage","Mage, Tank",1,0,1
10147,"Fighter, Tank",Fighter,Fighter,"Mage, Assassin",0,1,1
10146,"Fighter, Tank","Mage, Marksman","Mage, Fighter",Mage,1,0,1
10144,"Fighter, Tank","Mage, Support","Fighter, Mage","Assassin, Mage",0,1,1
10142,"Fighter, Tank","Mage, Marksman","Fighter, Mage","Mage, Assassin",0,1,1
10141,"Mage, Fighter","Mage, Assassin","Fighter, Mage","Mage, Fighter",0,1,1
10140,Fighter,"Mage, Assassin","Fighter, Tank",Fighter,1,0,1
10136,"Mage, Fighter","Mage, Marksman","Fighter, Tank","Marksman, Mage",0,1,1
10135,"Fighter, Assassin","Mage, Tank","Mage, Fighter",Mage,1,0,1
10134,Marksman,"Mage, Tank","Assassin, Fighter","Assassin, Mage",0,1,1
10131,Marksman,"Mage, Support",Fighter,"Mage, Marksman",0,1,1
10130,"Fighter, Mage","Assassin, Mage","Fighter, Assassin","Mage, Marksman",1,0,1
10127,"Fighter, Tank","Mage, Tank","Fighter, Mage","Assassin, Mage",1,0,1
10125,Marksman,Marksman,Marksman,"Mage, Support",0,1,1
10124,"Fighter, Assassin",Mage,Marksman,"Assassin, Mage",1,0,1
10123,"Mage, Fighter","Assassin, Mage","Fighter, Mage","Support, Mage",0,1,1
10122,"Fighter, Mage","Mage, Support",Marksman,"Assassin, Mage",1,0,1
10119,Marksman,"Mage, Support",Marksman,"Assassin, Mage",0,1,1
10090,"Fighter, Tank","Tank, Mage","Fighter, Mage","Assassin, Mage",0,1,1
10088,"Assassin, Fighter","Tank, Mage","Fighter, Assassin","Mage, Tank",0,1,1
10027,"Tank, Fighter",Marksman,"Assassin, Fighter","Mage, Support",0,1,1
10041,Marksman,"Fighter, Marksman","Mage, Fighter","Mage, Fighter",1,0,1
10055,"Assassin, Fighter","Mage, Support","Fighter, Tank","Assassin, Fighter",0,1,1
10054,"Fighter, Tank","Assassin, Mage","Fighter, Assassin","Fighter, Marksman",1,0,1
10052,Marksman,"Mage, Tank","Fighter, Assassin","Fighter, Support",0,1,1
10050,Marksman,"Mage, Fighter","Assassin, Fighter","Assassin, Mage",0,1,1
10049,"Mage, Fighter","Assassin, Fighter","Support, Mage","Assassin, Mage",1,0,1
10048,"Assassin, Fighter","Mage, Tank","Mage, Fighter","Assassin, Fighter",1,0,1
10047,"Fighter, Mage","Mage, Assassin",Marksman,"Assassin, Fighter",0,1,1
10045,"Mage, Fighter","Mage, Tank","Support, Mage","Mage, Support",0,1,1
10042,"Fighter, Assassin","Assassin, Mage","Support, Mage","Mage, Fighter",1,0,1
10040,"Mage, Fighter","Assassin, Fighter","Fighter, Assassin","Fighter, Marksman",1,0,1
10087,"Assassin, Fighter","Assassin, Mage","Fighter, Tank","Mage, Fighter",1,0,1
10039,Marksman,"Fighter, Marksman","Fighter, Assassin","Mage, Tank",0,1,1
10036,Marksman,"Mage, Assassin","Assassin, Fighter","Assassin, Mage",0,1,1
10035,"Support, Mage","Mage, Tank","Fighter, Mage","Mage, Fighter",0,1,1
10034,"Fighter, Mage","Assassin, Fighter","Mage, Fighter",Mage,1,0,1
10033,"Fighter, Mage","Assassin, Fighter","Assassin, Fighter","Assassin, Mage",0,1,1
10032,"Fighter, Mage","Mage, Support","Mage, Fighter","Assassin, Fighter",1,0,1
10031,Marksman,"Mage, Support","Tank, Fighter","Assassin, Mage",0,1,1
10029,"Mage, Fighter","Mage, Support","Assassin, Fighter","Tank, Mage",1,0,1
10028,"Tank, Fighter",Mage,"Assassin, Fighter","Tank, Mage",1,0,1
10056,Marksman,"Support, Mage","Assassin, Fighter","Assassin, Fighter",1,0,1
10057,"Mage, Fighter","Assassin, Fighter","Fighter, Assassin","Support, Mage",0,1,1
10058,"Assassin, Fighter","Assassin, Mage",Marksman,"Mage, Tank",1,0,1
10059,"Fighter, Mage","Mage, Tank","Fighter, Assassin","Assassin, Fighter",1,0,1
10086,"Tank, Fighter",Marksman,"Support, Mage","Mage, Support",1,0,1
10085,"Fighter, Tank","Mage, Support","Fighter, Assassin","Assassin, Mage",1,0,1
10084,"Fighter, Tank","Mage, Support","Assassin, Fighter","Assassin, Mage",0,1,1
10083,"Tank, Mage","Fighter, Marksman","Fighter, Mage","Mage, Support",0,1,1
10082,"Tank, Fighter","Mage, Support","Tank, Mage","Mage, Tank",1,0,1
10081,"Tank, Fighter","Mage, Tank","Fighter, Mage",Marksman,0,1,1
10080,"Mage, Fighter","Fighter, Marksman","Tank, Mage",Mage,1,0,1
10078,"Tank, Mage",Mage,"Mage, Fighter","Mage, Support",0,1,1
10077,"Mage, Fighter","Fighter, Assassin","Tank, Fighter","Mage, Support",1,0,1
10076,"Assassin, Fighter","Tank, Mage","Tank, Mage","Mage, Support",0,1,1
10074,"Tank, Mage",Mage,"Fighter, Mage",Marksman,1,0,1
10073,"Fighter, Mage","Assassin, Fighter","Tank, Mage","Mage, Tank",1,0,1
10072,"Mage, Fighter","Assassin, Fighter","Tank, Mage",Mage,0,1,1
10071,"Tank, Mage","Assassin, Fighter","Tank, Fighter","Mage, Support",1,0,1
10069,"Fighter, Mage","Mage, Support",Marksman,"Tank, Mage",1,0,1
10066,"Mage, Fighter","Mage, Tank","Fighter, Assassin",Marksman,1,0,1
10063,"Assassin, Fighter","Mage, Support","Tank, Mage","Mage, Tank",1,0,1
10061,"Tank, Mage","Mage, Support","Fighter, Mage","Mage, Tank",1,0,1
10060,Marksman,"Fighter, Marksman","Fighter, Mage","Mage, Fighter",0,1,1
9914,"Tank, Fighter","Assassin, Fighter","Fighter, Assassin","Marksman, Mage",1,0,1
9913,"Assassin, Fighter","Support, Mage","Tank, Fighter","Assassin, Mage",1,0,1
9912,"Tank, Fighter","Mage, Assassin","Assassin, Mage","Support, Mage",1,0,1
9755,Marksman,"Mage, Marksman","Fighter, Tank",Mage,1,0,1
9766,Marksman,Mage,"Mage, Fighter","Fighter, Support",1,0,1
9765,"Mage, Fighter","Mage, Fighter",Marksman,"Mage, Fighter",1,0,1
9764,"Mage, Fighter","Assassin, Mage","Fighter, Tank","Mage, Marksman",0,1,1
9763,"Fighter, Tank","Assassin, Mage",Marksman,"Mage, Fighter",0,1,1
9762,"Mage, Fighter","Mage, Fighter","Fighter, Assassin","Support, Mage",1,0,1
9760,Fighter,"Mage, Fighter","Fighter, Mage","Marksman, Mage",0,1,1
9758,Fighter,"Mage, Marksman","Fighter, Mage","Mage, Assassin",0,1,1
9757,"Fighter, Tank","Mage, Tank","Fighter, Mage",Mage,1,0,1
9756,Marksman,Mage,"Mage, Assassin",Mage,0,1,1
9754,"Fighter, Tank",Mage,"Assassin, Fighter","Mage, Assassin",0,1,1
9741,"Mage, Fighter","Assassin, Fighter","Fighter, Tank","Support, Mage",1,0,1
9753,Marksman,"Mage, Support","Fighter, Mage","Mage, Fighter",0,1,1
9752,"Support, Mage",Mage,"Fighter, Mage","Assassin, Fighter",1,0,1
9751,"Assassin, Fighter","Assassin, Mage","Mage, Fighter","Marksman, Mage",1,0,1
9750,Marksman,"Mage, Marksman",Fighter,"Mage, Tank",0,1,1
9749,"Assassin, Fighter","Support, Mage",Fighter,"Mage, Marksman",0,1,1
9746,Fighter,"Mage, Marksman","Fighter, Assassin","Assassin, Mage",0,1,1
9745,"Mage, Fighter","Mage, Marksman","Fighter, Tank",Mage,1,0,1
9744,"Fighter, Mage","Assassin, Fighter","Mage, Fighter","Mage, Marksman",0,1,1
9743,"Mage, Fighter","Assassin, Fighter","Fighter, Tank","Mage, Support",1,0,1
9767,"Tank, Fighter","Fighter, Support","Fighter, Mage","Mage, Support",0,1,1
9768,"Tank, Fighter","Mage, Assassin","Fighter, Mage",Marksman,1,0,1
9770,Fighter,"Mage, Assassin","Tank, Fighter","Support, Mage",1,0,1
9771,"Mage, Fighter","Support, Mage",Marksman,"Marksman, Assassin",0,1,1
9793,Marksman,"Mage, Tank","Assassin, Fighter","Fighter, Support",0,1,1
9791,"Assassin, Fighter","Mage, Support","Support, Mage","Mage, Tank",1,0,1
9789,"Fighter, Mage","Support, Mage","Assassin, Fighter","Mage, Assassin",1,0,1
9788,"Fighter, Tank",Marksman,"Fighter, Mage","Assassin, Mage",0,1,1
9787,"Fighter, Mage","Assassin, Mage",Tank,"Mage, Support",0,1,1
9786,"Fighter, Mage","Mage, Assassin","Assassin, Fighter","Support, Mage",0,1,1
9785,"Assassin, Fighter",Fighter,"Mage, Fighter","Support, Mage",1,0,1
9784,"Fighter, Assassin","Support, Mage","Mage, Fighter",Marksman,0,1,1
9783,"Fighter, Mage","Mage, Assassin","Mage, Fighter","Assassin, Mage",1,0,1
9782,"Mage, Fighter","Mage, Marksman","Tank, Fighter","Mage, Assassin",0,1,1
9781,Marksman,"Support, Mage","Fighter, Assassin","Fighter, Support",1,0,1
9779,"Assassin, Fighter",Fighter,"Fighter, Mage","Mage, Marksman",1,0,1
9778,"Assassin, Fighter","Marksman, Mage",Fighter,"Mage, Assassin",0,1,1
9777,"Fighter, Mage","Mage, Assassin",Marksman,"Mage, Marksman",0,1,1
9776,"Assassin, Mage","Marksman, Assassin","Assassin, Fighter","Mage, Support",0,1,1
9775,Marksman,"Mage, Assassin","Mage, Fighter","Assassin, Fighter",1,0,1
9774,Marksman,Mage,"Marksman, Fighter",Marksman,0,1,1
9773,"Fighter, Tank",Marksman,Fighter,Mage,1,0,1
9772,Fighter,"Mage, Assassin","Assassin, Fighter",Marksman,0,1,1
9742,"Fighter, Assassin","Mage, Marksman","Fighter, Mage","Mage, Support",1,0,1
9740,"Mage, Fighter",Mage,"Fighter, Assassin","Support, Mage",1,0,1
9795,"Fighter, Mage","Assassin, Fighter","Mage, Fighter","Assassin, Fighter",0,1,1
9701,"Tank, Fighter","Mage, Support","Assassin, Fighter","Support, Mage",0,1,1
9712,"Fighter, Mage","Support, Mage","Assassin, Mage","Mage, Support",1,0,1
9711,"Assassin, Mage","Mage, Support","Fighter, Mage","Fighter, Mage",0,1,1
9710,"Mage, Fighter",Mage,Fighter,"Fighter, Mage",0,1,1
9709,"Mage, Fighter","Assassin, Mage","Fighter, Mage",Mage,1,0,1
9708,"Mage, Fighter","Support, Mage",Fighter,"Fighter, Mage",1,0,1
9707,"Mage, Fighter",Mage,"Fighter, Mage","Mage, Fighter",0,1,1
9706,"Mage, Fighter","Assassin, Mage",Fighter,"Assassin, Fighter",1,0,1
9704,"Tank, Fighter",Marksman,"Fighter, Tank","Mage, Support",1,0,1
9702,"Fighter, Mage",Mage,"Tank, Mage",Mage,1,0,1
9698,"Tank, Mage","Assassin, Mage",Fighter,Mage,1,0,1
9739,"Fighter, Assassin","Fighter, Assassin",Fighter,Mage,0,1,1
9696,"Fighter, Tank","Fighter, Marksman","Mage, Fighter","Mage, Support",0,1,1
9695,"Tank, Mage","Mage, Tank","Fighter, Mage",Mage,1,0,1
9692,"Fighter, Assassin","Mage, Support","Assassin, Mage","Mage, Support",0,1,1
9691,"Tank, Fighter","Fighter, Assassin","Assassin, Fighter","Assassin, Fighter",1,0,1
9687,"Assassin, Fighter","Assassin, Mage","Tank, Fighter","Fighter, Assassin",0,1,1
9686,"Assassin, Fighter","Mage, Assassin","Fighter, Assassin","Fighter, Assassin",0,1,1
9683,"Assassin, Mage","Support, Mage","Assassin, Fighter","Assassin, Mage",1,0,1
9682,"Fighter, Assassin","Support, Mage","Assassin, Fighter",Mage,1,0,1
9678,"Assassin, Fighter","Fighter, Assassin","Fighter, Assassin","Mage, Support",0,1,1
9713,"Fighter, Mage",Mage,"Tank, Fighter","Fighter, Mage",1,0,1
9714,"Mage, Fighter","Marksman, Mage","Fighter, Mage","Support, Mage",0,1,1
9715,"Fighter, Mage",Mage,"Assassin, Mage",Mage,0,1,1
9716,Fighter,"Mage, Fighter","Fighter, Assassin","Support, Mage",1,0,1
9738,Fighter,"Fighter, Assassin","Mage, Fighter","Fighter, Tank",0,1,1
9736,"Fighter, Mage","Fighter, Assassin","Fighter, Assassin",Mage,0,1,1
9735,"Fighter, Assassin","Fighter, Assassin",Fighter,"Mage, Support",1,0,1
9734,"Assassin, Fighter","Fighter, Marksman","Assassin, Fighter","Assassin, Fighter",1,0,1
9733,"Fighter, Assassin","Fighter, Assassin","Assassin, Fighter","Fighter, Marksman",0,1,1
9732,"Assassin, Fighter","Fighter, Marksman","Assassin, Fighter","Mage, Fighter",1,0,1
9731,"Tank, Fighter","Mage, Support","Assassin, Fighter","Fighter, Marksman",0,1,1
9730,"Assassin, Fighter","Mage, Support","Tank, Fighter","Fighter, Marksman",0,1,1
9729,"Assassin, Fighter","Assassin, Fighter","Assassin, Fighter","Fighter, Marksman",1,0,1
9728,"Mage, Fighter","Support, Mage",Fighter,"Assassin, Fighter",1,0,1
9727,"Mage, Fighter","Mage, Marksman","Fighter, Assassin","Mage, Assassin",0,1,1
9726,"Assassin, Fighter",Fighter,"Fighter, Assassin","Support, Mage",1,0,1
9725,"Assassin, Fighter","Support, Mage","Fighter, Mage","Fighter, Assassin",0,1,1
9724,Fighter,"Assassin, Mage","Fighter, Assassin","Support, Mage",1,0,1
9722,"Mage, Fighter","Mage, Support","Fighter, Tank","Mage, Tank",0,1,1
9721,"Mage, Fighter","Fighter, Marksman",Marksman,"Mage, Tank",1,0,1
9719,"Assassin, Fighter","Mage, Fighter",Fighter,"Mage, Assassin",1,0,1
9718,Marksman,"Mage, Fighter","Mage, Fighter","Fighter, Marksman",1,0,1
9717,Fighter,"Mage, Tank","Tank, Fighter","Marksman, Mage",0,1,1
9794,"Mage, Fighter","Mage, Support","Assassin, Fighter","Mage, Tank",0,1,1
9796,"Assassin, Fighter","Mage, Tank","Assassin, Fighter","Assassin, Mage",1,0,1
9911,Fighter,"Assassin, Fighter","Assassin, Fighter","Mage, Support",1,0,1
9871,"Mage, Fighter","Mage, Marksman","Fighter, Mage","Assassin, Fighter",1,0,1
9881,Fighter,"Mage, Fighter","Mage, Fighter","Support, Mage",0,1,1
9880,"Fighter, Tank","Mage, Marksman","Mage, Fighter","Assassin, Mage",0,1,1
9879,Marksman,"Mage, Marksman",Fighter,"Marksman, Mage",0,1,1
9878,"Fighter, Tank","Mage, Marksman","Fighter, Mage",Mage,1,0,1
9877,Fighter,"Mage, Tank","Fighter, Tank","Mage, Support",1,0,1
9876,Marksman,"Mage, Marksman","Mage, Fighter","Assassin, Mage",0,1,1
9875,"Fighter, Assassin","Mage, Marksman","Fighter, Mage",Mage,0,1,1
9873,"Assassin, Fighter","Mage, Fighter","Mage, Fighter","Support, Mage",0,1,1
9872,"Assassin, Fighter","Mage, Marksman","Mage, Fighter","Assassin, Fighter",0,1,1
9869,"Fighter, Mage",Mage,Marksman,"Mage, Marksman",0,1,1
9857,"Fighter, Mage","Fighter, Assassin","Assassin, Fighter",Mage,1,0,1
9868,Fighter,"Assassin, Fighter","Assassin, Fighter","Mage, Marksman",1,0,1
9867,"Fighter, Mage","Mage, Marksman",Fighter,"Mage, Fighter",0,1,1
9866,"Assassin, Fighter","Mage, Tank",Fighter,"Mage, Fighter",1,0,1
9864,"Fighter, Tank","Mage, Marksman","Mage, Fighter","Marksman, Mage",1,0,1
9863,"Fighter, Tank","Support, Mage","Mage, Fighter","Fighter, Support",1,0,1
9862,"Assassin, Mage","Mage, Support","Mage, Fighter","Mage, Assassin",0,1,1
9861,"Fighter, Assassin","Assassin, Fighter","Assassin, Fighter","Fighter, Support",1,0,1
9860,"Fighter, Tank","Support, Mage","Fighter, Mage","Mage, Marksman",1,0,1
9859,Fighter,"Fighter, Mage","Fighter, Mage","Assassin, Fighter",0,1,1
9882,"Assassin, Fighter",Mage,"Mage, Fighter","Mage, Fighter",0,1,1
9883,"Fighter, Mage","Mage, Marksman","Mage, Fighter","Support, Mage",1,0,1
9884,"Fighter, Tank","Mage, Fighter","Assassin, Fighter",Mage,0,1,1
9885,"Mage, Fighter","Mage, Tank",Marksman,"Assassin, Mage",1,0,1
9910,"Assassin, Fighter","Assassin, Mage","Assassin, Fighter","Marksman, Mage",1,0,1
9909,"Fighter, Assassin","Assassin, Mage","Tank, Fighter",Mage,1,0,1
9908,"Fighter, Mage","Fighter, Mage",Fighter,"Assassin, Fighter",0,1,1
9907,Fighter,"Tank, Mage","Fighter, Mage","Assassin, Fighter",1,0,1
9906,"Fighter, Assassin","Assassin, Fighter","Assassin, Fighter","Assassin, Mage",0,1,1
9905,"Assassin, Fighter","Marksman, Mage",Marksman,"Assassin, Fighter",0,1,1
9904,"Fighter, Assassin","Assassin, Mage","Mage, Fighter","Mage, Marksman",1,0,1
9903,"Mage, Fighter","Mage, Tank","Fighter, Assassin","Mage, Marksman",0,1,1
9901,"Fighter, Assassin","Mage, Fighter",Fighter,"Mage, Tank",1,0,1
9900,"Fighter, Assassin",Marksman,"Fighter, Mage",Fighter,0,1,1
9899,"Fighter, Assassin","Mage, Marksman","Fighter, Mage","Assassin, Mage",0,1,1
9897,"Mage, Fighter",Fighter,"Assassin, Fighter","Mage, Marksman",1,0,1
9896,"Mage, Fighter",Fighter,"Assassin, Fighter","Marksman, Fighter",0,1,1
9895,"Assassin, Fighter",Marksman,"Fighter, Mage",Fighter,1,0,1
9894,"Fighter, Mage",Mage,"Mage, Fighter","Mage, Assassin",1,0,1
9893,"Fighter, Mage",Marksman,"Mage, Fighter","Marksman, Fighter",1,0,1
9892,"Fighter, Mage",Fighter,"Fighter, Assassin",Marksman,0,1,1
9891,"Assassin, Fighter","Support, Mage","Fighter, Assassin","Mage, Marksman",1,0,1
9886,"Fighter, Mage","Marksman, Mage",Marksman,Mage,1,0,1
9858,"Mage, Fighter","Mage, Tank","Fighter, Mage","Mage, Assassin",1,0,1
9856,"Mage, Fighter",Mage,"Fighter, Mage","Fighter, Mage",1,0,1
9797,Marksman,"Mage, Support","Tank, Fighter","Mage, Support",1,0,1
9811,"Assassin, Fighter","Mage, Support","Mage, Support","Mage, Fighter",1,0,1
9821,Fighter,Mage,"Assassin, Fighter","Mage, Fighter",1,0,1
9820,"Fighter, Tank",Marksman,"Support, Mage","Mage, Fighter",1,0,1
9819,"Assassin, Fighter","Assassin, Mage","Fighter, Assassin","Assassin, Mage",1,0,1
9818,"Assassin, Fighter","Assassin, Mage","Assassin, Fighter","Mage, Fighter",1,0,1
9817,"Mage, Fighter","Mage, Fighter","Assassin, Fighter","Mage, Support",0,1,1
9816,"Mage, Fighter","Mage, Support",Fighter,"Mage, Tank",1,0,1
9815,Fighter,Mage,"Tank, Fighter","Mage, Tank",1,0,1
9814,Fighter,"Assassin, Mage","Mage, Fighter","Fighter, Assassin",1,0,1
9812,"Assassin, Fighter",Marksman,"Mage, Fighter","Fighter, Marksman",0,1,1
9810,Fighter,"Mage, Support","Support, Mage","Mage, Fighter",1,0,1
9854,"Fighter, Assassin","Assassin, Fighter","Mage, Fighter","Mage, Assassin",1,0,1
9809,"Fighter, Tank","Mage, Support","Fighter, Tank","Mage, Assassin",1,0,1
9808,"Fighter, Tank","Assassin, Fighter","Assassin, Fighter","Mage, Support",0,1,1
9807,"Support, Mage",Mage,Fighter,Marksman,1,0,1
9805,"Assassin, Fighter",Mage,"Support, Mage",Marksman,0,1,1
9804,"Tank, Fighter","Assassin, Mage",Fighter,"Mage, Tank",1,0,1
9802,Fighter,"Mage, Tank","Fighter, Tank","Mage, Assassin",0,1,1
9801,"Fighter, Tank","Assassin, Fighter","Fighter, Assassin","Tank, Fighter",0,1,1
9800,"Fighter, Tank",Mage,"Assassin, Fighter",Marksman,1,0,1
9799,"Assassin, Fighter","Mage, Support","Support, Mage","Assassin, Fighter",0,1,1
9822,"Support, Mage",Marksman,"Fighter, Tank","Mage, Support",0,1,1
9823,"Assassin, Fighter",Mage,"Assassin, Fighter","Fighter, Marksman",1,0,1
9826,"Fighter, Assassin","Mage, Assassin",Marksman,"Assassin, Mage",0,1,1
9827,"Fighter, Tank","Assassin, Fighter",Marksman,Mage,0,1,1
9852,"Fighter, Assassin","Assassin, Fighter","Fighter, Mage","Assassin, Mage",1,0,1
9851,"Fighter, Tank","Mage, Support","Fighter, Mage","Tank, Mage",1,0,1
9849,Fighter,"Assassin, Fighter","Fighter, Tank","Mage, Support",0,1,1
9847,"Tank, Fighter","Assassin, Fighter",Fighter,"Mage, Tank",1,0,1
9844,Marksman,"Mage, Assassin",Fighter,"Mage, Fighter",1,0,1
9843,Fighter,"Marksman, Mage","Mage, Fighter","Assassin, Fighter",0,1,1
9842,Marksman,Mage,"Mage, Fighter","Fighter, Marksman",0,1,1
9841,Marksman,"Mage, Assassin","Marksman, Fighter","Assassin, Mage",0,1,1
9840,"Fighter, Assassin","Support, Mage",Marksman,Mage,0,1,1
9839,Marksman,"Mage, Assassin","Mage, Fighter","Mage, Marksman",1,0,1
9838,Marksman,"Mage, Fighter","Marksman, Fighter","Support, Mage",0,1,1
9836,"Assassin, Fighter",Mage,"Fighter, Assassin",Fighter,0,1,1
9835,Fighter,"Mage, Assassin","Assassin, Fighter","Support, Mage",0,1,1
9834,Marksman,Fighter,"Fighter, Assassin","Mage, Assassin",1,0,1
9833,"Fighter, Assassin","Support, Mage",Fighter,Mage,1,0,1
9831,"Mage, Fighter","Mage, Fighter","Tank, Fighter","Assassin, Mage",1,0,1
9830,"Fighter, Assassin","Support, Mage",Marksman,"Mage, Fighter",1,0,1
9829,"Fighter, Assassin","Mage, Assassin","Mage, Fighter","Assassin, Mage",0,1,1
9828,Marksman,"Mage, Assassin",Fighter,"Assassin, Fighter",0,1,1
2991,"Tank, Fighter",Tank,"Fighter, Tank","Support, Mage",0,1,1
7607,"Mage, Marksman","Tank, Fighter","Support, Mage","Fighter, Mage",0,1,1
7738,"Fighter, Marksman","Fighter, Tank","Tank, Mage","Assassin, Fighter",0,1,1
3881,"Mage, Fighter","Support, Fighter","Fighter, Assassin","Mage, Assassin",1,0,1
5363,Marksman,"Fighter, Tank","Marksman, Fighter","Support, Tank",1,0,1
5362,"Marksman, Assassin","Tank, Support",Marksman,"Mage, Marksman",1,0,1
3879,"Mage, Fighter","Mage, Assassin","Support, Mage","Support, Mage",1,0,1
5360,"Marksman, Support","Support, Tank","Marksman, Support","Tank, Support",1,0,1
3880,Marksman,"Tank, Fighter","Fighter, Mage","Fighter, Tank",1,0,1
5358,"Marksman, Assassin","Mage, Marksman",Marksman,"Support, Tank",1,0,1
5357,"Marksman, Support","Support, Fighter",Marksman,"Mage, Marksman",0,1,1
5356,"Marksman, Support","Mage, Marksman",Marksman,"Support, Fighter",1,0,1
5355,"Marksman, Support","Support, Tank",Marksman,"Mage, Marksman",1,0,1
5354,"Marksman, Support","Mage, Marksman",Marksman,"Tank, Support",0,1,1
5352,Marksman,"Tank, Support","Marksman, Support",Support,0,1,1
5340,"Mage, Marksman",Marksman,"Marksman, Assassin","Mage, Support",1,0,1
5351,"Marksman, Support","Fighter, Tank","Marksman, Assassin","Tank, Support",1,0,1
5350,"Marksman, Support",Marksman,"Mage, Marksman","Mage, Support",1,0,1
5349,"Marksman, Assassin","Mage, Assassin","Marksman, Support","Support, Tank",0,1,1
5348,"Marksman, Support","Mage, Assassin","Marksman, Assassin","Tank, Support",1,0,1
5347,"Marksman, Assassin","Tank, Support","Marksman, Support","Mage, Assassin",0,1,1
5346,"Marksman, Support","Mage, Assassin","Marksman, Mage","Fighter, Tank",1,0,1
5345,"Marksman, Support","Tank, Fighter",Mage,"Fighter, Tank",0,1,1
5344,"Marksman, Support","Mage, Assassin","Marksman, Assassin","Tank, Fighter",0,1,1
5343,"Marksman, Mage","Tank, Support",Mage,"Mage, Assassin",0,1,1
5342,Marksman,"Mage, Support","Marksman, Assassin",Marksman,1,0,1
5364,Marksman,"Tank, Fighter","Marksman, Support","Support, Mage",0,1,1
5365,"Marksman, Support","Support, Tank",Marksman,"Fighter, Tank",0,1,1
5366,"Marksman, Assassin","Support, Mage",Marksman,"Fighter, Tank",1,0,1
5367,Marksman,"Tank, Fighter","Marksman, Assassin","Fighter, Tank",1,0,1
5389,Marksman,Mage,"Marksman, Assassin","Tank, Support",0,1,1
5388,"Fighter, Marksman","Tank, Support","Marksman, Mage","Tank, Fighter",1,0,1
5387,"Marksman, Mage","Tank, Support","Fighter, Marksman","Support, Fighter",1,0,1
5386,"Marksman, Mage","Mage, Support","Marksman, Mage","Mage, Marksman",0,1,1
5385,"Fighter, Marksman","Support, Fighter",Marksman,"Fighter, Assassin",1,0,1
5384,Marksman,"Tank, Support","Fighter, Marksman","Support, Tank",0,1,1
3874,"Fighter, Assassin","Support, Fighter",Marksman,"Tank, Support",1,0,1
5382,"Marksman, Mage","Support, Fighter",Marksman,"Mage, Marksman",1,0,1
5381,Marksman,"Tank, Fighter","Marksman, Assassin","Mage, Marksman",0,1,1
5380,"Fighter, Marksman","Tank, Support",Marksman,Mage,1,0,1
3877,"Assassin, Fighter","Fighter, Tank","Mage, Fighter","Mage, Support",1,0,1
5378,"Marksman, Mage","Tank, Support",Marksman,Mage,1,0,1
5377,Marksman,"Support, Mage","Fighter, Marksman","Support, Mage",0,1,1
5376,Marksman,"Support, Fighter","Marksman, Assassin",Mage,1,0,1
5375,Marksman,"Mage, Support","Fighter, Marksman","Support, Fighter",0,1,1
5374,"Fighter, Marksman","Support, Fighter",Marksman,"Tank, Fighter",1,0,1
5373,"Marksman, Mage","Support, Fighter",Marksman,Mage,0,1,1
5372,Marksman,"Mage, Support",Marksman,"Tank, Mage",1,0,1
5371,Marksman,"Fighter, Assassin",Marksman,"Support, Fighter",0,1,1
5370,"Marksman, Mage","Support, Fighter","Fighter, Marksman","Mage, Support",0,1,1
5369,"Marksman, Mage",Mage,"Marksman, Mage","Support, Tank",0,1,1
5341,"Marksman, Assassin","Mage, Assassin",Marksman,Marksman,1,0,1
3882,"Fighter, Mage","Tank, Fighter",Marksman,"Tank, Support",0,1,1
5391,Mage,"Support, Tank","Marksman, Mage","Mage, Support",1,0,1
5302,"Mage, Marksman","Mage, Support","Marksman, Support",Marksman,1,0,1
5312,Marksman,"Fighter, Mage","Marksman, Mage","Mage, Assassin",0,1,1
5311,Marksman,"Tank, Support",Marksman,"Mage, Assassin",0,1,1
5310,"Marksman, Mage","Support, Tank","Marksman, Mage","Fighter, Mage",1,0,1
5309,Mage,"Support, Mage","Marksman, Assassin","Support, Mage",1,0,1
5308,Mage,"Mage, Assassin","Marksman, Assassin","Support, Tank",0,1,1
5307,"Marksman, Mage","Mage, Assassin","Marksman, Mage","Tank, Support",1,0,1
5306,"Marksman, Mage","Fighter, Tank","Marksman, Mage","Support, Mage",1,0,1
3884,"Fighter, Assassin","Mage, Assassin",Marksman,"Tank, Support",1,0,1
5304,Mage,"Support, Tank","Marksman, Mage","Support, Mage",1,0,1
5303,"Marksman, Mage","Mage, Support","Mage, Marksman","Mage, Support",0,1,1
5301,"Marksman, Mage","Mage, Support","Mage, Marksman","Support, Tank",1,0,1
5338,"Marksman, Support","Support, Tank","Fighter, Marksman","Mage, Support",1,0,1
5300,"Marksman, Assassin","Fighter, Tank","Marksman, Support","Mage, Support",1,0,1
5299,"Marksman, Support","Support, Fighter","Marksman, Mage","Tank, Mage",0,1,1
5298,"Mage, Marksman","Support, Tank","Marksman, Assassin","Support, Fighter",0,1,1
5297,"Marksman, Mage","Support, Fighter","Marksman, Mage","Tank, Fighter",1,0,1
5296,"Marksman, Mage","Support, Fighter",Marksman,"Mage, Assassin",1,0,1
3885,Marksman,"Support, Tank","Assassin, Fighter","Fighter, Tank",1,0,1
5294,"Mage, Marksman","Support, Tank",Marksman,"Support, Fighter",0,1,1
5293,"Mage, Marksman","Fighter, Tank","Marksman, Support","Mage, Support",1,0,1
5292,"Marksman, Mage","Mage, Support","Marksman, Assassin",Mage,1,0,1
5291,"Marksman, Assassin","Fighter, Tank","Marksman, Support","Support, Fighter",0,1,1
5313,"Marksman, Mage",Mage,"Marksman, Support","Support, Tank",1,0,1
5314,Marksman,"Mage, Support","Mage, Marksman","Mage, Support",0,1,1
5315,Marksman,"Support, Fighter","Mage, Marksman","Mage, Support",0,1,1
5316,"Marksman, Mage","Mage, Marksman","Marksman, Assassin","Support, Mage",0,1,1
5337,"Marksman, Support","Fighter, Tank","Marksman, Assassin","Mage, Support",1,0,1
5336,"Marksman, Assassin","Support, Mage","Marksman, Support","Support, Tank",0,1,1
5335,"Marksman, Support","Support, Mage","Marksman, Assassin","Tank, Support",1,0,1
5334,"Marksman, Mage","Tank, Fighter","Marksman, Support","Support, Fighter",0,1,1
5333,"Marksman, Assassin","Fighter, Tank",Marksman,Support,1,0,1
5332,Marksman,"Support, Fighter","Mage, Marksman","Support, Mage",1,0,1
5331,Marksman,"Support, Tank","Marksman, Support","Tank, Fighter",1,0,1
5330,Marksman,"Tank, Fighter",Marksman,Support,1,0,1
5329,"Marksman, Support","Support, Tank",Marksman,"Tank, Mage",1,0,1
5328,"Marksman, Support",Support,"Mage, Marksman","Support, Fighter",0,1,1
5327,"Mage, Marksman","Support, Fighter",Marksman,Support,1,0,1
5326,"Tank, Fighter","Fighter, Tank","Marksman, Assassin","Fighter, Mage",0,1,1
5325,"Fighter, Assassin","Fighter, Mage","Support, Fighter",Mage,1,0,1
3883,Marksman,"Support, Tank","Mage, Fighter","Fighter, Tank",1,0,1
5323,"Marksman, Assassin","Tank, Fighter",Marksman,"Fighter, Tank",1,0,1
5322,"Marksman, Support","Tank, Support",Marksman,"Fighter, Tank",1,0,1
5321,"Marksman, Support",Support,Marksman,"Mage, Support",1,0,1
5320,Marksman,"Fighter, Assassin",Mage,"Marksman, Assassin",0,1,1
5319,"Mage, Support","Fighter, Assassin",Marksman,"Fighter, Tank",1,0,1
5318,"Marksman, Mage","Support, Fighter","Marksman, Support","Tank, Support",1,0,1
5317,"Mage, Marksman","Mage, Support","Marksman, Mage","Support, Fighter",0,1,1
5390,Mage,"Support, Fighter","Marksman, Assassin","Mage, Support",1,0,1
5392,"Marksman, Assassin","Mage, Assassin","Marksman, Support","Support, Fighter",0,1,1
5289,"Mage, Fighter",Tank,"Fighter, Assassin","Mage, Support",1,0,1
5456,"Fighter, Assassin","Assassin, Fighter","Fighter, Marksman","Fighter, Mage",0,1,1
3864,"Fighter, Mage","Support, Mage","Fighter, Assassin","Fighter, Tank",1,0,1
3865,Marksman,"Mage, Support","Fighter, Mage","Fighter, Tank",0,1,1
3867,"Support, Mage","Support, Mage","Assassin, Fighter","Mage, Assassin",1,0,1
5463,"Tank, Mage","Tank, Fighter","Fighter, Tank","Support, Mage",1,0,1
5462,"Tank, Fighter","Fighter, Assassin",Tank,"Assassin, Fighter",1,0,1
5461,"Mage, Marksman","Tank, Fighter","Tank, Mage","Support, Mage",1,0,1
5460,Marksman,"Mage, Fighter","Tank, Fighter","Fighter, Assassin",1,0,1
5459,"Fighter, Tank","Tank, Fighter","Mage, Marksman","Tank, Fighter",1,0,1
3868,"Mage, Fighter","Fighter, Tank","Assassin, Fighter","Support, Mage",0,1,1
3869,"Support, Mage","Support, Tank","Fighter, Mage","Support, Fighter",0,1,1
3870,"Support, Mage","Mage, Support",Marksman,"Tank, Fighter",1,0,1
5443,"Mage, Marksman","Tank, Fighter","Marksman, Assassin","Support, Tank",1,0,1
5454,"Tank, Fighter","Tank, Fighter","Fighter, Mage",Marksman,1,0,1
3871,"Fighter, Assassin","Fighter, Tank","Mage, Fighter","Support, Fighter",0,1,1
5452,"Tank, Fighter","Mage, Marksman","Fighter, Mage","Mage, Support",0,1,1
5451,"Marksman, Assassin","Support, Mage","Marksman, Mage","Tank, Fighter",1,0,1
5450,"Marksman, Assassin","Tank, Support","Marksman, Mage",Support,0,1,1
5449,Marksman,"Support, Fighter","Marksman, Mage","Support, Fighter",1,0,1
5448,"Marksman, Assassin","Tank, Fighter","Marksman, Assassin","Support, Fighter",0,1,1
5447,"Marksman, Assassin","Mage, Support","Marksman, Assassin","Support, Fighter",1,0,1
5446,"Mage, Marksman","Support, Tank","Marksman, Support","Support, Tank",1,0,1
5445,Mage,"Support, Tank","Marksman, Mage","Support, Tank",0,1,1
3863,"Fighter, Mage","Tank, Support",Marksman,"Fighter, Tank",0,1,1
5468,"Fighter, Tank","Fighter, Assassin","Fighter, Marksman","Fighter, Mage",1,0,1
5470,Marksman,"Tank, Fighter","Fighter, Assassin","Mage, Fighter",0,1,1
3860,"Assassin, Fighter",Mage,Fighter,"Support, Tank",1,0,1
5497,"Fighter, Tank","Mage, Fighter",Marksman,"Assassin, Mage",1,0,1
5496,Tank,"Mage, Fighter","Tank, Fighter","Support, Mage",0,1,1
3846,"Tank, Fighter","Support, Mage","Fighter, Assassin","Tank, Fighter",1,0,1
5494,"Assassin, Fighter",Fighter,"Tank, Fighter","Assassin, Fighter",0,1,1
5493,"Fighter, Tank","Fighter, Assassin","Assassin, Fighter","Assassin, Fighter",1,0,1
3848,Fighter,Mage,"Fighter, Tank","Tank, Support",0,1,1
5490,"Fighter, Tank","Mage, Fighter","Support, Tank","Assassin, Fighter",0,1,1
3850,"Fighter, Mage","Mage, Assassin","Assassin, Fighter","Tank, Fighter",0,1,1
5487,"Fighter, Tank","Assassin, Fighter","Support, Tank","Mage, Fighter",1,0,1
5486,"Assassin, Fighter","Fighter, Assassin","Fighter, Mage","Fighter, Mage",0,1,1
3851,"Assassin, Fighter","Tank, Support","Mage, Fighter","Tank, Fighter",0,1,1
5483,"Fighter, Mage",Marksman,"Mage, Marksman","Fighter, Assassin",1,0,1
3853,"Mage, Fighter","Tank, Fighter","Fighter, Assassin","Mage, Support",0,1,1
3854,"Assassin, Fighter","Support, Tank","Fighter, Assassin","Fighter, Mage",1,0,1
3855,Assassin,"Tank, Support","Fighter, Mage","Mage, Assassin",0,1,1
3856,Assassin,"Fighter, Mage","Fighter, Tank","Mage, Assassin",0,1,1
3857,"Assassin, Fighter","Mage, Support","Mage, Fighter","Tank, Support",1,0,1
5477,"Fighter, Assassin","Tank, Fighter","Fighter, Mage","Mage, Fighter",1,0,1
5476,"Fighter, Mage",Fighter,"Fighter, Assassin","Tank, Mage",0,1,1
3858,Marksman,"Support, Mage","Mage, Fighter","Fighter, Tank",1,0,1
5474,"Tank, Mage","Tank, Mage","Fighter, Tank","Tank, Fighter",1,0,1
5444,"Marksman, Assassin","Support, Tank","Marksman, Assassin",Support,1,0,1
5442,"Mage, Marksman","Support, Tank","Marksman, Assassin","Support, Mage",0,1,1
5393,"Marksman, Mage","Mage, Assassin","Marksman, Assassin","Fighter, Tank",1,0,1
5405,"Marksman, Support","Mage, Assassin","Marksman, Mage","Support, Fighter",0,1,1
5415,"Marksman, Mage","Support, Mage","Fighter, Marksman","Mage, Support",1,0,1
5414,"Marksman, Mage","Mage, Assassin",Mage,"Support, Mage",1,0,1
5413,"Mage, Marksman","Support, Fighter","Marksman, Mage","Support, Tank",1,0,1
5412,"Mage, Marksman","Mage, Support",Marksman,"Tank, Fighter",0,1,1
5411,Marksman,Support,"Marksman, Support","Support, Mage",1,0,1
5410,"Marksman, Support","Mage, Support","Marksman, Assassin",Support,0,1,1
5409,"Marksman, Mage","Support, Tank","Marksman, Mage",Support,0,1,1
5408,Marksman,"Support, Mage",Mage,"Mage, Support",1,0,1
5407,"Marksman, Mage","Tank, Fighter",Marksman,"Tank, Fighter",0,1,1
5406,Marksman,"Support, Mage","Marksman, Support","Fighter, Mage",0,1,1
5404,Marksman,"Mage, Support","Mage, Marksman","Support, Fighter",0,1,1
5441,"Marksman, Assassin","Tank, Support","Marksman, Assassin","Mage, Support",1,0,1
5403,"Marksman, Mage","Mage, Support",Marksman,"Tank, Mage",0,1,1
5402,"Marksman, Support","Support, Fighter","Marksman, Assassin","Mage, Assassin",0,1,1
5401,"Marksman, Assassin","Fighter, Tank","Marksman, Support","Mage, Assassin",1,0,1
5400,"Marksman, Mage","Support, Mage",Mage,"Support, Mage",1,0,1
5399,"Marksman, Mage","Mage, Support","Marksman, Mage","Mage, Assassin",1,0,1
5398,"Marksman, Support","Support, Fighter",Marksman,"Fighter, Tank",0,1,1
5397,"Marksman, Assassin","Support, Mage","Marksman, Support","Fighter, Tank",1,0,1
5396,Fighter,"Tank, Fighter","Marksman, Assassin","Mage, Assassin",1,0,1
5395,"Marksman, Mage","Tank, Support","Marksman, Support","Mage, Assassin",0,1,1
5394,Fighter,"Tank, Mage","Marksman, Mage","Support, Fighter",0,1,1
5416,Mage,"Support, Mage","Marksman, Mage","Mage, Assassin",1,0,1
5417,"Marksman, Assassin","Support, Fighter",Mage,"Mage, Support",1,0,1
5418,"Marksman, Mage","Mage, Assassin","Marksman, Mage",Mage,1,0,1
5419,Mage,"Support, Mage","Marksman, Support","Mage, Support",1,0,1
3872,"Mage, Fighter","Support, Tank","Fighter, Tank","Tank, Support",1,0,1
5439,Marksman,"Tank, Mage","Marksman, Assassin","Support, Tank",0,1,1
3873,Marksman,"Support, Fighter","Assassin, Fighter","Tank, Support",1,0,1
5437,Marksman,Tank,"Marksman, Mage","Tank, Support",1,0,1
5436,Marksman,"Tank, Support",Marksman,"Fighter, Mage",1,0,1
5435,"Fighter, Marksman","Support, Mage",Marksman,"Mage, Support",1,0,1
5434,"Marksman, Assassin",Tank,Marksman,"Support, Fighter",1,0,1
5433,"Marksman, Assassin","Support, Fighter",Marksman,Tank,0,1,1
5432,Marksman,"Support, Tank","Marksman, Assassin",Mage,1,0,1
5431,Marksman,"Fighter, Tank","Marksman, Mage","Support, Fighter",0,1,1
5430,"Marksman, Assassin",Mage,Marksman,"Support, Mage",1,0,1
5429,Marksman,"Mage, Support","Fighter, Marksman","Tank, Fighter",1,0,1
5428,Marksman,"Tank, Fighter","Fighter, Marksman",Mage,0,1,1
5427,"Marksman, Mage","Tank, Fighter","Fighter, Marksman","Mage, Support",1,0,1
5426,"Marksman, Mage","Tank, Support","Marksman, Mage","Mage, Support",0,1,1
5425,Marksman,"Tank, Support","Support, Mage","Tank, Fighter",1,0,1
5424,"Marksman, Support","Tank, Support",Marksman,"Mage, Support",1,0,1
5423,"Marksman, Mage","Mage, Support","Marksman, Assassin","Fighter, Tank",1,0,1
5422,"Marksman, Support","Fighter, Tank","Marksman, Mage","Mage, Support",1,0,1
5421,"Marksman, Assassin","Support, Mage","Marksman, Support","Support, Mage",0,1,1
5420,Marksman,"Mage, Assassin","Marksman, Mage","Support, Fighter",1,0,1
5290,"Mage, Marksman","Mage, Support","Marksman, Support","Tank, Fighter",1,0,1
3886,Marksman,"Mage, Assassin","Fighter, Assassin","Support, Tank",0,1,1
5962,"Tank, Fighter","Tank, Fighter","Tank, Fighter","Mage, Fighter",0,1,1
5146,"Assassin, Fighter",Mage,"Mage, Fighter","Tank, Support",1,0,1
5156,"Support, Mage","Support, Tank","Fighter, Assassin","Support, Mage",1,0,1
5155,"Assassin, Fighter","Support, Mage","Fighter, Assassin",Support,0,1,1
5154,"Tank, Fighter","Mage, Support","Mage, Fighter","Support, Fighter",0,1,1
5153,"Support, Mage","Support, Fighter",Marksman,"Mage, Support",0,1,1
5152,"Tank, Fighter","Mage, Support","Fighter, Assassin","Support, Tank",0,1,1
5151,"Tank, Fighter",Support,"Fighter, Tank","Support, Fighter",1,0,1
5150,"Fighter, Tank",Marksman,"Assassin, Fighter","Mage, Assassin",0,1,1
5149,"Assassin, Fighter","Support, Tank","Assassin, Fighter",Marksman,1,0,1
5148,"Mage, Fighter","Tank, Fighter",Fighter,"Tank, Support",0,1,1
5147,"Assassin, Fighter","Support, Tank",Fighter,"Tank, Fighter",1,0,1
5145,Marksman,"Fighter, Tank","Assassin, Fighter","Support, Fighter",0,1,1
5133,"Fighter, Assassin","Tank, Support",Fighter,"Mage, Support",0,1,1
5144,Marksman,"Mage, Support","Fighter, Tank","Tank, Support",1,0,1
5143,Fighter,"Support, Fighter","Fighter, Assassin","Fighter, Tank",0,1,1
5142,"Tank, Fighter","Support, Fighter","Tank, Mage","Mage, Support",1,0,1
5141,"Tank, Mage","Tank, Fighter","Tank, Fighter","Support, Tank",0,1,1
5140,"Mage, Fighter","Tank, Support","Fighter, Mage",Support,0,1,1
5139,"Mage, Fighter","Support, Fighter","Tank, Mage",Support,0,1,1
5138,"Fighter, Assassin","Marksman, Support","Fighter, Mage","Support, Tank",1,0,1
5137,"Mage, Fighter",Support,"Tank, Fighter","Tank, Support",1,0,1
5136,"Fighter, Assassin",Support,"Mage, Fighter","Support, Mage",0,1,1
5135,"Fighter, Assassin","Support, Fighter","Fighter, Mage",Support,0,1,1
5157,"Support, Mage","Support, Tank","Fighter, Assassin","Mage, Support",1,0,1
5158,"Fighter, Tank","Mage, Support","Mage, Fighter","Support, Fighter",0,1,1
5159,"Support, Mage","Support, Tank","Fighter, Tank","Mage, Support",1,0,1
5160,"Tank, Fighter","Support, Tank","Support, Mage","Support, Fighter",0,1,1
5183,Fighter,Support,"Assassin, Fighter","Fighter, Mage",1,0,1
5182,Marksman,"Tank, Fighter","Assassin, Fighter","Support, Fighter",1,0,1
5180,Marksman,"Tank, Fighter","Assassin, Fighter","Support, Mage",1,0,1
3894,"Fighter, Mage","Support, Mage",Marksman,"Fighter, Tank",0,1,1
5178,"Fighter, Mage","Fighter, Tank","Mage, Fighter",Mage,0,1,1
3895,"Tank, Fighter","Support, Tank","Mage, Fighter","Fighter, Tank",0,1,1
5176,"Assassin, Fighter","Support, Tank","Assassin, Fighter","Fighter, Tank",1,0,1
3896,"Fighter, Assassin","Tank, Fighter","Support, Mage","Mage, Support",0,1,1
5173,Marksman,Marksman,"Fighter, Assassin","Mage, Assassin",1,0,1
5172,Marksman,"Support, Mage","Assassin, Fighter","Tank, Fighter",1,0,1
5171,"Fighter, Assassin",Marksman,"Tank, Fighter","Mage, Support",0,1,1
5170,"Assassin, Mage","Support, Fighter","Fighter, Assassin","Support, Tank",0,1,1
5169,"Mage, Fighter","Support, Tank","Support, Mage","Tank, Support",0,1,1
5168,"Assassin, Fighter","Support, Tank","Tank, Fighter","Mage, Support",0,1,1
5167,"Tank, Fighter","Support, Mage","Fighter, Tank",Support,1,0,1
5166,"Fighter, Mage","Support, Fighter","Fighter, Mage","Support, Tank",0,1,1
5165,Fighter,"Fighter, Tank","Tank, Fighter","Support, Tank",1,0,1
5164,"Tank, Mage","Support, Fighter","Tank, Mage","Support, Mage",0,1,1
5163,Fighter,"Tank, Fighter","Tank, Mage","Support, Mage",0,1,1
5162,"Fighter, Tank","Support, Mage","Tank, Mage","Support, Mage",0,1,1
5161,"Tank, Fighter",Support,"Fighter, Assassin","Tank, Support",1,0,1
5134,"Tank, Fighter","Support, Fighter","Mage, Fighter",Support,1,0,1
5132,"Fighter, Assassin","Mage, Support",Fighter,"Fighter, Tank",1,0,1
5185,"Tank, Fighter",Support,"Tank, Fighter","Tank, Fighter",1,0,1
5092,Marksman,"Support, Mage","Tank, Fighter","Mage, Support",1,0,1
5103,"Assassin, Fighter","Support, Tank","Support, Mage","Mage, Assassin",1,0,1
3905,"Mage, Fighter","Support, Fighter","Fighter, Mage","Fighter, Tank",0,1,1
5101,"Fighter, Tank",Support,"Assassin, Fighter","Support, Mage",1,0,1
5100,"Mage, Fighter",Support,"Assassin, Fighter","Support, Fighter",1,0,1
5099,"Tank, Fighter",Support,"Mage, Fighter","Mage, Support",0,1,1
5098,"Assassin, Fighter",Mage,Fighter,"Tank, Fighter",0,1,1
5097,"Assassin, Fighter","Support, Mage","Fighter, Tank","Support, Fighter",1,0,1
3907,"Fighter, Mage","Mage, Assassin",Marksman,"Support, Tank",0,1,1
5094,Marksman,"Tank, Fighter","Mage, Fighter","Support, Mage",1,0,1
5093,Marksman,"Tank, Fighter","Assassin, Fighter","Support, Tank",1,0,1
3908,"Fighter, Mage",Mage,"Fighter, Assassin","Support, Tank",0,1,1
5130,"Fighter, Tank","Mage, Assassin","Assassin, Fighter","Support, Tank",1,0,1
5090,"Tank, Fighter","Tank, Support","Mage, Fighter","Mage, Support",1,0,1
5089,"Mage, Fighter","Fighter, Tank","Fighter, Tank","Mage, Support",0,1,1
5088,Fighter,"Support, Fighter","Mage, Fighter","Fighter, Tank",1,0,1
5087,Marksman,"Tank, Support","Marksman, Fighter","Support, Tank",0,1,1
5086,Fighter,"Tank, Support","Tank, Fighter","Support, Tank",1,0,1
5085,"Mage, Fighter","Tank, Support","Tank, Fighter","Fighter, Tank",1,0,1
5084,Fighter,"Support, Fighter","Tank, Fighter","Tank, Fighter",1,0,1
5083,"Assassin, Fighter",Support,"Mage, Fighter","Support, Mage",1,0,1
5082,"Tank, Fighter","Support, Tank",Fighter,Support,1,0,1
5081,"Tank, Fighter",Support,"Tank, Mage","Support, Mage",0,1,1
5104,"Fighter, Tank","Mage, Support","Support, Mage",Mage,1,0,1
5105,"Assassin, Fighter","Support, Tank",Fighter,"Mage, Assassin",0,1,1
5106,"Assassin, Fighter","Support, Mage","Mage, Support","Support, Mage",1,0,1
5107,Fighter,Mage,"Mage, Fighter","Support, Fighter",1,0,1
5129,"Assassin, Fighter",Marksman,"Mage, Fighter","Mage, Assassin",1,0,1
5128,Marksman,"Support, Fighter","Fighter, Mage","Mage, Support",1,0,1
5127,"Fighter, Mage","Mage, Support","Fighter, Mage","Fighter, Tank",1,0,1
5126,"Fighter, Mage","Mage, Support","Fighter, Mage","Tank, Support",1,0,1
5125,"Fighter, Mage","Fighter, Tank","Fighter, Assassin","Support, Tank",0,1,1
5124,Marksman,"Fighter, Tank","Mage, Fighter","Tank, Fighter",1,0,1
5123,Marksman,"Fighter, Tank","Fighter, Mage","Support, Mage",0,1,1
5122,"Fighter, Tank","Support, Fighter",Marksman,"Tank, Support",0,1,1
5121,"Fighter, Mage","Fighter, Tank",Marksman,"Support, Tank",1,0,1
5120,"Fighter, Assassin","Tank, Support",Fighter,Tank,1,0,1
5119,"Assassin, Fighter",Support,"Tank, Fighter","Support, Tank",1,0,1
3899,"Assassin, Fighter","Support, Tank",Marksman,"Tank, Fighter",0,1,1
3900,"Mage, Fighter","Mage, Support","Fighter, Assassin","Tank, Fighter",0,1,1
5116,"Support, Mage","Support, Fighter",Fighter,"Support, Mage",1,0,1
3901,Marksman,"Tank, Fighter","Fighter, Mage","Tank, Support",0,1,1
3902,"Fighter, Mage","Fighter, Tank","Mage, Fighter","Tank, Support",1,0,1
5113,"Support, Mage","Mage, Assassin","Fighter, Tank","Mage, Support",0,1,1
3903,Marksman,"Tank, Support","Fighter, Mage","Support, Mage",1,0,1
5111,"Fighter, Tank","Mage, Assassin","Assassin, Fighter","Support, Mage",0,1,1
5109,"Fighter, Tank","Mage, Support","Fighter, Tank",Marksman,1,0,1
5108,Fighter,"Mage, Assassin","Support, Mage","Mage, Support",1,0,1
5184,"Fighter, Mage","Support, Fighter","Tank, Fighter",Support,1,0,1
5186,"Fighter, Mage",Support,"Tank, Fighter","Support, Mage",0,1,1
5287,"Fighter, Assassin","Mage, Support","Assassin, Fighter","Mage, Marksman",0,1,1
5251,"Tank, Mage","Support, Fighter",Fighter,"Support, Tank",1,0,1
5261,"Tank, Fighter",Tank,"Assassin, Mage","Tank, Support",1,0,1
5260,Fighter,Tank,"Tank, Fighter","Tank, Support",0,1,1
5259,Marksman,"Support, Tank","Fighter, Tank","Fighter, Tank",1,0,1
5258,"Assassin, Fighter","Support, Fighter","Fighter, Assassin","Tank, Support",1,0,1
5257,"Fighter, Tank","Mage, Support","Fighter, Assassin","Tank, Support",0,1,1
5256,"Tank, Fighter","Fighter, Tank","Tank, Mage","Tank, Support",1,0,1
5255,"Mage, Fighter","Tank, Fighter","Tank, Fighter",Support,1,0,1
5254,"Assassin, Fighter","Support, Fighter",Fighter,"Tank, Mage",0,1,1
5253,Fighter,"Tank, Support","Fighter, Tank","Fighter, Tank",1,0,1
5252,"Tank, Mage","Support, Fighter",Fighter,"Tank, Support",1,0,1
5250,"Tank, Mage","Support, Fighter","Tank, Mage","Tank, Fighter",1,0,1
5238,"Fighter, Assassin",Support,"Fighter, Tank","Tank, Mage",0,1,1
5249,Fighter,"Tank, Support","Fighter, Mage",Support,1,0,1
5248,"Fighter, Mage","Support, Tank","Support, Mage","Support, Mage",1,0,1
5247,"Tank, Fighter",Support,"Fighter, Tank","Mage, Support",1,0,1
5246,"Tank, Mage","Support, Tank",Fighter,"Tank, Support",0,1,1
5245,"Fighter, Tank","Fighter, Tank","Tank, Fighter","Support, Tank",1,0,1
5244,Fighter,"Support, Tank","Fighter, Tank","Tank, Mage",1,0,1
5243,"Fighter, Tank",Support,"Assassin, Fighter","Tank, Mage",1,0,1
5242,Fighter,Mage,"Tank, Fighter","Support, Tank",0,1,1
5241,"Tank, Fighter","Tank, Support","Fighter, Tank","Support, Tank",1,0,1
3888,"Assassin, Fighter","Support, Tank","Mage, Fighter",Mage,1,0,1
5262,Fighter,"Mage, Support","Tank, Fighter","Tank, Support",0,1,1
5263,"Fighter, Tank","Tank, Support",Fighter,"Support, Tank",1,0,1
3887,"Fighter, Assassin","Support, Mage","Support, Mage","Support, Tank",1,0,1
5265,"Tank, Support","Fighter, Assassin","Mage, Fighter","Support, Tank",1,0,1
5286,"Fighter, Mage","Support, Tank",Fighter,Mage,0,1,1
5285,"Tank, Fighter",Mage,Fighter,"Support, Tank",0,1,1
5284,"Fighter, Mage","Tank, Support","Fighter, Assassin",Mage,0,1,1
5283,"Fighter, Mage","Support, Tank","Mage, Fighter",Mage,1,0,1
5282,"Fighter, Assassin","Support, Tank","Mage, Fighter",Mage,0,1,1
5281,"Fighter, Mage","Support, Fighter","Tank, Fighter",Mage,1,0,1
5280,"Assassin, Mage","Mage, Marksman","Fighter, Mage","Support, Mage",0,1,1
5279,"Mage, Fighter","Support, Fighter",Fighter,Tank,0,1,1
5278,"Fighter, Assassin","Mage, Support","Fighter, Mage","Tank, Support",1,0,1
5277,"Mage, Fighter","Mage, Marksman",Fighter,"Support, Fighter",1,0,1
5276,"Assassin, Fighter","Mage, Support","Fighter, Assassin","Tank, Support",1,0,1
5275,Fighter,"Mage, Support","Mage, Fighter","Tank, Fighter",1,0,1
5274,Fighter,"Mage, Marksman","Fighter, Assassin","Support, Fighter",0,1,1
5273,"Mage, Fighter",Tank,"Fighter, Tank","Support, Fighter",1,0,1
5272,"Mage, Fighter","Support, Tank","Fighter, Tank",Mage,1,0,1
5271,"Mage, Fighter","Tank, Support","Fighter, Mage",Tank,1,0,1
5270,"Fighter, Tank","Tank, Support","Fighter, Assassin","Mage, Support",0,1,1
5269,"Fighter, Tank","Mage, Marksman",Fighter,"Tank, Support",0,1,1
5268,"Assassin, Fighter","Tank, Support","Fighter, Assassin","Mage, Support",1,0,1
5267,"Mage, Fighter","Support, Mage","Fighter, Tank","Tank, Support",0,1,1
5266,"Fighter, Tank","Mage, Support","Fighter, Assassin","Support, Mage",1,0,1
5239,"Assassin, Fighter","Tank, Fighter","Tank, Fighter","Support, Mage",1,0,1
5237,"Tank, Fighter","Fighter, Tank","Tank, Fighter","Support, Tank",1,0,1
5187,"Assassin, Fighter","Support, Mage",Fighter,Support,1,0,1
5200,"Fighter, Mage",Support,"Tank, Mage","Mage, Support",1,0,1
5210,Marksman,"Support, Tank","Fighter, Tank","Support, Tank",0,1,1
5209,"Support, Mage","Mage, Assassin","Fighter, Tank","Support, Fighter",0,1,1
5208,Fighter,"Tank, Support","Tank, Fighter","Tank, Support",1,0,1
5207,"Fighter, Tank","Mage, Support","Fighter, Assassin","Support, Fighter",1,0,1
5206,"Fighter, Assassin","Mage, Support","Support, Mage","Support, Tank",1,0,1
5205,Fighter,"Support, Mage","Tank, Fighter",Support,0,1,1
5204,Marksman,"Support, Mage","Tank, Fighter",Support,1,0,1
5203,"Tank, Fighter","Support, Mage",Marksman,"Support, Mage",1,0,1
5202,"Marksman, Mage","Support, Mage","Tank, Fighter","Support, Mage",0,1,1
5201,"Assassin, Fighter","Mage, Support","Marksman, Mage","Mage, Support",1,0,1
5199,"Fighter, Assassin","Support, Mage","Fighter, Mage",Support,0,1,1
5236,"Fighter, Tank","Tank, Support","Mage, Fighter","Support, Fighter",0,1,1
5198,"Assassin, Fighter","Support, Mage","Fighter, Mage",Support,0,1,1
5197,"Fighter, Assassin","Support, Mage",Fighter,Support,0,1,1
5196,"Tank, Fighter",Support,"Mage, Fighter","Support, Mage",0,1,1
5195,"Fighter, Tank","Support, Tank","Tank, Fighter","Mage, Support",1,0,1
5194,"Fighter, Assassin",Marksman,"Fighter, Tank","Mage, Support",1,0,1
5192,"Support, Mage","Tank, Support","Fighter, Mage","Support, Fighter",0,1,1
3892,Marksman,"Tank, Support","Assassin, Fighter","Mage, Assassin",0,1,1
5190,"Fighter, Mage","Tank, Support","Assassin, Fighter",Support,1,0,1
5189,"Tank, Fighter","Mage, Support","Fighter, Mage","Support, Fighter",0,1,1
5188,"Fighter, Mage","Support, Mage","Support, Mage","Tank, Support",0,1,1
5211,"Support, Mage","Mage, Support","Tank, Fighter","Support, Tank",0,1,1
5212,"Assassin, Fighter","Support, Tank","Fighter, Assassin","Tank, Mage",0,1,1
3890,Marksman,"Mage, Assassin","Fighter, Mage","Support, Tank",0,1,1
5214,Fighter,"Tank, Support","Fighter, Tank",Tank,0,1,1
5235,"Assassin, Mage","Support, Mage","Assassin, Fighter","Support, Fighter",1,0,1
5234,"Fighter, Assassin","Support, Mage","Assassin, Mage","Support, Fighter",0,1,1
5233,"Tank, Mage",Support,"Tank, Fighter","Tank, Support",0,1,1
5232,"Fighter, Assassin","Support, Mage","Fighter, Tank","Tank, Support",0,1,1
5231,"Assassin, Fighter","Support, Fighter","Assassin, Fighter","Tank, Fighter",1,0,1
5230,"Fighter, Assassin","Fighter, Support","Assassin, Fighter","Support, Mage",0,1,1
3889,Marksman,"Mage, Marksman","Mage, Fighter","Support, Tank",0,1,1
5228,"Tank, Fighter","Support, Mage",Marksman,"Mage, Assassin",0,1,1
5227,Marksman,"Support, Mage","Tank, Fighter","Support, Mage",0,1,1
5226,"Fighter, Assassin","Support, Mage",Marksman,"Fighter, Tank",0,1,1
5225,"Fighter, Assassin","Support, Tank","Mage, Fighter","Support, Tank",0,1,1
5224,"Fighter, Mage",Mage,Fighter,"Tank, Support",1,0,1
5223,Marksman,"Mage, Support","Fighter, Mage","Tank, Fighter",1,0,1
5222,"Fighter, Assassin","Tank, Support",Marksman,"Support, Tank",1,0,1
5221,Marksman,"Tank, Support","Fighter, Assassin","Support, Tank",1,0,1
5220,"Fighter, Assassin","Support, Tank",Marksman,"Support, Tank",1,0,1
5219,"Assassin, Fighter","Support, Mage","Fighter, Assassin",Mage,0,1,1
5218,Fighter,"Support, Tank","Mage, Fighter",Tank,0,1,1
5217,Fighter,"Mage, Marksman","Fighter, Assassin","Tank, Support",0,1,1
5216,"Mage, Fighter",Tank,Marksman,"Tank, Support",1,0,1
5215,"Fighter, Tank","Support, Tank","Assassin, Fighter","Mage, Support",1,0,1
3845,"Fighter, Mage","Tank, Support","Assassin, Mage",Mage,0,1,1
3844,"Tank, Fighter","Support, Tank","Assassin, Fighter","Tank, Fighter",0,1,1
3843,"Tank, Fighter","Tank, Fighter","Tank, Fighter","Tank, Support",0,1,1
3657,"Assassin, Fighter","Tank, Fighter","Fighter, Assassin","Support, Mage",0,1,1
5813,"Fighter, Marksman","Mage, Fighter",Tank,"Tank, Fighter",0,1,1
5812,Tank,"Mage, Fighter","Fighter, Assassin","Tank, Fighter",0,1,1
3654,Marksman,"Support, Fighter","Support, Mage","Mage, Support",0,1,1
5810,"Fighter, Tank","Tank, Mage","Tank, Mage","Fighter, Mage",1,0,1
5809,Tank,"Tank, Fighter","Fighter, Tank","Assassin, Fighter",0,1,1
3655,"Fighter, Assassin","Support, Tank","Mage, Fighter","Tank, Fighter",1,0,1
5807,"Fighter, Assassin","Fighter, Assassin","Fighter, Tank",Fighter,1,0,1
5806,"Fighter, Mage","Assassin, Fighter",Marksman,"Fighter, Mage",0,1,1
5805,"Fighter, Marksman","Fighter, Assassin","Fighter, Tank",Fighter,0,1,1
5804,Tank,Fighter,"Fighter, Mage","Fighter, Assassin",1,0,1
5802,"Mage, Marksman","Fighter, Assassin","Fighter, Tank","Fighter, Mage",1,0,1
5788,"Tank, Fighter","Assassin, Fighter","Support, Tank","Mage, Fighter",0,1,1
5801,"Mage, Marksman","Fighter, Assassin",Mage,Marksman,1,0,1
5800,"Tank, Mage",Fighter,"Fighter, Support","Fighter, Assassin",0,1,1
5799,"Tank, Mage","Assassin, Fighter",Marksman,"Fighter, Mage",1,0,1
3660,"Mage, Fighter","Support, Mage",Fighter,"Tank, Fighter",1,0,1
3661,"Fighter, Mage","Mage, Support","Fighter, Assassin","Tank, Support",1,0,1
3662,Marksman,Mage,"Fighter, Mage","Support, Tank",0,1,1
5794,Tank,"Assassin, Fighter","Fighter, Tank",Fighter,1,0,1
3663,"Fighter, Assassin","Tank, Fighter","Fighter, Mage","Support, Fighter",0,1,1
5792,Tank,"Fighter, Assassin","Mage, Marksman","Support, Mage",0,1,1
5790,Tank,"Assassin, Fighter",Mage,"Mage, Fighter",1,0,1
5814,"Tank, Mage","Mage, Fighter","Tank, Mage","Tank, Fighter",0,1,1
3653,"Support, Mage","Support, Mage","Fighter, Assassin","Tank, Mage",0,1,1
5816,"Tank, Mage","Fighter, Mage","Fighter, Marksman","Fighter, Tank",1,0,1
5817,Tank,"Fighter, Mage",Fighter,"Tank, Mage",1,0,1
3634,"Assassin, Fighter","Mage, Assassin","Fighter, Assassin","Tank, Support",1,0,1
3636,Fighter,"Mage, Assassin",Marksman,"Support, Mage",1,0,1
3637,"Assassin, Fighter","Mage, Support","Fighter, Tank","Support, Tank",1,0,1
5844,"Fighter, Tank","Mage, Fighter",Tank,Marksman,1,0,1
5843,"Fighter, Mage","Fighter, Assassin","Tank, Mage","Fighter, Mage",1,0,1
5842,"Mage, Marksman",Marksman,"Fighter, Mage","Fighter, Mage",1,0,1
5841,"Fighter, Mage","Fighter, Mage","Fighter, Marksman","Fighter, Assassin",1,0,1
3638,"Fighter, Mage","Mage, Support",Marksman,"Support, Fighter",0,1,1
3641,"Fighter, Assassin","Mage, Support","Fighter, Mage","Tank, Fighter",0,1,1
5836,"Fighter, Support","Mage, Fighter",Tank,"Tank, Fighter",0,1,1
5835,"Assassin, Fighter","Assassin, Fighter","Fighter, Mage",Fighter,0,1,1
5833,"Fighter, Marksman","Mage, Fighter","Tank, Fighter",Marksman,0,1,1
5832,"Mage, Marksman","Mage, Fighter","Fighter, Mage","Fighter, Tank",1,0,1
5831,"Tank, Mage","Support, Mage","Fighter, Assassin",Marksman,0,1,1
3644,Marksman,"Support, Mage","Fighter, Assassin","Support, Fighter",0,1,1
5825,"Tank, Mage",Marksman,Marksman,"Fighter, Tank",0,1,1
5824,"Tank, Fighter","Fighter, Tank","Tank, Mage","Mage, Fighter",0,1,1
5823,Marksman,Marksman,"Tank, Mage","Assassin, Fighter",1,0,1
5822,Tank,Marksman,"Fighter, Assassin","Fighter, Mage",0,1,1
3650,Marksman,Support,"Assassin, Fighter",Mage,1,0,1
3652,Marksman,Support,"Assassin, Fighter","Mage, Support",0,1,1
3667,"Fighter, Assassin","Tank, Fighter","Assassin, Fighter","Support, Tank",0,1,1
5787,"Support, Mage",Marksman,"Marksman, Fighter",Fighter,0,1,1
5849,"Fighter, Assassin","Fighter, Tank","Fighter, Assassin","Tank, Fighter",1,0,1
5744,"Tank, Fighter",Marksman,"Support, Tank","Fighter, Mage",0,1,1
5758,"Assassin, Fighter",Marksman,"Fighter, Assassin",Fighter,1,0,1
5756,"Tank, Mage","Mage, Fighter","Mage, Fighter",Fighter,1,0,1
3691,"Mage, Fighter","Mage, Assassin","Assassin, Fighter",Marksman,1,0,1
3693,"Fighter, Tank","Support, Fighter","Mage, Fighter","Support, Mage",0,1,1
5751,"Tank, Mage","Fighter, Assassin","Support, Tank",Fighter,0,1,1
5750,Tank,Marksman,"Assassin, Fighter",Fighter,0,1,1
5749,"Fighter, Tank",Fighter,"Tank, Fighter",Marksman,1,0,1
3694,"Assassin, Fighter","Fighter, Support","Assassin, Fighter","Mage, Support",0,1,1
5747,"Fighter, Assassin","Mage, Fighter",Mage,"Fighter, Assassin",0,1,1
5746,"Tank, Mage",Fighter,"Support, Tank",Marksman,0,1,1
5743,"Support, Tank","Fighter, Mage","Fighter, Assassin","Mage, Fighter",1,0,1
5786,"Fighter, Assassin","Mage, Fighter","Fighter, Assassin","Assassin, Fighter",0,1,1
5742,"Support, Mage",Marksman,"Tank, Fighter",Marksman,0,1,1
3697,"Assassin, Fighter","Support, Tank","Assassin, Fighter",Mage,0,1,1
5740,"Tank, Fighter","Fighter, Tank","Fighter, Tank",Marksman,0,1,1
5739,"Support, Tank","Fighter, Mage","Tank, Fighter",Marksman,1,0,1
5738,"Assassin, Fighter","Fighter, Mage","Tank, Fighter","Assassin, Fighter",0,1,1
3699,Marksman,"Mage, Support","Fighter, Tank","Support, Tank",0,1,1
3700,"Assassin, Fighter","Support, Tank","Mage, Fighter","Mage, Assassin",1,0,1
5735,"Tank, Mage","Mage, Fighter","Fighter, Assassin","Support, Mage",1,0,1
3702,Marksman,"Support, Tank","Mage, Fighter",Mage,0,1,1
5733,"Tank, Fighter","Fighter, Mage","Tank, Mage","Fighter, Tank",1,0,1
5759,"Support, Tank","Mage, Fighter","Mage, Tank",Fighter,0,1,1
5760,"Support, Mage",Marksman,"Assassin, Fighter","Mage, Fighter",0,1,1
5761,"Assassin, Fighter",Fighter,"Fighter, Tank","Fighter, Assassin",0,1,1
3683,"Fighter, Assassin","Support, Tank",Fighter,"Tank, Support",1,0,1
3669,"Mage, Fighter",Support,"Fighter, Mage","Tank, Fighter",1,0,1
3671,"Assassin, Fighter","Tank, Fighter",Fighter,"Support, Tank",1,0,1
5783,"Fighter, Tank",Marksman,Mage,"Fighter, Tank",1,0,1
5781,"Tank, Fighter","Fighter, Mage","Support, Mage","Mage, Fighter",1,0,1
5780,"Mage, Support","Mage, Fighter","Tank, Fighter","Fighter, Mage",1,0,1
5779,"Marksman, Fighter","Assassin, Fighter","Fighter, Assassin","Mage, Fighter",1,0,1
5778,"Fighter, Tank",Fighter,"Fighter, Tank",Marksman,1,0,1
5777,"Fighter, Tank","Tank, Fighter","Fighter, Mage","Mage, Fighter",1,0,1
3674,Fighter,"Support, Tank",Marksman,"Support, Tank",0,1,1
5774,Tank,"Tank, Fighter","Mage, Marksman","Tank, Fighter",0,1,1
3676,Marksman,Support,"Fighter, Tank","Mage, Support",0,1,1
5772,Fighter,Marksman,"Support, Tank","Mage, Fighter",0,1,1
5771,"Tank, Fighter",Fighter,"Support, Tank","Fighter, Assassin",0,1,1
3677,"Tank, Fighter","Tank, Mage","Fighter, Mage","Support, Mage",0,1,1
3678,"Fighter, Mage","Tank, Support","Fighter, Assassin","Fighter, Tank",0,1,1
5768,"Marksman, Fighter","Mage, Fighter","Fighter, Tank",Fighter,0,1,1
5767,"Mage, Fighter",Marksman,"Fighter, Tank",Fighter,0,1,1
3679,"Support, Mage","Tank, Fighter",Marksman,"Support, Fighter",0,1,1
3680,"Fighter, Assassin","Support, Tank","Fighter, Mage","Fighter, Tank",1,0,1
3681,"Fighter, Assassin","Mage, Support",Marksman,"Support, Tank",1,0,1
3682,"Assassin, Fighter",Support,"Fighter, Assassin","Mage, Support",0,1,1
5848,Tank,"Tank, Fighter","Fighter, Assassin","Mage, Fighter",1,0,1
3633,"Support, Mage","Mage, Assassin",Fighter,"Mage, Support",1,0,1
3841,Fighter,"Mage, Marksman","Tank, Fighter","Tank, Fighter",0,1,1
3595,"Assassin, Fighter","Mage, Assassin","Support, Mage",Marksman,1,0,1
3589,"Fighter, Tank","Tank, Fighter",Fighter,"Support, Tank",0,1,1
5932,Mage,Fighter,"Fighter, Mage","Tank, Fighter",1,0,1
5931,"Fighter, Tank","Tank, Fighter","Mage, Support",Fighter,0,1,1
5930,"Fighter, Tank","Tank, Fighter","Mage, Support","Assassin, Fighter",0,1,1
5929,"Mage, Marksman",Fighter,"Tank, Mage","Tank, Fighter",0,1,1
3590,Fighter,"Support, Tank","Fighter, Assassin","Support, Mage",1,0,1
3593,"Fighter, Tank","Support, Tank","Support, Mage","Support, Mage",1,0,1
5926,Mage,"Fighter, Tank","Mage, Support","Tank, Fighter",1,0,1
5925,"Assassin, Fighter","Fighter, Tank","Tank, Fighter","Fighter, Assassin",0,1,1
3594,"Support, Mage","Support, Tank",Marksman,"Mage, Assassin",0,1,1
3597,"Fighter, Mage","Tank, Fighter","Support, Mage","Mage, Support",1,0,1
5909,"Fighter, Mage","Tank, Fighter",Mage,Fighter,1,0,1
5920,"Fighter, Assassin","Tank, Fighter",Mage,"Fighter, Tank",0,1,1
3598,Marksman,"Mage, Support","Support, Mage","Support, Tank",0,1,1
5918,Mage,"Fighter, Tank","Fighter, Tank","Fighter, Tank",1,0,1
5917,"Fighter, Mage","Tank, Fighter","Assassin, Mage",Fighter,0,1,1
5916,Mage,"Assassin, Fighter","Support, Mage","Tank, Fighter",1,0,1
5915,"Tank, Fighter","Mage, Fighter","Tank, Mage","Tank, Fighter",0,1,1
3599,"Support, Mage","Support, Tank","Fighter, Mage","Mage, Support",1,0,1
5913,"Assassin, Mage","Tank, Fighter","Tank, Mage","Assassin, Fighter",1,0,1
3600,Marksman,"Support, Mage","Fighter, Tank","Support, Mage",0,1,1
5911,"Fighter, Assassin","Tank, Fighter","Fighter, Tank","Assassin, Fighter",0,1,1
5934,"Assassin, Fighter","Assassin, Fighter","Fighter, Assassin","Tank, Fighter",0,1,1
5935,"Mage, Support","Fighter, Assassin",Mage,Fighter,0,1,1
3588,"Fighter, Tank","Support, Fighter","Fighter, Tank","Tank, Support",1,0,1
3584,Fighter,"Fighter, Tank","Fighter, Assassin","Support, Tank",0,1,1
3574,"Fighter, Mage","Mage, Support","Fighter, Mage","Support, Tank",1,0,1
5959,"Tank, Fighter","Fighter, Tank","Tank, Mage","Fighter, Mage",1,0,1
5958,Tank,Fighter,"Tank, Mage","Tank, Fighter",0,1,1
5957,Mage,"Fighter, Assassin","Tank, Fighter","Tank, Fighter",1,0,1
3575,"Fighter, Mage","Fighter, Tank","Mage, Fighter","Support, Mage",1,0,1
3576,Fighter,"Tank, Support","Fighter, Tank","Support, Mage",1,0,1
5954,"Fighter, Assassin","Fighter, Assassin","Fighter, Mage",Fighter,1,0,1
5953,Mage,"Assassin, Fighter","Fighter, Tank","Fighter, Assassin",1,0,1
5952,"Fighter, Tank","Tank, Fighter",Mage,"Tank, Mage",0,1,1
3577,"Fighter, Mage","Fighter, Tank","Fighter, Tank","Mage, Support",1,0,1
5950,"Mage, Marksman",Fighter,"Fighter, Mage","Fighter, Mage",0,1,1
5949,"Mage, Marksman",Fighter,Marksman,Marksman,0,1,1
5948,"Fighter, Assassin","Mage, Fighter","Fighter, Assassin","Fighter, Assassin",1,0,1
5947,"Fighter, Assassin","Mage, Fighter","Fighter, Mage","Fighter, Assassin",1,0,1
3578,"Assassin, Fighter","Tank, Fighter","Mage, Fighter","Support, Fighter",1,0,1
5945,"Tank, Mage","Fighter, Mage","Fighter, Mage","Fighter, Assassin",1,0,1
3579,"Fighter, Tank","Support, Tank",Fighter,"Support, Tank",1,0,1
3580,"Fighter, Tank","Fighter, Tank","Mage, Fighter","Support, Fighter",0,1,1
3581,"Fighter, Tank","Support, Fighter",Marksman,"Support, Mage",1,0,1
3582,"Fighter, Tank","Fighter, Tank",Marksman,"Mage, Support",0,1,1
3583,"Fighter, Assassin","Mage, Support","Fighter, Tank","Tank, Support",0,1,1
3601,Fighter,"Mage, Support","Support, Mage","Mage, Assassin",1,0,1
3602,Marksman,"Support, Tank","Assassin, Fighter","Mage, Assassin",1,0,1
5851,Tank,"Fighter, Assassin","Mage, Marksman","Fighter, Mage",1,0,1
5864,"Mage, Tank","Assassin, Fighter",Tank,"Mage, Fighter",1,0,1
5878,"Tank, Mage","Fighter, Tank","Fighter, Tank","Support, Mage",0,1,1
3621,"Fighter, Mage","Support, Mage","Fighter, Tank","Mage, Assassin",1,0,1
5875,"Tank, Mage",Fighter,"Fighter, Mage","Fighter, Assassin",1,0,1
5873,"Tank, Mage","Support, Mage","Fighter, Mage","Assassin, Fighter",1,0,1
5871,"Fighter, Marksman",Fighter,"Tank, Fighter","Mage, Fighter",0,1,1
5870,"Fighter, Tank","Assassin, Fighter",Fighter,"Fighter, Mage",1,0,1
5868,Tank,"Assassin, Fighter","Fighter, Mage",Marksman,1,0,1
3626,Fighter,"Mage, Support","Tank, Mage","Tank, Support",1,0,1
5866,"Fighter, Tank","Mage, Fighter","Tank, Fighter","Support, Mage",0,1,1
5865,Tank,"Fighter, Tank","Tank, Fighter","Mage, Fighter",0,1,1
5863,"Mage, Marksman","Assassin, Fighter",Tank,"Mage, Fighter",1,0,1
5907,"Tank, Mage","Fighter, Assassin",Mage,"Fighter, Tank",0,1,1
3627,"Assassin, Fighter","Support, Fighter","Support, Mage","Support, Fighter",0,1,1
3628,"Fighter, Tank","Mage, Assassin","Support, Mage",Marksman,0,1,1
5860,"Mage, Fighter",Assassin,"Fighter, Mage","Fighter, Mage",1,0,1
5859,"Fighter, Marksman","Assassin, Fighter","Tank, Fighter",Marksman,0,1,1
5858,"Fighter, Tank",Fighter,"Tank, Fighter","Support, Mage",0,1,1
5856,"Fighter, Tank","Assassin, Fighter","Fighter, Assassin","Support, Mage",1,0,1
3630,"Mage, Fighter","Mage, Support","Support, Mage","Support, Tank",0,1,1
5854,"Fighter, Assassin",Marksman,"Fighter, Mage","Fighter, Assassin",1,0,1
3631,"Support, Mage","Support, Mage","Fighter, Assassin","Mage, Support",1,0,1
3632,"Assassin, Fighter","Tank, Fighter","Assassin, Fighter","Mage, Support",1,0,1
3620,"Fighter, Tank","Fighter, Tank","Fighter, Mage","Tank, Support",0,1,1
5880,"Fighter, Tank","Support, Mage","Fighter, Assassin",Fighter,1,0,1
5882,"Fighter, Tank","Fighter, Assassin","Tank, Mage","Fighter, Tank",1,0,1
3618,"Fighter, Tank","Mage, Support","Tank, Fighter","Support, Tank",0,1,1
5905,Mage,"Tank, Fighter","Fighter, Assassin","Assassin, Fighter",1,0,1
5904,"Tank, Mage",Fighter,"Assassin, Mage","Tank, Fighter",1,0,1
3604,"Tank, Mage","Tank, Support",Fighter,"Support, Tank",1,0,1
3605,"Assassin, Fighter","Fighter, Tank",Marksman,"Mage, Assassin",0,1,1
3606,Marksman,"Fighter, Tank",Fighter,"Tank, Support",1,0,1
3607,Marksman,"Tank, Fighter","Mage, Fighter","Fighter, Tank",0,1,1
5899,"Fighter, Marksman",Fighter,"Tank, Mage","Fighter, Assassin",0,1,1
5898,"Tank, Fighter",Fighter,"Tank, Mage",Marksman,1,0,1
5897,"Fighter, Marksman",Fighter,"Tank, Mage",Marksman,0,1,1
3608,"Assassin, Fighter","Mage, Assassin",Marksman,"Fighter, Tank",1,0,1
5895,"Fighter, Assassin","Support, Mage","Fighter, Mage","Fighter, Assassin",0,1,1
5894,"Fighter, Marksman","Assassin, Fighter","Tank, Mage","Assassin, Fighter",1,0,1
5893,"Fighter, Tank","Fighter, Assassin","Tank, Fighter","Support, Mage",0,1,1
5892,"Tank, Mage","Assassin, Fighter",Fighter,Fighter,1,0,1
3609,Marksman,"Support, Tank","Support, Mage","Support, Tank",1,0,1
5890,"Fighter, Assassin",Marksman,"Fighter, Tank","Fighter, Tank",0,1,1
3610,"Fighter, Assassin","Tank, Support",Marksman,"Mage, Assassin",0,1,1
5888,"Tank, Fighter","Support, Mage",Fighter,Fighter,0,1,1
5887,"Fighter, Mage","Support, Mage","Tank, Fighter","Fighter, Assassin",1,0,1
3613,"Support, Mage","Mage, Support","Fighter, Assassin",Marksman,1,0,1
5885,"Tank, Fighter","Support, Mage","Tank, Mage","Fighter, Tank",0,1,1
5732,"Tank, Fighter","Mage, Fighter",Mage,"Fighter, Assassin",1,0,1
3704,"Fighter, Tank","Support, Mage","Mage, Fighter","Mage, Support",0,1,1
5729,"Fighter, Marksman","Mage, Fighter","Mage, Marksman","Fighter, Mage",0,1,1
5578,"Assassin, Fighter","Fighter, Mage","Tank, Mage","Mage, Fighter",1,0,1
3782,"Assassin, Mage","Support, Mage","Tank, Fighter","Tank, Support",0,1,1
3784,"Tank, Fighter","Support, Mage","Tank, Mage",Support,1,0,1
5587,"Tank, Mage","Fighter, Mage","Tank, Fighter","Assassin, Fighter",0,1,1
5586,"Tank, Fighter","Mage, Fighter","Fighter, Support","Fighter, Assassin",1,0,1
3785,"Assassin, Mage","Tank, Support","Fighter, Assassin","Support, Mage",1,0,1
3786,"Tank, Mage","Support, Tank","Tank, Fighter",Support,0,1,1
5583,"Fighter, Tank",Tank,"Tank, Fighter","Fighter, Assassin",1,0,1
5581,"Fighter, Tank","Support, Mage",Fighter,"Fighter, Mage",0,1,1
5580,Marksman,"Fighter, Mage","Tank, Fighter",Marksman,1,0,1
5579,"Tank, Mage",Marksman,"Fighter, Assassin","Fighter, Mage",1,0,1
3788,"Fighter, Tank","Support, Tank",Fighter,"Tank, Fighter",1,0,1
5560,"Fighter, Assassin","Tank, Mage","Fighter, Assassin","Tank, Fighter",1,0,1
5576,"Tank, Fighter","Fighter, Mage",Mage,Marksman,1,0,1
3791,"Fighter, Assassin","Fighter, Assassin","Tank, Fighter","Support, Fighter",0,1,1
3793,"Fighter, Assassin",Mage,"Tank, Fighter","Support, Fighter",1,0,1
5571,"Tank, Fighter","Mage, Fighter","Assassin, Fighter","Assassin, Fighter",1,0,1
5570,"Fighter, Mage",Fighter,Tank,"Tank, Fighter",1,0,1
3795,Fighter,"Support, Mage","Fighter, Assassin","Fighter, Support",1,0,1
3797,"Fighter, Assassin","Support, Fighter","Tank, Fighter","Mage, Support",0,1,1
3801,"Fighter, Assassin",Mage,"Tank, Fighter","Support, Tank",0,1,1
5564,"Fighter, Tank","Tank, Mage",Marksman,"Fighter, Mage",0,1,1
5562,"Fighter, Marksman",Fighter,"Tank, Fighter","Tank, Fighter",1,0,1
3781,"Assassin, Mage","Support, Tank","Assassin, Fighter","Support, Fighter",0,1,1
5591,"Tank, Mage","Mage, Fighter","Mage, Support",Fighter,1,0,1
5592,"Fighter, Tank",Fighter,"Mage, Fighter","Mage, Fighter",0,1,1
5593,"Tank, Mage","Fighter, Mage","Fighter, Tank",Marksman,0,1,1
3768,Fighter,"Support, Fighter","Assassin, Mage","Mage, Marksman",1,0,1
3769,"Assassin, Fighter","Mage, Marksman","Tank, Mage","Tank, Support",0,1,1
5614,Fighter,"Mage, Fighter",Mage,Marksman,1,0,1
5613,"Support, Tank","Fighter, Mage","Support, Mage",Fighter,1,0,1
5612,"Tank, Fighter","Mage, Fighter",Mage,"Assassin, Fighter",1,0,1
3770,"Fighter, Assassin","Tank, Fighter","Assassin, Mage","Support, Fighter",0,1,1
5610,"Tank, Fighter","Fighter, Mage","Marksman, Fighter","Assassin, Fighter",1,0,1
5609,"Marksman, Fighter","Fighter, Mage","Tank, Fighter","Assassin, Fighter",0,1,1
5608,Fighter,"Mage, Fighter","Tank, Fighter","Fighter, Mage",1,0,1
3771,"Fighter, Assassin","Fighter, Tank","Fighter, Mage","Mage, Support",1,0,1
3772,"Assassin, Mage",Mage,"Assassin, Fighter","Tank, Fighter",0,1,1
3774,"Mage, Fighter",Support,"Fighter, Assassin","Tank, Support",0,1,1
5603,Fighter,"Assassin, Fighter","Marksman, Fighter","Fighter, Mage",1,0,1
3776,"Tank, Fighter","Tank, Support","Fighter, Tank","Support, Mage",0,1,1
5601,"Assassin, Fighter",Marksman,"Assassin, Fighter",Marksman,1,0,1
5600,"Fighter, Tank","Tank, Fighter","Assassin, Fighter",Marksman,0,1,1
5599,"Fighter, Tank","Assassin, Fighter","Assassin, Fighter","Fighter, Assassin",0,1,1
5598,"Assassin, Fighter","Tank, Fighter","Tank, Mage",Marksman,0,1,1
3777,"Tank, Mage","Support, Mage",Fighter,"Tank, Fighter",0,1,1
3778,"Assassin, Mage","Mage, Marksman","Fighter, Assassin","Tank, Fighter",1,0,1
3780,Fighter,"Support, Tank","Assassin, Mage",Mage,1,0,1
5561,Tank,"Tank, Fighter","Fighter, Mage","Tank, Mage",0,1,1
3804,"Assassin, Fighter","Tank, Fighter","Tank, Fighter","Support, Fighter",1,0,1
3706,"Mage, Fighter","Tank, Fighter",Marksman,"Support, Mage",0,1,1
5515,"Fighter, Mage","Fighter, Tank","Tank, Mage","Mage, Fighter",0,1,1
3829,"Assassin, Fighter","Support, Fighter","Assassin, Mage","Support, Mage",1,0,1
3831,"Fighter, Mage","Tank, Fighter","Assassin, Mage","Tank, Support",1,0,1
5524,"Fighter, Tank","Fighter, Mage",Marksman,"Tank, Fighter",1,0,1
3832,"Assassin, Mage","Support, Tank","Fighter, Mage","Tank, Fighter",0,1,1
5522,"Tank, Mage","Mage, Fighter","Mage, Marksman","Tank, Fighter",0,1,1
3833,"Fighter, Mage","Tank, Support","Fighter, Assassin","Support, Tank",1,0,1
5520,"Tank, Mage","Support, Mage","Tank, Fighter","Assassin, Fighter",0,1,1
5519,"Fighter, Marksman",Fighter,"Tank, Fighter","Fighter, Assassin",1,0,1
5517,Tank,"Assassin, Fighter","Mage, Fighter",Marksman,0,1,1
3835,"Fighter, Mage","Support, Tank","Support, Mage","Support, Fighter",1,0,1
5514,Tank,"Fighter, Assassin","Fighter, Marksman","Mage, Fighter",0,1,1
3805,"Fighter, Assassin","Mage, Support","Tank, Fighter","Mage, Marksman",0,1,1
3836,"Tank, Fighter","Fighter, Tank","Fighter, Mage","Mage, Support",0,1,1
5512,"Fighter, Tank",Fighter,"Fighter, Mage","Mage, Fighter",1,0,1
5511,"Fighter, Marksman","Fighter, Tank","Fighter, Mage","Fighter, Mage",0,1,1
3837,"Assassin, Fighter","Support, Mage",Fighter,"Tank, Fighter",0,1,1
5509,"Assassin, Fighter",Marksman,Tank,"Fighter, Assassin",1,0,1
5507,"Fighter, Assassin",Marksman,"Fighter, Tank","Assassin, Fighter",0,1,1
3839,"Tank, Fighter","Support, Fighter","Fighter, Assassin","Fighter, Assassin",1,0,1
5505,"Tank, Fighter","Fighter, Assassin","Assassin, Fighter","Mage, Fighter",0,1,1
5504,"Tank, Fighter","Assassin, Fighter","Mage, Marksman","Assassin, Fighter",0,1,1
5503,"Tank, Fighter","Support, Mage",Tank,"Assassin, Fighter",1,0,1
3827,"Assassin, Fighter","Tank, Support","Assassin, Mage",Mage,1,0,1
5529,Tank,Marksman,"Fighter, Mage","Fighter, Assassin",1,0,1
3826,"Assassin, Mage","Tank, Fighter","Fighter, Mage","Support, Mage",0,1,1
5531,"Tank, Mage","Assassin, Fighter","Fighter, Assassin",Marksman,0,1,1
3806,"Tank, Fighter","Mage, Marksman","Tank, Fighter","Tank, Fighter",1,0,1
3808,"Fighter, Tank","Mage, Support","Tank, Fighter","Tank, Mage",1,0,1
5554,"Fighter, Assassin","Fighter, Assassin","Tank, Fighter","Tank, Fighter",0,1,1
5553,"Fighter, Mage","Tank, Mage","Fighter, Assassin","Tank, Fighter",1,0,1
3809,"Fighter, Assassin","Support, Fighter","Tank, Fighter",Mage,0,1,1
5551,"Tank, Fighter","Tank, Fighter","Tank, Mage","Fighter, Assassin",1,0,1
5550,"Fighter, Mage","Fighter, Assassin","Fighter, Marksman","Tank, Fighter",0,1,1
5549,"Tank, Fighter","Tank, Mage","Tank, Mage","Tank, Fighter",1,0,1
3813,"Assassin, Fighter","Support, Mage","Assassin, Fighter",Mage,0,1,1
3816,"Fighter, Assassin","Support, Fighter","Tank, Fighter","Tank, Support",0,1,1
3819,"Fighter, Assassin","Support, Fighter","Fighter, Assassin",Mage,1,0,1
3820,"Tank, Fighter","Tank, Support","Fighter, Assassin",Mage,0,1,1
5542,"Tank, Mage","Tank, Fighter","Fighter, Mage","Tank, Mage",1,0,1
5541,"Fighter, Marksman","Fighter, Assassin","Tank, Mage","Mage, Fighter",1,0,1
5540,Tank,"Support, Mage","Tank, Mage",Marksman,0,1,1
5538,Tank,Fighter,"Assassin, Fighter","Mage, Fighter",1,0,1
5537,Tank,"Tank, Fighter","Fighter, Marksman","Assassin, Fighter",0,1,1
3823,"Fighter, Mage",Support,"Support, Mage","Tank, Support",0,1,1
3825,"Assassin, Mage","Support, Tank",Fighter,"Tank, Support",1,0,1
5533,"Fighter, Mage","Assassin, Fighter","Fighter, Assassin",Marksman,1,0,1
5532,"Fighter, Mage","Fighter, Assassin","Fighter, Assassin",Marksman,1,0,1
5617,"Support, Mage","Mage, Fighter",Fighter,Marksman,0,1,1
5618,"Support, Mage",Fighter,"Marksman, Fighter","Mage, Fighter",0,1,1
5619,"Fighter, Support","Assassin, Fighter","Support, Mage","Support, Mage",0,1,1
3727,"Tank, Fighter","Tank, Fighter","Fighter, Mage","Fighter, Tank",1,0,1
5700,"Tank, Fighter","Mage, Fighter","Fighter, Tank","Tank, Mage",0,1,1
3720,"Fighter, Mage","Tank, Fighter","Assassin, Mage","Mage, Marksman",0,1,1
3721,"Tank, Fighter","Fighter, Assassin","Fighter, Mage","Marksman, Assassin",0,1,1
3722,Fighter,"Support, Fighter","Assassin, Mage",Mage,0,1,1
5696,"Fighter, Mage","Tank, Mage","Tank, Mage","Fighter, Mage",1,0,1
3723,Marksman,"Fighter, Assassin","Assassin, Fighter","Fighter, Tank",1,0,1
3724,"Assassin, Mage",Mage,Fighter,"Mage, Support",1,0,1
3726,"Fighter, Assassin","Fighter, Tank","Tank, Mage","Support, Mage",0,1,1
5691,"Fighter, Tank","Fighter, Mage",Tank,"Tank, Mage",1,0,1
5690,"Fighter, Mage","Tank, Mage","Fighter, Tank","Tank, Mage",1,0,1
5688,"Tank, Mage","Tank, Fighter",Fighter,"Tank, Mage",1,0,1
5621,"Tank, Fighter","Assassin, Mage","Tank, Fighter","Fighter, Mage",0,1,1
3728,"Mage, Fighter",Support,"Fighter, Mage","Mage, Support",1,0,1
5686,"Fighter, Tank","Support, Mage","Fighter, Assassin",Marksman,1,0,1
3729,"Fighter, Mage","Mage, Support","Assassin, Mage","Support, Tank",1,0,1
5683,"Mage, Fighter","Fighter, Mage","Fighter, Tank",Fighter,1,0,1
5682,"Fighter, Mage","Fighter, Tank","Fighter, Assassin","Fighter, Mage",0,1,1
3731,Fighter,"Support, Tank","Tank, Fighter","Tank, Fighter",0,1,1
5680,"Fighter, Tank","Fighter, Mage","Mage, Fighter",Fighter,1,0,1
3733,"Tank, Fighter","Tank, Support","Assassin, Mage","Support, Mage",0,1,1
5678,"Tank, Mage","Tank, Fighter","Fighter, Assassin","Mage, Fighter",0,1,1
3735,"Assassin, Mage",Mage,"Fighter, Assassin","Tank, Fighter",1,0,1
5702,"Tank, Mage","Tank, Mage","Fighter, Assassin","Tank, Fighter",0,1,1
3718,Fighter,"Support, Mage","Assassin, Mage","Support, Fighter",0,1,1
3717,"Tank, Mage","Support, Mage","Fighter, Mage","Mage, Support",0,1,1
5705,"Fighter, Tank","Tank, Fighter","Fighter, Tank","Mage, Fighter",1,0,1
3707,Fighter,"Support, Mage","Assassin, Mage","Tank, Fighter",0,1,1
3708,"Tank, Fighter","Mage, Support","Tank, Fighter","Fighter, Tank",0,1,1
3709,"Assassin, Mage","Support, Mage","Fighter, Assassin","Tank, Fighter",1,0,1
5724,Tank,"Mage, Fighter","Fighter, Tank","Fighter, Tank",1,0,1
5723,Tank,"Mage, Fighter","Fighter, Mage","Support, Mage",0,1,1
5722,Tank,"Mage, Fighter","Mage, Marksman","Assassin, Fighter",1,0,1
5721,"Mage, Marksman","Support, Mage","Fighter, Tank","Assassin, Fighter",1,0,1
5720,"Tank, Mage","Mage, Fighter","Fighter, Tank","Fighter, Tank",0,1,1
5719,Tank,"Fighter, Mage","Fighter, Tank","Fighter, Assassin",0,1,1
3712,Fighter,"Tank, Support","Fighter, Assassin","Tank, Fighter",1,0,1
5716,"Fighter, Marksman","Support, Mage","Fighter, Tank","Mage, Fighter",0,1,1
3713,Fighter,Mage,"Assassin, Mage","Tank, Fighter",1,0,1
5714,"Mage, Marksman","Fighter, Mage",Tank,"Fighter, Assassin",0,1,1
5713,"Mage, Marksman","Fighter, Tank","Fighter, Mage","Mage, Fighter",0,1,1
5712,"Fighter, Assassin","Tank, Fighter","Fighter, Tank","Support, Mage",1,0,1
3714,"Support, Mage","Fighter, Mage","Fighter, Assassin",Mage,1,0,1
5710,Tank,"Fighter, Assassin","Fighter, Mage","Fighter, Mage",0,1,1
5709,"Fighter, Tank","Tank, Mage",Tank,"Mage, Fighter",1,0,1
3715,"Mage, Support","Fighter, Tank","Support, Mage","Fighter, Mage",0,1,1
5707,Tank,"Fighter, Assassin","Fighter, Mage","Tank, Mage",1,0,1
3716,"Assassin, Mage","Tank, Support","Assassin, Fighter",Mage,1,0,1
5675,Fighter,"Mage, Fighter","Fighter, Assassin",Fighter,0,1,1
5674,Fighter,Fighter,Tank,"Assassin, Fighter",1,0,1
5673,"Fighter, Assassin","Tank, Fighter","Fighter, Assassin","Mage, Fighter",1,0,1
5647,"Support, Tank",Marksman,"Fighter, Tank","Assassin, Fighter",0,1,1
3757,"Tank, Mage","Fighter, Tank","Tank, Fighter","Support, Tank",1,0,1
3759,"Fighter, Mage",Mage,Fighter,"Support, Tank",0,1,1
5640,"Fighter, Marksman","Support, Mage","Tank, Fighter","Mage, Fighter",1,0,1
3760,"Assassin, Mage","Support, Tank","Assassin, Fighter","Tank, Support",1,0,1
5638,"Fighter, Assassin","Support, Mage",Fighter,"Fighter, Assassin",0,1,1
5637,"Fighter, Marksman","Assassin, Fighter","Tank, Fighter","Support, Mage",0,1,1
5636,"Tank, Fighter","Assassin, Fighter",Fighter,"Fighter, Assassin",0,1,1
5635,"Tank, Mage","Mage, Fighter","Fighter, Assassin","Fighter, Assassin",1,0,1
5634,"Tank, Mage","Mage, Fighter","Tank, Fighter","Support, Mage",1,0,1
3761,"Assassin, Mage","Support, Tank",Fighter,"Support, Mage",0,1,1
3762,Fighter,Mage,"Fighter, Mage","Support, Tank",1,0,1
5631,"Assassin, Fighter","Mage, Fighter","Tank, Fighter",Fighter,0,1,1
5630,"Support, Mage","Fighter, Mage","Tank, Fighter","Fighter, Mage",1,0,1
5629,"Marksman, Fighter","Fighter, Assassin","Support, Mage",Fighter,0,1,1
5628,"Tank, Fighter","Assassin, Fighter","Marksman, Fighter","Mage, Fighter",0,1,1
5627,"Fighter, Assassin","Assassin, Fighter",Fighter,"Fighter, Mage",0,1,1
5626,"Support, Mage",Fighter,"Tank, Fighter","Fighter, Mage",0,1,1
3763,"Assassin, Mage","Tank, Support","Assassin, Fighter","Support, Tank",1,0,1
3764,"Tank, Fighter","Support, Tank",Fighter,"Tank, Support",1,0,1
3765,"Tank, Mage","Support, Tank","Fighter, Mage","Support, Fighter",1,0,1
3766,"Mage, Fighter","Tank, Fighter","Tank, Mage","Support, Fighter",0,1,1
3754,"Mage, Fighter","Tank, Support","Tank, Mage",Support,1,0,1
5648,Tank,"Support, Mage",Fighter,Fighter,1,0,1
5672,"Mage, Fighter","Fighter, Tank","Mage, Fighter",Fighter,0,1,1
3752,"Fighter, Mage","Mage, Marksman",Fighter,"Tank, Support",1,0,1
3737,"Fighter, Mage","Fighter, Tank","Tank, Fighter","Tank, Support",1,0,1
5669,"Fighter, Tank",Marksman,Tank,Fighter,0,1,1
3740,"Assassin, Fighter","Tank, Fighter","Assassin, Mage",Mage,1,0,1
3741,"Tank, Fighter","Fighter, Tank","Mage, Fighter","Support, Tank",1,0,1
3742,"Assassin, Mage","Support, Mage","Fighter, Assassin","Tank, Support",0,1,1
3743,"Fighter, Assassin","Tank, Support","Assassin, Fighter","Tank, Fighter",0,1,1
5664,"Fighter, Tank",Fighter,Tank,"Fighter, Assassin",1,0,1
3744,"Tank, Fighter","Mage, Marksman","Fighter, Tank","Support, Mage",0,1,1
5662,"Mage, Fighter","Fighter, Mage","Fighter, Tank",Marksman,1,0,1
3745,"Assassin, Fighter","Tank, Fighter","Fighter, Mage",Mage,0,1,1
5660,"Assassin, Fighter","Fighter, Tank","Fighter, Assassin",Fighter,0,1,1
5659,"Fighter, Marksman","Assassin, Fighter","Tank, Fighter",Fighter,1,0,1
3746,"Tank, Fighter","Support, Tank","Assassin, Fighter","Fighter, Tank",0,1,1
3747,"Assassin, Mage","Support, Mage",Fighter,"Tank, Support",0,1,1
3748,"Assassin, Mage","Support, Fighter","Fighter, Mage","Tank, Support",0,1,1
5655,"Tank, Mage","Assassin, Fighter","Fighter, Mage","Support, Mage",0,1,1
5654,"Assassin, Fighter","Mage, Fighter",Tank,Fighter,1,0,1
3749,"Tank, Mage","Support, Tank","Mage, Fighter","Support, Tank",0,1,1
5652,"Tank, Mage",Fighter,"Tank, Fighter","Support, Mage",0,1,1
5651,"Fighter, Marksman",Marksman,"Tank, Fighter","Mage, Fighter",1,0,1
3750,"Fighter, Mage","Fighter, Tank","Tank, Mage","Support, Tank",1,0,1
5080,"Fighter, Assassin","Support, Tank",Fighter,"Fighter, Tank",1,0,1
5079,Marksman,"Mage, Support",Fighter,"Fighter, Tank",0,1,1
5078,"Tank, Fighter","Support, Fighter","Fighter, Assassin","Mage, Support",1,0,1
4497,"Marksman, Support",Marksman,"Marksman, Assassin","Tank, Fighter",1,0,1
4106,"Assassin, Fighter","Tank, Support","Assassin, Fighter","Mage, Assassin",0,1,1
4107,"Fighter, Mage","Support, Fighter","Tank, Mage","Tank, Support",1,0,1
4108,"Fighter, Mage",Support,"Tank, Fighter","Tank, Fighter",1,0,1
4504,"Marksman, Support","Support, Tank",Marksman,"Mage, Assassin",1,0,1
4503,Marksman,"Mage, Assassin",Marksman,"Support, Tank",1,0,1
4502,"Marksman, Support",Mage,Marksman,"Mage, Support",0,1,1
4501,"Marksman, Assassin","Tank, Support",Mage,"Marksman, Support",0,1,1
4500,"Tank, Support",Marksman,"Fighter, Tank","Mage, Fighter",1,0,1
4499,"Marksman, Mage","Support, Mage",Mage,Marksman,1,0,1
4498,Marksman,"Mage, Assassin","Marksman, Assassin","Support, Fighter",0,1,1
4109,"Tank, Fighter",Support,"Mage, Fighter","Support, Fighter",1,0,1
4115,"Mage, Fighter","Support, Mage","Mage, Assassin","Support, Mage",0,1,1
4494,"Mage, Support","Marksman, Support","Marksman, Assassin","Support, Tank",0,1,1
4493,"Marksman, Assassin","Fighter, Tank","Marksman, Mage","Mage, Support",1,0,1
4492,"Marksman, Assassin",Marksman,Marksman,"Support, Tank",1,0,1
4491,"Marksman, Support","Support, Tank","Marksman, Mage",Marksman,1,0,1
4490,"Marksman, Assassin",Marksman,"Marksman, Support","Support, Tank",1,0,1
4489,"Marksman, Mage","Support, Tank","Marksman, Assassin",Mage,0,1,1
4488,Marksman,"Support, Tank","Mage, Support","Mage, Support",1,0,1
4487,Mage,"Tank, Support","Marksman, Support","Support, Tank",0,1,1
4486,Mage,"Support, Tank","Marksman, Mage","Mage, Assassin",0,1,1
4112,"Support, Mage","Support, Fighter","Assassin, Fighter","Mage, Assassin",1,0,1
4508,"Marksman, Support","Mage, Support",Marksman,Mage,1,0,1
4105,"Tank, Mage","Support, Fighter","Tank, Mage",Support,1,0,1
4510,Marksman,"Mage, Assassin","Marksman, Mage","Tank, Support",1,0,1
4511,Marksman,"Support, Tank","Marksman, Support","Mage, Assassin",1,0,1
4536,"Marksman, Assassin",Support,"Marksman, Support","Support, Fighter",1,0,1
4094,"Mage, Fighter","Support, Tank",Fighter,"Tank, Fighter",0,1,1
4534,Marksman,"Fighter, Support","Marksman, Assassin","Support, Mage",0,1,1
4095,"Tank, Fighter","Fighter, Tank",Fighter,"Support, Mage",0,1,1
4097,"Fighter, Tank","Support, Mage","Assassin, Fighter","Support, Mage",1,0,1
4098,Fighter,"Support, Tank","Marksman, Fighter","Tank, Support",0,1,1
4529,"Marksman, Assassin","Mage, Marksman",Marksman,"Support, Mage",0,1,1
4099,"Assassin, Fighter","Tank, Fighter",Marksman,"Support, Tank",1,0,1
4527,"Marksman, Support",Support,"Marksman, Mage","Support, Mage",1,0,1
4526,"Marksman, Mage","Tank, Fighter","Marksman, Mage","Support, Fighter",1,0,1
4525,"Marksman, Mage",Mage,"Marksman, Assassin","Mage, Support",0,1,1
4524,"Marksman, Mage","Tank, Support","Marksman, Support","Mage, Support",1,0,1
4101,"Assassin, Fighter","Tank, Mage","Mage, Fighter","Support, Fighter",0,1,1
4520,Marksman,"Support, Fighter","Marksman, Mage","Mage, Assassin",0,1,1
4518,Marksman,"Mage, Support","Marksman, Support","Mage, Assassin",1,0,1
4517,"Marksman, Mage","Mage, Assassin",Marksman,Marksman,1,0,1
4516,"Marksman, Assassin","Mage, Support",Marksman,Marksman,0,1,1
4515,"Marksman, Mage","Support, Mage","Marksman, Assassin",Marksman,0,1,1
4514,"Marksman, Support","Support, Tank","Marksman, Assassin","Mage, Assassin",0,1,1
4513,"Marksman, Assassin","Mage, Assassin","Marksman, Support",Marksman,1,0,1
4104,"Tank, Fighter","Tank, Fighter","Tank, Mage","Support, Fighter",0,1,1
4113,"Fighter, Tank","Mage, Assassin",Marksman,Marksman,1,0,1
4116,"Assassin, Fighter","Mage, Assassin","Assassin, Fighter","Support, Fighter",1,0,1
4091,"Assassin, Fighter","Tank, Fighter","Mage, Fighter","Tank, Support",1,0,1
4441,"Marksman, Mage",Tank,"Marksman, Assassin","Mage, Support",1,0,1
4137,"Tank, Fighter",Mage,"Fighter, Mage","Tank, Fighter",1,0,1
4138,Marksman,"Support, Mage","Assassin, Mage","Mage, Support",0,1,1
4139,"Tank, Mage","Support, Tank",Fighter,"Support, Mage",1,0,1
4140,"Fighter, Assassin","Tank, Mage",Fighter,"Support, Mage",1,0,1
4143,"Assassin, Fighter","Support, Fighter","Fighter, Mage",Mage,1,0,1
4144,"Support, Mage","Support, Mage","Tank, Fighter",Support,1,0,1
4145,"Assassin, Fighter","Support, Fighter","Support, Mage",Support,1,0,1
4444,Marksman,"Support, Tank",Marksman,"Tank, Mage",1,0,1
4146,"Fighter, Tank",Support,"Fighter, Assassin","Support, Tank",0,1,1
4147,"Fighter, Tank","Support, Mage","Fighter, Assassin",Support,1,0,1
4439,"Marksman, Mage","Mage, Assassin",Marksman,"Mage, Support",0,1,1
4481,Marksman,"Mage, Support",Mage,"Support, Mage",1,0,1
4438,"Marksman, Support","Mage, Support",Mage,"Mage, Support",1,0,1
4437,"Marksman, Mage",Marksman,"Marksman, Support","Mage, Assassin",0,1,1
4149,"Fighter, Assassin","Support, Tank","Support, Mage","Support, Mage",0,1,1
4435,"Marksman, Assassin","Mage, Assassin",Mage,Marksman,1,0,1
4434,"Marksman, Assassin","Mage, Support",Mage,"Mage, Support",1,0,1
4150,"Assassin, Fighter","Support, Fighter","Mage, Fighter",Support,0,1,1
4151,"Mage, Fighter","Support, Mage","Assassin, Fighter",Support,1,0,1
4431,Mage,"Support, Tank","Marksman, Support","Mage, Support",1,0,1
4430,"Marksman, Support",Marksman,"Marksman, Assassin","Mage, Support",1,0,1
4152,"Tank, Mage","Support, Fighter","Fighter, Mage","Support, Tank",1,0,1
4454,Marksman,Tank,Marksman,"Tank, Fighter",1,0,1
4135,Fighter,Support,"Mage, Fighter","Support, Tank",0,1,1
4456,"Marksman, Mage","Support, Tank",Marksman,Tank,0,1,1
4457,Marksman,Tank,"Marksman, Mage",Support,1,0,1
4117,"Assassin, Mage","Mage, Support","Fighter, Assassin","Mage, Support",1,0,1
4118,Marksman,"Support, Fighter","Assassin, Mage","Mage, Support",0,1,1
4478,"Marksman, Fighter","Support, Mage","Marksman, Assassin","Mage, Support",1,0,1
4119,"Support, Mage",Marksman,"Assassin, Fighter","Support, Fighter",0,1,1
4120,"Assassin, Fighter","Support, Fighter","Support, Mage","Mage, Support",1,0,1
4475,"Marksman, Support","Tank, Support","Marksman, Mage","Fighter, Tank",1,0,1
4121,Assassin,"Mage, Support","Fighter, Assassin","Support, Mage",0,1,1
4473,"Marksman, Mage",Tank,Marksman,"Fighter, Tank",1,0,1
4122,Fighter,"Mage, Assassin","Fighter, Assassin","Fighter, Tank",1,0,1
4470,Marksman,"Tank, Mage",Marksman,"Support, Tank",1,0,1
4126,"Assassin, Mage","Mage, Support",Fighter,"Support, Mage",0,1,1
4468,"Marksman, Assassin","Mage, Assassin","Marksman, Mage",Mage,1,0,1
4128,Marksman,"Support, Tank","Mage, Fighter","Support, Tank",1,0,1
4129,"Assassin, Mage","Mage, Assassin",Marksman,"Support, Fighter",0,1,1
4130,"Tank, Fighter","Support, Fighter","Assassin, Fighter","Tank, Fighter",1,0,1
4131,Fighter,"Support, Tank","Tank, Fighter","Support, Tank",0,1,1
4462,Marksman,"Support, Mage","Marksman, Support",Tank,0,1,1
4461,"Marksman, Assassin","Support, Tank","Marksman, Support","Tank, Support",0,1,1
4133,"Fighter, Mage","Support, Fighter","Assassin, Fighter",Support,1,0,1
4134,"Support, Mage","Support, Mage",Marksman,"Fighter, Mage",0,1,1
4458,"Marksman, Support","Tank, Support","Marksman, Mage",Tank,0,1,1
4092,"Fighter, Mage","Tank, Support","Fighter, Tank","Support, Fighter",0,1,1
4540,"Marksman, Assassin",Support,"Marksman, Mage","Support, Tank",0,1,1
4650,"Marksman, Assassin","Tank, Support","Marksman, Assassin","Support, Tank",0,1,1
4064,"Tank, Mage","Support, Mage","Tank, Fighter","Support, Fighter",1,0,1
4060,"Tank, Mage","Mage, Support","Tank, Fighter","Support, Mage",1,0,1
4618,Marksman,"Support, Fighter","Fighter, Marksman","Support, Mage",0,1,1
4617,"Marksman, Assassin","Fighter, Support","Marksman, Mage","Mage, Support",0,1,1
4062,Marksman,"Mage, Support","Fighter, Tank","Mage, Assassin",1,0,1
4615,Mage,"Mage, Assassin",Marksman,"Mage, Support",1,0,1
4614,"Marksman, Support","Support, Fighter",Mage,"Mage, Support",1,0,1
4613,Mage,"Mage, Support","Marksman, Support","Mage, Assassin",0,1,1
4612,Mage,"Mage, Support","Marksman, Support","Mage, Support",1,0,1
4611,Marksman,"Mage, Assassin","Marksman, Support","Support, Mage",0,1,1
4063,"Tank, Mage","Support, Mage","Fighter, Mage","Mage, Marksman",1,0,1
4608,"Marksman, Mage","Mage, Assassin",Mage,"Support, Tank",1,0,1
4068,"Fighter, Mage","Support, Mage","Tank, Mage","Mage, Marksman",1,0,1
4607,Marksman,"Mage, Assassin","Marksman, Assassin",Mage,1,0,1
4606,"Marksman, Assassin",Marksman,"Marksman, Support","Mage, Support",1,0,1
4605,Mage,"Mage, Support",Marksman,"Mage, Support",1,0,1
4604,Mage,"Mage, Support",Marksman,Marksman,0,1,1
4065,Marksman,"Support, Mage","Tank, Fighter","Support, Tank",1,0,1
4602,"Marksman, Support",Mage,"Marksman, Assassin","Mage, Support",1,0,1
4066,"Tank, Fighter","Support, Fighter",Marksman,"Tank, Fighter",0,1,1
4067,"Tank, Mage","Support, Fighter",Marksman,Support,1,0,1
4599,"Marksman, Assassin",Mage,"Marksman, Support","Support, Mage",1,0,1
4598,Mage,"Mage, Fighter","Marksman, Assassin","Support, Mage",1,0,1
4058,"Fighter, Mage","Fighter, Tank",Fighter,"Tank, Fighter",0,1,1
4622,Marksman,"Support, Fighter","Marksman, Mage",Mage,1,0,1
4623,"Marksman, Mage","Support, Tank",Marksman,"Tank, Mage",0,1,1
4624,"Marksman, Mage","Tank, Mage",Marksman,"Mage, Support",1,0,1
4047,"Fighter, Mage","Support, Mage","Fighter, Assassin","Support, Fighter",0,1,1
4645,"Marksman, Assassin",Support,"Marksman, Assassin","Support, Fighter",0,1,1
4644,"Marksman, Mage","Support, Fighter","Marksman, Assassin",Support,1,0,1
4643,"Marksman, Support",Support,"Marksman, Assassin","Tank, Support",1,0,1
4049,Marksman,"Fighter, Tank","Assassin, Fighter","Mage, Support",0,1,1
4050,"Fighter, Tank","Support, Mage",Marksman,"Support, Tank",0,1,1
4051,Marksman,"Tank, Support","Fighter, Tank","Support, Tank",0,1,1
4639,Mage,"Mage, Support","Marksman, Mage","Mage, Assassin",1,0,1
4638,"Marksman, Support","Mage, Support",Marksman,Marksman,0,1,1
4637,"Marksman, Assassin",Marksman,"Marksman, Support","Mage, Assassin",0,1,1
4636,"Marksman, Support",Mage,"Marksman, Mage","Support, Tank",1,0,1
4053,"Tank, Mage","Support, Tank","Fighter, Mage","Support, Mage",0,1,1
4054,"Mage, Fighter","Tank, Support","Fighter, Mage","Mage, Support",0,1,1
4055,"Mage, Fighter","Tank, Support",Fighter,"Tank, Support",0,1,1
4056,"Tank, Mage","Mage, Support","Tank, Fighter","Support, Fighter",0,1,1
4057,"Fighter, Mage","Tank, Support",Fighter,"Tank, Support",0,1,1
4629,"Marksman, Support","Mage, Assassin","Marksman, Assassin","Mage, Support",0,1,1
4628,"Marksman, Support","Mage, Support","Marksman, Mage",Mage,0,1,1
4627,"Marksman, Mage",Mage,"Marksman, Support","Support, Mage",1,0,1
4626,"Marksman, Support",Mage,"Marksman, Mage","Tank, Fighter",1,0,1
4625,"Marksman, Mage",Support,"Marksman, Support",Mage,0,1,1
4597,Mage,"Mage, Support","Marksman, Assassin",Marksman,0,1,1
4595,"Marksman, Mage","Support, Tank","Marksman, Mage",Mage,0,1,1
4542,"Marksman, Assassin","Mage, Support","Marksman, Mage",Support,1,0,1
4556,Marksman,"Tank, Fighter",Marksman,"Tank, Fighter",1,0,1
4566,Marksman,"Mage, Marksman",Marksman,Support,1,0,1
4565,Marksman,Mage,"Marksman, Mage","Support, Tank",0,1,1
4084,"Assassin, Fighter","Support, Tank","Tank, Mage","Mage, Support",0,1,1
4563,"Marksman, Mage",Support,"Marksman, Support","Mage, Support",1,0,1
4562,"Marksman, Mage","Support, Fighter","Marksman, Support","Tank, Fighter",1,0,1
4561,Marksman,Support,Marksman,"Tank, Fighter",1,0,1
4560,"Marksman, Mage","Mage, Support",Mage,"Mage, Support",1,0,1
4559,Marksman,Support,"Marksman, Support",Mage,1,0,1
4558,Marksman,"Support, Mage",Marksman,"Tank, Mage",0,1,1
4557,"Marksman, Assassin","Tank, Mage","Marksman, Mage","Support, Mage",0,1,1
4554,"Marksman, Support","Mage, Marksman",Marksman,Support,1,0,1
4594,"Marksman, Support","Mage, Support",Mage,Marksman,1,0,1
4553,"Marksman, Mage","Support, Mage",Marksman,"Mage, Marksman",0,1,1
4552,"Marksman, Mage",Support,Marksman,"Support, Mage",0,1,1
4551,Marksman,Support,"Marksman, Assassin","Mage, Marksman",0,1,1
4550,"Marksman, Assassin",Support,Marksman,"Tank, Mage",0,1,1
4086,"Assassin, Fighter","Support, Tank",Marksman,"Mage, Assassin",1,0,1
4088,"Fighter, Assassin",Marksman,Marksman,"Mage, Assassin",0,1,1
4546,"Marksman, Assassin","Support, Tank","Marksman, Support",Support,0,1,1
4089,"Tank, Fighter","Support, Fighter",Marksman,"Support, Fighter",1,0,1
4544,"Marksman, Support","Support, Tank","Marksman, Assassin",Support,1,0,1
4543,Marksman,"Fighter, Mage","Marksman, Mage","Mage, Support",0,1,1
4567,"Marksman, Assassin",Mage,Marksman,"Tank, Fighter",0,1,1
4083,"Fighter, Mage","Support, Tank","Fighter, Tank","Support, Tank",1,0,1
4569,Marksman,"Mage, Marksman","Marksman, Mage","Mage, Support",1,0,1
4082,"Tank, Mage","Support, Mage",Fighter,"Mage, Support",0,1,1
4069,"Tank, Mage","Support, Fighter","Fighter, Assassin","Support, Fighter",1,0,1
4070,Marksman,"Mage, Support","Mage, Fighter","Tank, Fighter",1,0,1
4071,"Fighter, Tank",Support,Fighter,"Support, Fighter",0,1,1
4072,"Mage, Fighter","Tank, Fighter",Marksman,"Support, Fighter",1,0,1
4073,Marksman,Mage,"Assassin, Fighter","Support, Tank",1,0,1
4076,Marksman,"Fighter, Tank","Fighter, Mage","Support, Tank",0,1,1
4586,"Marksman, Support","Support, Mage","Marksman, Mage","Tank, Support",1,0,1
4585,"Marksman, Support","Support, Fighter","Marksman, Assassin","Fighter, Tank",0,1,1
4584,"Marksman, Support","Mage, Assassin","Marksman, Mage",Marksman,0,1,1
4583,Mage,"Mage, Support","Marksman, Assassin","Support, Tank",1,0,1
4582,"Marksman, Assassin","Tank, Fighter","Marksman, Support","Support, Fighter",1,0,1
4581,"Marksman, Mage","Fighter, Tank","Marksman, Support","Support, Fighter",1,0,1
4580,"Marksman, Assassin","Tank, Support","Marksman, Support","Fighter, Tank",0,1,1
4579,"Marksman, Assassin","Support, Fighter",Marksman,"Mage, Assassin",0,1,1
4578,Marksman,"Support, Mage","Fighter, Marksman","Tank, Support",1,0,1
4077,Fighter,"Mage, Support","Fighter, Mage","Fighter, Tank",0,1,1
4078,"Fighter, Mage","Support, Tank","Assassin, Fighter","Fighter, Tank",1,0,1
4575,Marksman,Support,"Marksman, Support","Tank, Support",1,0,1
4079,"Fighter, Mage","Support, Fighter",Fighter,"Support, Fighter",1,0,1
4081,"Tank, Fighter","Tank, Fighter","Tank, Mage","Support, Mage",0,1,1
4571,Marksman,"Mage, Marksman","Marksman, Mage","Tank, Fighter",1,0,1
4428,"Marksman, Support",Mage,Marksman,"Tank, Support",1,0,1
4153,"Fighter, Mage","Fighter, Tank","Tank, Fighter","Tank, Mage",1,0,1
4154,Fighter,"Mage, Assassin","Fighter, Assassin","Support, Mage",0,1,1
4283,Fighter,Tank,"Assassin, Fighter","Tank, Support",0,1,1
4293,"Mage, Fighter",Support,"Fighter, Tank","Support, Mage",0,1,1
4292,Fighter,Mage,"Mage, Fighter","Tank, Support",1,0,1
4202,"Fighter, Assassin","Support, Fighter","Fighter, Tank",Mage,1,0,1
4290,"Fighter, Assassin","Tank, Fighter","Fighter, Mage","Tank, Support",0,1,1
4289,"Fighter, Assassin",Tank,"Mage, Fighter","Tank, Support",1,0,1
4288,"Fighter, Assassin","Tank, Support","Fighter, Mage","Support, Tank",1,0,1
4287,"Mage, Fighter","Support, Tank","Tank, Mage","Mage, Support",0,1,1
4203,"Fighter, Mage",Tank,"Assassin, Fighter","Tank, Support",0,1,1
4285,"Tank, Fighter","Mage, Marksman","Tank, Mage","Tank, Fighter",1,0,1
4284,"Tank, Fighter","Support, Fighter","Tank, Mage","Support, Fighter",1,0,1
4282,"Fighter, Mage","Fighter, Tank","Assassin, Fighter","Tank, Support",1,0,1
4270,"Tank, Fighter",Support,"Fighter, Marksman","Mage, Support",1,0,1
4281,"Tank, Fighter","Tank, Fighter","Fighter, Assassin","Support, Fighter",1,0,1
4204,"Fighter, Mage",Support,"Mage, Fighter","Tank, Support",1,0,1
4279,"Tank, Fighter","Mage, Support","Tank, Mage","Support, Fighter",1,0,1
4278,"Assassin, Fighter","Mage, Marksman","Mage, Fighter","Tank, Support",0,1,1
4277,Assassin,"Support, Fighter","Assassin, Fighter","Tank, Fighter",1,0,1
4276,"Fighter, Tank","Support, Fighter","Fighter, Mage",Mage,0,1,1
4205,"Assassin, Fighter",Mage,"Assassin, Mage","Support, Fighter",0,1,1
4274,"Fighter, Assassin",Mage,"Fighter, Mage","Support, Fighter",1,0,1
4273,"Fighter, Assassin",Mage,"Fighter, Tank","Support, Fighter",1,0,1
4272,"Mage, Fighter",Tank,Fighter,"Tank, Support",1,0,1
4294,"Mage, Fighter","Support, Fighter","Assassin, Fighter",Support,1,0,1
4295,"Fighter, Mage","Tank, Fighter","Tank, Fighter","Support, Tank",1,0,1
4296,"Fighter, Mage",Support,"Mage, Fighter","Mage, Marksman",0,1,1
4297,"Tank, Fighter","Mage, Marksman","Fighter, Mage",Support,1,0,1
4318,"Tank, Fighter","Tank, Support","Assassin, Fighter",Mage,1,0,1
4198,Fighter,"Tank, Support","Tank, Fighter",Support,0,1,1
4316,"Fighter, Mage","Mage, Support","Assassin, Fighter","Support, Fighter",0,1,1
4315,Fighter,"Mage, Support","Assassin, Mage","Support, Tank",1,0,1
4314,"Assassin, Mage","Support, Tank","Assassin, Fighter","Mage, Support",0,1,1
4313,"Assassin, Fighter","Tank, Support","Assassin, Mage","Support, Tank",0,1,1
4312,"Mage, Fighter","Tank, Support","Assassin, Fighter",Mage,0,1,1
4311,"Fighter, Assassin","Tank, Fighter","Mage, Fighter","Tank, Support",1,0,1
4310,"Fighter, Mage","Tank, Fighter","Mage, Fighter","Support, Fighter",0,1,1
4199,"Mage, Fighter","Tank, Support","Assassin, Mage","Support, Fighter",1,0,1
4200,"Fighter, Mage",Support,"Fighter, Mage","Mage, Support",1,0,1
4307,Fighter,"Fighter, Tank",Marksman,"Support, Tank",1,0,1
4306,"Fighter, Tank","Mage, Support","Fighter, Mage","Support, Tank",0,1,1
4305,Fighter,"Support, Fighter","Assassin, Fighter","Fighter, Tank",0,1,1
4304,"Fighter, Tank",Mage,"Assassin, Fighter","Tank, Support",1,0,1
4303,"Mage, Fighter","Tank, Support","Fighter, Tank","Fighter, Tank",1,0,1
4302,"Tank, Fighter","Support, Fighter","Fighter, Tank","Tank, Fighter",0,1,1
4301,"Mage, Fighter","Tank, Support","Fighter, Assassin","Tank, Fighter",1,0,1
4201,"Tank, Fighter","Mage, Marksman",Fighter,"Mage, Support",1,0,1
4299,Marksman,"Support, Fighter","Fighter, Assassin","Fighter, Tank",1,0,1
4298,"Tank, Fighter","Tank, Fighter","Tank, Mage","Tank, Support",1,0,1
4271,"Fighter, Mage","Tank, Mage","Mage, Fighter","Tank, Support",0,1,1
4269,"Assassin, Mage",Tank,"Mage, Fighter","Support, Fighter",0,1,1
4425,Marksman,"Support, Mage","Marksman, Mage","Mage, Fighter",0,1,1
4232,"Fighter, Assassin","Tank, Support","Assassin, Mage","Mage, Support",0,1,1
4242,Fighter,"Support, Mage","Mage, Fighter",Support,0,1,1
4241,Marksman,"Fighter, Tank",Fighter,"Support, Tank",1,0,1
4240,Fighter,"Tank, Fighter","Mage, Fighter","Tank, Support",0,1,1
4239,"Mage, Fighter","Support, Fighter",Fighter,"Support, Fighter",0,1,1
4210,Fighter,"Support, Fighter","Tank, Mage",Support,0,1,1
4237,"Fighter, Mage","Tank, Support","Fighter, Mage","Support, Fighter",1,0,1
4236,"Mage, Fighter","Tank, Support",Fighter,Support,0,1,1
4235,"Assassin, Fighter","Tank, Support","Fighter, Assassin",Mage,0,1,1
4234,"Fighter, Mage","Support, Fighter","Assassin, Mage","Mage, Support",1,0,1
4233,"Tank, Fighter",Mage,"Fighter, Assassin","Tank, Fighter",0,1,1
4231,"Assassin, Fighter",Support,"Support, Mage","Support, Mage",1,0,1
4268,"Mage, Fighter","Support, Tank","Fighter, Assassin",Support,0,1,1
4230,"Tank, Fighter","Support, Mage","Fighter, Assassin",Support,0,1,1
4229,"Mage, Fighter","Support, Mage","Tank, Fighter","Tank, Fighter",1,0,1
4228,"Fighter, Mage","Support, Fighter","Support, Mage","Support, Mage",0,1,1
4227,"Fighter, Tank","Support, Mage","Tank, Fighter",Support,1,0,1
4212,"Assassin, Mage","Mage, Support","Tank, Fighter","Tank, Support",1,0,1
4213,"Fighter, Mage","Mage, Support","Assassin, Mage","Support, Mage",1,0,1
4214,"Assassin, Mage","Tank, Fighter","Tank, Fighter","Support, Fighter",0,1,1
4216,"Assassin, Mage","Tank, Fighter","Fighter, Mage","Mage, Support",1,0,1
4221,"Assassin, Fighter","Tank, Support","Fighter, Tank",Mage,0,1,1
4220,"Assassin, Mage","Mage, Support","Fighter, Assassin","Tank, Support",1,0,1
4243,"Mage, Fighter","Support, Tank","Fighter, Mage",Support,1,0,1
4244,Fighter,Support,"Mage, Fighter","Tank, Mage",0,1,1
4209,"Fighter, Assassin","Tank, Fighter","Assassin, Mage","Tank, Support",1,0,1
4246,"Fighter, Assassin","Support, Fighter","Mage, Fighter",Mage,0,1,1
4206,Fighter,Support,"Fighter, Assassin","Support, Fighter",0,1,1
4266,Fighter,"Tank, Fighter","Mage, Fighter","Mage, Support",1,0,1
4207,"Fighter, Assassin","Tank, Support","Fighter, Mage",Support,1,0,1
4264,"Fighter, Mage","Support, Tank","Fighter, Assassin","Mage, Support",0,1,1
4263,Marksman,"Mage, Support",Fighter,"Tank, Support",1,0,1
4262,"Fighter, Tank","Support, Tank",Marksman,"Tank, Support",0,1,1
4261,"Mage, Fighter","Mage, Support","Tank, Fighter","Tank, Fighter",1,0,1
4260,"Fighter, Assassin","Tank, Support",Marksman,"Mage, Support",0,1,1
4259,"Assassin, Fighter","Tank, Support","Fighter, Mage",Support,1,0,1
4258,"Fighter, Mage","Support, Tank",Marksman,"Support, Tank",1,0,1
4257,"Fighter, Mage","Support, Fighter","Fighter, Assassin","Mage, Support",0,1,1
4256,"Tank, Fighter",Support,"Assassin, Fighter","Tank, Support",1,0,1
4255,"Fighter, Mage",Support,"Assassin, Fighter","Tank, Support",1,0,1
4254,"Fighter, Mage","Tank, Support","Fighter, Assassin","Support, Fighter",1,0,1
4208,"Assassin, Fighter",Mage,"Fighter, Mage","Support, Fighter",0,1,1
4252,"Fighter, Mage","Support, Fighter","Assassin, Fighter",Tank,0,1,1
4251,Fighter,"Tank, Support","Fighter, Mage",Tank,0,1,1
4250,"Mage, Fighter","Tank, Support","Fighter, Mage",Mage,0,1,1
4249,"Fighter, Mage","Mage, Marksman","Fighter, Assassin",Support,1,0,1
4248,"Fighter, Mage",Support,"Mage, Fighter","Support, Tank",0,1,1
4247,"Mage, Fighter","Support, Tank","Fighter, Mage",Mage,1,0,1
4197,"Fighter, Assassin","Support, Fighter","Assassin, Fighter",Tank,0,1,1
4320,"Assassin, Mage","Mage, Support","Mage, Fighter","Tank, Support",0,1,1
4321,"Fighter, Tank","Support, Mage",Marksman,"Tank, Support",1,0,1
4386,"Mage, Fighter","Support, Tank","Tank, Fighter","Fighter, Tank",0,1,1
4396,Marksman,"Fighter, Tank","Marksman, Assassin",Tank,1,0,1
4175,"Mage, Fighter","Mage, Assassin","Assassin, Fighter","Support, Tank",1,0,1
4176,"Tank, Fighter","Support, Tank","Mage, Fighter","Mage, Support",1,0,1
4393,Marksman,Tank,Marksman,"Fighter, Tank",1,0,1
4392,Marksman,"Mage, Support","Marksman, Assassin",Tank,1,0,1
4177,"Assassin, Mage","Support, Mage","Fighter, Mage","Support, Fighter",0,1,1
4178,"Mage, Fighter","Support, Fighter","Tank, Fighter","Support, Fighter",1,0,1
4179,"Mage, Fighter","Tank, Support","Tank, Fighter","Support, Fighter",0,1,1
4388,"Marksman, Mage",Tank,Marksman,"Support, Mage",0,1,1
4387,"Assassin, Fighter","Tank, Mage","Fighter, Assassin","Tank, Support",0,1,1
4385,"Assassin, Fighter","Tank, Fighter","Fighter, Mage","Fighter, Tank",1,0,1
4322,Marksman,"Support, Tank",Fighter,"Tank, Fighter",1,0,1
4384,"Assassin, Fighter","Tank, Fighter","Fighter, Mage","Support, Mage",0,1,1
4383,Fighter,"Tank, Support","Assassin, Fighter",Mage,0,1,1
4382,"Fighter, Mage","Support, Mage","Assassin, Fighter","Tank, Fighter",1,0,1
4180,"Tank, Mage","Tank, Fighter","Mage, Fighter","Support, Fighter",1,0,1
4380,"Fighter, Mage","Tank, Fighter","Assassin, Fighter","Tank, Support",0,1,1
4379,Fighter,"Fighter, Tank","Fighter, Mage","Support, Fighter",1,0,1
4378,Fighter,"Fighter, Mage","Assassin, Fighter","Tank, Fighter",1,0,1
4377,"Assassin, Fighter",Mage,"Assassin, Fighter","Support, Mage",0,1,1
4376,"Tank, Fighter","Mage, Marksman",Fighter,"Support, Fighter",1,0,1
4375,"Assassin, Fighter","Tank, Support","Assassin, Fighter",Mage,1,0,1
4174,"Tank, Mage","Tank, Fighter",Marksman,"Support, Mage",1,0,1
4173,"Assassin, Fighter","Mage, Assassin","Mage, Fighter","Support, Fighter",1,0,1
4172,"Mage, Fighter","Support, Tank","Tank, Fighter","Support, Mage",1,0,1
4400,Marksman,"Support, Mage","Fighter, Marksman","Support, Fighter",0,1,1
4424,"Marksman, Mage","Tank, Fighter","Marksman, Mage","Support, Mage",0,1,1
4155,"Tank, Fighter","Support, Fighter","Mage, Fighter","Tank, Fighter",1,0,1
4422,Marksman,"Support, Tank","Marksman, Mage","Mage, Fighter",0,1,1
4421,"Marksman, Mage",Mage,Marksman,"Support, Tank",1,0,1
4156,"Mage, Fighter","Support, Mage","Tank, Mage","Support, Mage",0,1,1
4419,"Marksman, Assassin",Mage,"Fighter, Marksman",Mage,1,0,1
4418,"Marksman, Assassin",Mage,"Tank, Fighter",Mage,0,1,1
4158,Fighter,"Fighter, Tank","Tank, Fighter","Tank, Support",0,1,1
4159,"Tank, Mage","Support, Mage","Tank, Mage","Tank, Support",1,0,1
4161,"Tank, Fighter","Fighter, Tank",Marksman,"Support, Fighter",1,0,1
4162,"Mage, Fighter","Mage, Assassin","Fighter, Mage","Support, Mage",0,1,1
4163,"Fighter, Assassin","Support, Tank","Mage, Fighter","Mage, Support",1,0,1
4410,"Marksman, Assassin",Mage,Marksman,"Support, Tank",1,0,1
4164,"Tank, Mage","Tank, Fighter","Mage, Fighter","Support, Mage",1,0,1
4165,"Mage, Fighter","Support, Mage",Assassin,"Mage, Support",1,0,1
4407,"Marksman, Mage","Tank, Fighter","Fighter, Marksman","Support, Mage",1,0,1
4166,Fighter,"Fighter, Mage","Mage, Fighter","Tank, Support",1,0,1
4167,"Tank, Fighter","Tank, Support","Tank, Mage","Support, Mage",1,0,1
4403,"Marksman, Assassin","Tank, Support","Fighter, Marksman","Tank, Fighter",1,0,1
4171,"Fighter, Mage","Support, Tank","Mage, Fighter",Support,1,0,1
4401,"Fighter, Marksman","Tank, Support",Marksman,"Support, Mage",0,1,1
4374,Fighter,"Fighter, Tank","Assassin, Mage","Fighter, Mage",0,1,1
4373,"Assassin, Fighter","Tank, Support","Assassin, Fighter","Fighter, Mage",0,1,1
4372,"Assassin, Mage","Fighter, Tank","Fighter, Mage","Tank, Fighter",0,1,1
4188,"Fighter, Mage","Tank, Support","Assassin, Mage","Support, Fighter",1,0,1
4345,"Fighter, Mage","Tank, Support",Marksman,"Support, Fighter",0,1,1
4344,"Assassin, Fighter","Support, Tank","Tank, Fighter","Support, Fighter",1,0,1
4343,Marksman,"Support, Tank","Tank, Fighter","Tank, Support",1,0,1
4342,Marksman,"Support, Tank","Fighter, Mage","Tank, Fighter",0,1,1
4341,"Tank, Mage","Tank, Support",Fighter,"Support, Mage",0,1,1
4339,"Mage, Fighter","Tank, Support","Fighter, Mage","Tank, Support",0,1,1
4338,"Fighter, Mage","Support, Mage","Fighter, Mage","Support, Tank",1,0,1
4337,"Fighter, Mage","Tank, Support",Fighter,Support,0,1,1
4336,"Tank, Mage",Support,"Fighter, Mage","Tank, Support",0,1,1
4335,"Tank, Fighter","Support, Mage","Tank, Mage","Tank, Fighter",0,1,1
4334,"Tank, Mage","Support, Tank","Tank, Fighter","Support, Fighter",1,0,1
4192,"Fighter, Mage","Tank, Fighter","Assassin, Fighter","Mage, Support",1,0,1
4194,"Tank, Fighter","Support, Mage","Fighter, Mage","Tank, Fighter",1,0,1
4330,Marksman,"Fighter, Tank",Fighter,"Mage, Support",1,0,1
4329,"Assassin, Fighter","Support, Fighter","Mage, Fighter","Tank, Fighter",0,1,1
4328,"Fighter, Mage","Tank, Support","Assassin, Fighter","Tank, Support",1,0,1
4327,"Fighter, Mage","Tank, Support","Mage, Fighter","Tank, Support",0,1,1
4195,"Fighter, Mage","Support, Fighter",Fighter,Tank,0,1,1
4325,"Tank, Fighter","Support, Fighter","Fighter, Tank","Tank, Support",0,1,1
4196,"Tank, Fighter","Tank, Support",Fighter,"Fighter, Mage",1,0,1
4323,"Tank, Fighter","Support, Mage","Mage, Fighter",Mage,0,1,1
4346,"Fighter, Mage",Support,"Tank, Fighter","Mage, Support",1,0,1
4348,"Mage, Fighter","Support, Fighter","Tank, Fighter","Support, Tank",1,0,1
4371,"Fighter, Mage","Fighter, Tank","Assassin, Fighter","Support, Mage",0,1,1
4349,"Fighter, Assassin","Tank, Support","Tank, Fighter","Support, Tank",0,1,1
4370,"Assassin, Fighter","Mage, Support","Tank, Fighter","Tank, Fighter",1,0,1
4369,"Assassin, Fighter","Support, Tank","Assassin, Mage","Mage, Support",0,1,1
4181,"Tank, Fighter","Support, Fighter",Fighter,"Support, Fighter",1,0,1
4367,"Tank, Fighter",Mage,"Assassin, Mage","Tank, Support",0,1,1
4182,Fighter,"Support, Tank","Tank, Fighter","Mage, Support",0,1,1
4365,"Fighter, Assassin","Tank, Support","Fighter, Assassin","Support, Fighter",0,1,1
4183,"Fighter, Mage","Support, Fighter","Tank, Mage",Support,1,0,1
4363,Fighter,"Support, Fighter","Fighter, Tank",Mage,1,0,1
4362,"Tank, Fighter",Mage,"Tank, Fighter","Tank, Fighter",1,0,1
4361,"Assassin, Fighter","Support, Mage","Assassin, Fighter","Tank, Support",1,0,1
4360,"Assassin, Fighter","Tank, Fighter","Tank, Fighter","Tank, Support",1,0,1
4359,"Fighter, Mage","Tank, Support","Tank, Fighter","Tank, Support",1,0,1
4358,"Tank, Fighter","Tank, Support",Fighter,"Mage, Support",0,1,1
4184,"Tank, Fighter","Mage, Support","Assassin, Fighter",Support,0,1,1
4185,"Fighter, Tank","Support, Mage",Fighter,"Tank, Support",1,0,1
4187,"Assassin, Fighter","Mage, Support","Fighter, Tank","Tank, Support",0,1,1
4354,Fighter,"Tank, Support","Tank, Fighter","Mage, Support",1,0,1
4353,"Fighter, Mage","Support, Fighter","Tank, Fighter","Mage, Marksman",1,0,1
4352,"Assassin, Mage",Mage,"Fighter, Mage","Support, Fighter",0,1,1
4351,"Tank, Fighter","Mage, Support","Assassin, Mage","Support, Fighter",1,0,1
4350,"Tank, Fighter","Tank, Support",Fighter,"Tank, Support",0,1,1
4045,"Mage, Fighter","Tank, Fighter",Fighter,"Support, Fighter",0,1,1
4651,Marksman,"Support, Fighter",Marksman,"Tank, Mage",1,0,1
5077,"Tank, Fighter","Fighter, Tank",Fighter,"Tank, Support",1,0,1
4934,"Mage, Fighter","Support, Tank","Fighter, Mage","Fighter, Tank",0,1,1
4945,Fighter,"Fighter, Tank","Assassin, Fighter","Mage, Support",1,0,1
4944,"Assassin, Mage","Tank, Fighter","Mage, Fighter","Tank, Support",0,1,1
4942,"Tank, Fighter",Mage,Fighter,"Support, Fighter",1,0,1
4941,Fighter,"Mage, Marksman","Mage, Fighter","Support, Fighter",0,1,1
4940,Fighter,"Support, Fighter","Fighter, Assassin","Mage, Marksman",1,0,1
3939,"Fighter, Mage","Tank, Support",Fighter,Mage,0,1,1
4938,"Assassin, Mage","Support, Fighter","Mage, Fighter","Tank, Support",0,1,1
4937,Marksman,"Support, Mage","Fighter, Mage","Fighter, Tank",1,0,1
4936,"Fighter, Mage","Fighter, Tank","Fighter, Tank","Tank, Support",0,1,1
4935,"Fighter, Tank","Support, Tank","Fighter, Tank","Mage, Support",0,1,1
4933,"Fighter, Assassin","Fighter, Tank","Fighter, Mage","Support, Tank",1,0,1
4921,Mage,"Support, Fighter","Tank, Fighter","Mage, Support",1,0,1
4932,"Fighter, Assassin","Fighter, Tank","Fighter, Tank","Support, Mage",0,1,1
4931,Fighter,"Mage, Support",Marksman,"Tank, Fighter",0,1,1
3940,"Fighter, Assassin",Support,"Fighter, Mage","Support, Fighter",0,1,1
4929,"Tank, Fighter","Support, Tank","Mage, Fighter","Support, Mage",0,1,1
4928,"Tank, Fighter","Support, Tank",Fighter,"Support, Mage",0,1,1
4927,"Tank, Fighter","Support, Mage",Fighter,"Support, Tank",1,0,1
4926,"Mage, Fighter","Tank, Fighter","Fighter, Mage","Mage, Support",1,0,1
4925,"Assassin, Mage","Tank, Support","Tank, Fighter","Support, Tank",1,0,1
4924,"Fighter, Assassin","Support, Fighter","Support, Mage","Tank, Support",1,0,1
3941,"Mage, Fighter",Support,"Fighter, Assassin","Support, Mage",1,0,1
4946,"Assassin, Fighter","Support, Tank","Fighter, Tank","Support, Mage",0,1,1
4947,Marksman,"Support, Mage","Tank, Fighter","Tank, Support",1,0,1
4948,"Fighter, Assassin","Support, Mage","Mage, Fighter","Tank, Fighter",0,1,1
4949,Fighter,"Tank, Fighter","Fighter, Tank","Support, Fighter",0,1,1
4970,"Fighter, Assassin","Support, Tank","Fighter, Tank","Mage, Support",1,0,1
4969,"Fighter, Tank","Support, Fighter",Fighter,"Support, Mage",0,1,1
3937,"Mage, Fighter","Mage, Marksman","Fighter, Assassin","Support, Fighter",1,0,1
4967,Marksman,"Mage, Assassin","Support, Mage","Mage, Support",1,0,1
4966,Fighter,"Support, Tank","Fighter, Tank",Support,1,0,1
4965,"Fighter, Tank","Support, Fighter",Fighter,"Tank, Fighter",1,0,1
4964,"Tank, Fighter","Tank, Fighter","Fighter, Mage","Mage, Support",1,0,1
4963,"Fighter, Assassin","Support, Fighter",Fighter,"Tank, Fighter",1,0,1
4962,"Fighter, Assassin","Support, Fighter","Fighter, Mage","Tank, Fighter",0,1,1
4961,"Fighter, Mage","Support, Tank","Fighter, Tank",Support,1,0,1
4960,Fighter,"Fighter, Tank","Assassin, Fighter","Support, Mage",0,1,1
4959,"Assassin, Fighter","Support, Fighter","Fighter, Mage","Tank, Fighter",1,0,1
4958,"Support, Mage",Support,"Assassin, Fighter","Support, Tank",0,1,1
4957,Fighter,Support,"Tank, Fighter","Support, Fighter",0,1,1
4956,"Fighter, Assassin","Tank, Fighter","Assassin, Fighter","Tank, Support",1,0,1
4955,Fighter,Support,"Fighter, Tank","Support, Fighter",1,0,1
4954,"Mage, Fighter",Support,Fighter,"Mage, Support",1,0,1
4953,"Fighter, Mage","Support, Tank","Assassin, Mage","Support, Tank",1,0,1
4952,"Support, Mage","Mage, Support",Fighter,Support,0,1,1
4951,"Tank, Fighter","Mage, Support",Fighter,Support,1,0,1
4950,"Fighter, Mage","Mage, Support","Mage, Fighter",Support,1,0,1
4922,"Tank, Fighter","Support, Mage","Fighter, Assassin","Support, Tank",0,1,1
4920,Mage,"Support, Mage","Tank, Fighter","Support, Mage",0,1,1
4972,"Fighter, Assassin","Support, Tank","Fighter, Tank","Support, Tank",1,0,1
3950,"Fighter, Tank","Support, Tank","Fighter, Assassin","Support, Fighter",1,0,1
4891,"Marksman, Assassin","Support, Fighter",Marksman,"Tank, Mage",1,0,1
4890,"Marksman, Support",Support,"Marksman, Mage","Tank, Support",1,0,1
4889,"Marksman, Mage","Fighter, Support","Marksman, Assassin","Support, Mage",0,1,1
4888,"Mage, Marksman",Tank,Marksman,"Mage, Support",1,0,1
4887,Marksman,Mage,"Mage, Marksman","Support, Tank",0,1,1
3946,Marksman,"Tank, Support","Mage, Fighter",Tank,0,1,1
3947,Fighter,Tank,"Mage, Fighter","Tank, Support",0,1,1
4884,Fighter,"Tank, Support","Marksman, Assassin","Support, Fighter",1,0,1
3949,"Fighter, Assassin","Support, Mage","Assassin, Fighter",Support,0,1,1
4882,Marksman,"Mage, Marksman","Marksman, Assassin","Support, Fighter",1,0,1
4880,Marksman,Tank,"Marksman, Support","Support, Fighter",1,0,1
4919,"Fighter, Tank","Support, Tank","Tank, Fighter","Support, Fighter",0,1,1
4879,Marksman,Mage,"Marksman, Assassin","Support, Tank",1,0,1
4878,"Marksman, Mage",Mage,"Marksman, Support","Tank, Fighter",0,1,1
4877,Marksman,"Tank, Fighter","Marksman, Support","Mage, Assassin",0,1,1
4876,Marksman,"Support, Tank","Marksman, Mage","Mage, Assassin",1,0,1
4875,Marksman,"Tank, Mage","Marksman, Support","Mage, Support",0,1,1
4874,Marksman,"Tank, Fighter","Marksman, Support","Support, Tank",1,0,1
4873,"Marksman, Support","Support, Fighter","Marksman, Mage","Tank, Support",0,1,1
4872,"Marksman, Mage","Mage, Support","Marksman, Assassin","Tank, Fighter",0,1,1
3951,"Mage, Fighter","Support, Fighter","Support, Mage","Tank, Fighter",0,1,1
4870,"Marksman, Mage","Support, Tank",Marksman,"Mage, Assassin",1,0,1
4892,"Marksman, Mage",Marksman,"Marksman, Assassin","Mage, Support",0,1,1
4893,"Marksman, Assassin","Support, Tank","Marksman, Support",Marksman,1,0,1
4894,"Marksman, Mage","Mage, Assassin","Marksman, Assassin","Support, Tank",1,0,1
4895,"Marksman, Mage","Fighter, Tank",Marksman,Mage,0,1,1
4918,"Fighter, Tank","Mage, Support","Tank, Fighter",Tank,0,1,1
4916,"Tank, Fighter","Support, Fighter","Tank, Fighter","Support, Fighter",0,1,1
4915,"Tank, Fighter","Support, Fighter","Assassin, Mage","Support, Tank",0,1,1
4914,"Tank, Fighter",Tank,"Assassin, Fighter","Support, Fighter",1,0,1
4913,"Tank, Fighter","Support, Tank","Tank, Fighter",Tank,1,0,1
4912,"Mage, Support","Fighter, Tank","Assassin, Fighter","Support, Mage",0,1,1
4911,"Fighter, Assassin","Tank, Fighter","Tank, Fighter","Support, Fighter",0,1,1
4910,"Support, Mage","Support, Mage","Fighter, Assassin","Support, Fighter",0,1,1
4908,"Fighter, Mage","Mage, Marksman","Assassin, Fighter","Mage, Support",1,0,1
4907,"Tank, Fighter","Support, Mage","Tank, Fighter","Tank, Support",1,0,1
4906,"Fighter, Mage","Mage, Support",Fighter,"Tank, Fighter",1,0,1
4905,Marksman,Mage,Marksman,"Fighter, Tank",1,0,1
4904,"Marksman, Mage",Mage,Marksman,"Support, Mage",0,1,1
4903,Marksman,"Assassin, Mage","Marksman, Assassin","Tank, Fighter",0,1,1
4902,Marksman,"Support, Mage","Marksman, Support",Mage,1,0,1
4901,"Marksman, Assassin",Mage,"Marksman, Support","Support, Fighter",1,0,1
4900,"Marksman, Mage","Support, Mage",Marksman,Tank,1,0,1
4899,"Marksman, Assassin","Support, Mage",Mage,"Mage, Support",1,0,1
4898,"Marksman, Support","Support, Mage","Marksman, Assassin","Assassin, Fighter",0,1,1
4897,"Marksman, Assassin","Support, Mage","Marksman, Support","Tank, Fighter",1,0,1
3945,Marksman,"Mage, Support","Assassin, Fighter","Tank, Support",0,1,1
4971,"Fighter, Tank","Mage, Support","Fighter, Assassin","Support, Tank",0,1,1
3935,"Fighter, Mage","Support, Fighter",Marksman,Support,1,0,1
4044,"Fighter, Tank","Tank, Fighter",Fighter,"Tank, Support",0,1,1
5038,"Tank, Fighter","Support, Mage","Mage, Fighter","Tank, Support",1,0,1
5049,"Tank, Fighter","Support, Mage","Assassin, Mage","Support, Fighter",0,1,1
5048,"Tank, Fighter","Support, Fighter","Tank, Fighter",Tank,1,0,1
5047,"Tank, Fighter","Support, Tank","Tank, Fighter",Mage,1,0,1
5046,"Fighter, Mage","Support, Tank","Tank, Fighter",Tank,1,0,1
5045,"Assassin, Fighter","Support, Fighter","Tank, Fighter","Tank, Support",1,0,1
3916,"Mage, Fighter","Fighter, Tank",Fighter,Support,1,0,1
5043,Fighter,"Fighter, Tank","Fighter, Mage","Tank, Support",0,1,1
3917,Fighter,"Mage, Marksman","Assassin, Mage","Tank, Support",1,0,1
5040,"Tank, Fighter","Support, Mage","Fighter, Mage","Support, Fighter",0,1,1
5039,"Tank, Mage","Mage, Support","Fighter, Mage",Support,1,0,1
3919,"Fighter, Mage","Mage, Marksman",Fighter,"Support, Tank",1,0,1
5024,Marksman,"Tank, Fighter",Marksman,"Mage, Marksman",0,1,1
5036,"Tank, Fighter","Support, Tank","Tank, Fighter","Tank, Fighter",0,1,1
3920,"Fighter, Assassin","Support, Fighter",Fighter,Support,0,1,1
5034,"Tank, Fighter","Fighter, Mage","Tank, Fighter","Tank, Support",1,0,1
5033,Fighter,"Support, Tank","Fighter, Tank","Fighter, Tank",0,1,1
5032,"Tank, Mage","Support, Tank","Fighter, Mage",Support,0,1,1
5031,"Fighter, Assassin","Mage, Support","Mage, Fighter","Tank, Fighter",1,0,1
5030,"Marksman, Assassin",Mage,Marksman,"Mage, Support",0,1,1
3922,Fighter,"Support, Fighter","Mage, Fighter","Mage, Marksman",0,1,1
5028,Marksman,Mage,Marksman,Tank,0,1,1
3923,"Fighter, Assassin","Mage, Support","Fighter, Tank",Support,0,1,1
5050,"Fighter, Tank","Support, Tank","Tank, Fighter","Support, Mage",0,1,1
5051,"Tank, Fighter","Tank, Fighter","Tank, Fighter","Support, Tank",0,1,1
5052,"Fighter, Tank",Tank,"Tank, Fighter","Support, Tank",1,0,1
5053,"Tank, Fighter","Tank, Fighter","Assassin, Fighter",Tank,1,0,1
5076,"Tank, Fighter","Support, Tank","Fighter, Mage","Fighter, Tank",0,1,1
5075,"Fighter, Mage","Support, Mage",Fighter,Tank,1,0,1
5074,Marksman,"Support, Mage",Fighter,"Support, Fighter",1,0,1
3909,"Mage, Fighter",Support,"Fighter, Mage","Support, Tank",0,1,1
3910,"Fighter, Assassin",Mage,"Assassin, Mage","Support, Mage",1,0,1
5071,"Mage, Fighter","Mage, Support","Fighter, Tank","Support, Tank",0,1,1
5070,"Support, Mage","Mage, Support","Fighter, Mage","Support, Mage",1,0,1
5067,"Assassin, Mage","Assassin, Mage","Assassin, Fighter","Tank, Fighter",0,1,1
5066,"Fighter, Mage","Tank, Support",Tank,"Support, Tank",0,1,1
3913,Fighter,"Mage, Marksman","Fighter, Mage","Tank, Support",1,0,1
5064,"Assassin, Fighter","Support, Mage","Fighter, Mage","Tank, Fighter",1,0,1
5063,"Mage, Fighter",Mage,Fighter,"Fighter, Tank",1,0,1
5062,Marksman,"Support, Tank","Mage, Assassin","Mage, Support",0,1,1
5061,"Fighter, Tank","Tank, Support",Fighter,"Fighter, Tank",1,0,1
3914,"Fighter, Mage",Mage,"Mage, Fighter","Tank, Support",0,1,1
5059,"Fighter, Mage","Tank, Support","Tank, Fighter","Tank, Fighter",0,1,1
5058,"Tank, Fighter","Support, Tank","Assassin, Mage","Support, Tank",1,0,1
5057,"Assassin, Mage","Tank, Fighter","Tank, Fighter","Support, Tank",1,0,1
3915,"Assassin, Mage","Tank, Support","Mage, Fighter","Support, Mage",0,1,1
5055,"Fighter, Assassin","Support, Mage","Assassin, Fighter","Support, Tank",0,1,1
5054,"Assassin, Fighter","Mage, Marksman","Tank, Fighter","Support, Tank",1,0,1
5026,Marksman,Tank,Marksman,Mage,0,1,1
5023,"Marksman, Mage",Mage,Marksman,"Tank, Fighter",1,0,1
4974,"Support, Mage","Support, Tank",Fighter,"Support, Fighter",0,1,1
3931,"Assassin, Fighter",Mage,"Mage, Fighter","Support, Fighter",0,1,1
4996,"Assassin, Fighter",Support,Fighter,"Support, Fighter",0,1,1
4995,"Fighter, Tank","Tank, Fighter","Tank, Fighter","Mage, Support",1,0,1
4994,"Mage, Fighter","Tank, Fighter",Fighter,"Mage, Support",0,1,1
4993,"Fighter, Tank","Support, Fighter","Mage, Fighter","Tank, Support",0,1,1
4992,"Tank, Fighter","Support, Mage","Support, Mage","Tank, Fighter",0,1,1
4991,"Assassin, Fighter","Support, Tank","Fighter, Tank","Support, Tank",0,1,1
4990,"Fighter, Tank","Support, Tank","Tank, Fighter",Tank,1,0,1
4989,"Fighter, Assassin","Support, Tank","Tank, Fighter","Tank, Support",1,0,1
3929,"Assassin, Fighter","Support, Fighter","Tank, Mage",Support,1,0,1
3930,"Assassin, Mage","Tank, Support","Fighter, Mage",Mage,0,1,1
4985,"Assassin, Fighter","Support, Fighter","Tank, Fighter",Tank,0,1,1
5022,"Marksman, Assassin","Support, Mage","Marksman, Support","Tank, Support",1,0,1
4984,"Assassin, Fighter",Tank,"Tank, Fighter","Support, Fighter",1,0,1
4983,"Support, Mage","Support, Tank","Tank, Fighter","Support, Tank",1,0,1
4982,"Assassin, Fighter","Support, Tank","Tank, Fighter",Support,1,0,1
4981,"Fighter, Tank","Support, Tank","Tank, Fighter","Support, Tank",0,1,1
4980,"Tank, Fighter","Tank, Support","Tank, Fighter",Tank,1,0,1
4979,"Fighter, Tank","Fighter, Tank","Tank, Fighter","Tank, Support",0,1,1
4978,"Fighter, Assassin","Support, Fighter","Fighter, Mage","Support, Fighter",1,0,1
3933,"Mage, Fighter","Support, Tank","Fighter, Mage","Tank, Fighter",1,0,1
4976,"Support, Mage","Support, Tank","Mage, Fighter","Mage, Assassin",0,1,1
3934,Marksman,"Support, Fighter","Fighter, Mage",Support,0,1,1
4997,"Fighter, Assassin","Fighter, Tank",Fighter,"Fighter, Tank",1,0,1
4998,"Fighter, Assassin","Fighter, Tank","Assassin, Fighter","Tank, Support",1,0,1
4999,"Mage, Fighter","Support, Fighter",Fighter,"Tank, Fighter",1,0,1
5000,"Fighter, Assassin",Support,"Fighter, Mage","Support, Mage",0,1,1
5021,Marksman,"Mage, Support","Marksman, Mage",Mage,1,0,1
5020,"Marksman, Assassin","Tank, Fighter","Marksman, Mage","Support, Mage",0,1,1
5019,"Marksman, Support","Tank, Support",Marksman,"Tank, Fighter",1,0,1
5018,Marksman,Mage,"Marksman, Support","Support, Mage",1,0,1
5017,"Marksman, Support",Mage,Marksman,"Support, Fighter",1,0,1
5016,"Marksman, Support","Tank, Support",Marksman,Mage,1,0,1
5015,"Fighter, Marksman","Support, Fighter",Marksman,"Tank, Support",0,1,1
5014,Marksman,"Tank, Fighter","Marksman, Support","Support, Fighter",1,0,1
5013,"Fighter, Tank","Mage, Support","Fighter, Assassin","Mage, Assassin",1,0,1
3925,"Fighter, Mage","Tank, Support","Assassin, Fighter",Mage,1,0,1
5011,"Assassin, Fighter",Marksman,"Assassin, Fighter","Support, Fighter",1,0,1
5010,"Fighter, Tank","Support, Fighter",Marksman,"Tank, Fighter",1,0,1
5009,"Support, Mage","Support, Mage","Mage, Fighter","Support, Mage",1,0,1
5008,"Mage, Support","Support, Mage","Assassin, Fighter","Support, Fighter",1,0,1
5007,"Fighter, Mage","Support, Fighter","Fighter, Tank","Tank, Support",1,0,1
5006,"Assassin, Mage","Tank, Fighter","Assassin, Fighter","Support, Fighter",1,0,1
3926,"Tank, Mage",Support,"Fighter, Mage","Support, Tank",1,0,1
3927,"Assassin, Mage","Support, Tank","Assassin, Fighter","Support, Mage",0,1,1
5003,"Assassin, Mage","Support, Mage","Tank, Fighter","Support, Tank",0,1,1
5002,"Assassin, Mage","Support, Tank","Assassin, Fighter","Support, Tank",0,1,1
3928,"Fighter, Tank",Support,"Tank, Fighter","Support, Tank",1,0,1
4869,Marksman,"Support, Mage","Marksman, Assassin",Marksman,0,1,1
3953,Marksman,"Support, Fighter","Fighter, Assassin","Tank, Mage",0,1,1
4867,Marksman,"Support, Fighter","Marksman, Assassin","Tank, Mage",0,1,1
4720,"Marksman, Assassin","Tank, Fighter","Marksman, Assassin","Support, Tank",0,1,1
4004,"Support, Mage","Mage, Support","Fighter, Assassin","Tank, Fighter",0,1,1
4729,"Mage, Marksman","Tank, Fighter",Marksman,"Mage, Support",1,0,1
4728,"Marksman, Assassin","Support, Fighter","Mage, Marksman","Support, Tank",1,0,1
4727,"Marksman, Support","Support, Tank","Mage, Marksman","Support, Fighter",1,0,1
4726,Marksman,"Mage, Support","Marksman, Support",Support,1,0,1
4725,Mage,"Support, Mage","Marksman, Assassin","Mage, Support",0,1,1
4006,"Assassin, Fighter",Mage,"Fighter, Assassin","Tank, Fighter",1,0,1
4007,"Mage, Fighter","Mage, Support","Fighter, Mage",Support,1,0,1
4722,"Marksman, Support","Mage, Support",Marksman,Support,1,0,1
4721,"Marksman, Assassin","Support, Fighter","Marksman, Support","Tank, Fighter",0,1,1
4008,"Fighter, Tank",Support,"Assassin, Fighter","Mage, Support",1,0,1
4010,"Mage, Fighter","Mage, Support","Support, Mage",Support,1,0,1
4718,"Mage, Marksman","Support, Mage",Marksman,"Tank, Fighter",0,1,1
4717,"Marksman, Mage",Support,"Marksman, Assassin","Support, Mage",0,1,1
4716,"Marksman, Mage",Marksman,Marksman,"Support, Fighter",1,0,1
4715,"Marksman, Mage","Fighter, Tank",Marksman,"Fighter, Tank",1,0,1
4714,"Marksman, Mage","Fighter, Tank","Marksman, Support","Tank, Support",1,0,1
4713,"Marksman, Assassin","Mage, Support","Marksman, Assassin","Tank, Fighter",0,1,1
4712,"Marksman, Support",Support,Marksman,"Support, Fighter",0,1,1
4009,"Mage, Support","Support, Tank","Fighter, Mage","Support, Fighter",0,1,1
4710,Marksman,"Support, Fighter","Mage, Marksman","Tank, Fighter",1,0,1
4709,Mage,"Support, Mage","Marksman, Assassin","Support, Tank",0,1,1
4003,"Assassin, Fighter","Mage, Support","Fighter, Assassin",Support,0,1,1
4002,"Mage, Fighter",Support,"Fighter, Assassin","Support, Tank",0,1,1
4001,"Fighter, Assassin","Mage, Support","Mage, Fighter","Support, Tank",0,1,1
4734,Marksman,Tank,"Marksman, Assassin","Tank, Support",1,0,1
4759,Marksman,"Mage, Marksman","Marksman, Assassin","Support, Tank",1,0,1
4758,Marksman,"Mage, Marksman","Marksman, Support","Support, Tank",0,1,1
4757,"Marksman, Mage",Mage,"Marksman, Mage","Support, Mage",0,1,1
4756,"Marksman, Support","Fighter, Tank","Marksman, Assassin","Support, Mage",0,1,1
3988,"Fighter, Assassin",Support,"Mage, Fighter","Support, Fighter",1,0,1
4754,"Marksman, Assassin","Support, Mage","Marksman, Assassin","Tank, Fighter",1,0,1
4751,"Marksman, Mage",Support,"Marksman, Mage","Support, Fighter",1,0,1
4750,"Marksman, Assassin","Support, Fighter","Marksman, Mage",Support,1,0,1
3991,"Fighter, Mage",Support,"Tank, Mage","Support, Fighter",1,0,1
3994,"Tank, Mage","Support, Fighter","Fighter, Mage","Mage, Support",0,1,1
4746,"Fighter, Marksman","Support, Fighter",Marksman,Mage,1,0,1
4745,Marksman,Mage,"Fighter, Marksman","Support, Fighter",1,0,1
4744,"Mage, Marksman",Tank,"Marksman, Assassin","Tank, Support",0,1,1
3996,Fighter,"Tank, Support","Fighter, Assassin",Support,1,0,1
4742,Marksman,"Fighter, Assassin","Marksman, Assassin","Support, Tank",1,0,1
4741,"Mage, Marksman","Tank, Fighter",Marksman,"Tank, Support",0,1,1
4740,Fighter,"Support, Fighter","Marksman, Assassin","Tank, Support",1,0,1
4739,"Marksman, Mage","Support, Fighter",Marksman,Tank,0,1,1
4738,"Mage, Marksman","Tank, Support","Fighter, Marksman","Support, Fighter",1,0,1
3997,Marksman,"Support, Fighter","Fighter, Assassin",Support,1,0,1
4735,Marksman,"Tank, Support","Marksman, Support",Tank,0,1,1
4708,Marksman,"Support, Tank","Marksman, Assassin",Tank,0,1,1
4706,"Marksman, Support","Mage, Support",Mage,"Mage, Assassin",0,1,1
4866,Marksman,"Tank, Fighter","Marksman, Support",Support,1,0,1
4041,"Fighter, Tank","Tank, Support",Fighter,"Support, Mage",1,0,1
4038,"Fighter, Mage","Support, Mage","Fighter, Tank","Support, Fighter",1,0,1
4673,"Marksman, Mage","Support, Fighter","Fighter, Marksman","Tank, Support",0,1,1
4672,"Fighter, Marksman","Tank, Support","Marksman, Mage","Support, Fighter",0,1,1
4671,"Fighter, Marksman","Tank, Fighter","Marksman, Assassin","Support, Fighter",1,0,1
4670,"Marksman, Assassin","Tank, Support",Marksman,"Tank, Support",1,0,1
4669,"Marksman, Mage","Support, Mage","Fighter, Marksman","Tank, Support",1,0,1
4039,"Fighter, Tank","Support, Fighter","Fighter, Mage","Support, Mage",0,1,1
4040,"Tank, Mage","Support, Tank","Fighter, Assassin","Support, Mage",1,0,1
4666,Marksman,"Fighter, Mage",Marksman,"Tank, Fighter",1,0,1
4665,"Fighter, Marksman","Fighter, Tank",Marksman,"Support, Mage",0,1,1
4663,"Marksman, Mage","Fighter, Tank",Marksman,"Fighter, Mage",0,1,1
4011,"Tank, Fighter","Support, Mage",Marksman,"Mage, Support",1,0,1
4662,"Fighter, Marksman","Mage, Marksman",Marksman,"Support, Fighter",1,0,1
4661,Marksman,"Tank, Support","Marksman, Mage","Fighter, Mage",0,1,1
4660,"Fighter, Marksman","Tank, Support",Marksman,"Mage, Support",1,0,1
4042,Fighter,"Support, Mage","Tank, Mage","Support, Mage",1,0,1
4043,"Fighter, Tank","Tank, Support","Assassin, Fighter","Support, Tank",0,1,1
4657,Marksman,"Mage, Marksman","Marksman, Mage","Support, Mage",1,0,1
4656,Marksman,"Fighter, Mage","Marksman, Mage","Tank, Support",1,0,1
4655,"Marksman, Assassin","Fighter, Tank","Marksman, Support","Tank, Mage",1,0,1
4654,"Marksman, Mage","Support, Fighter","Marksman, Support",Support,0,1,1
4653,Marksman,"Tank, Mage","Marksman, Assassin","Support, Mage",1,0,1
4036,"Fighter, Mage","Support, Mage",Fighter,Support,1,0,1
4035,"Tank, Mage","Support, Fighter","Fighter, Mage","Support, Mage",0,1,1
4677,Marksman,"Tank, Support","Fighter, Marksman","Tank, Support",0,1,1
4034,Fighter,"Tank, Support","Fighter, Tank","Support, Tank",0,1,1
4704,"Marksman, Assassin","Support, Mage","Mage, Marksman","Mage, Support",1,0,1
4703,Marksman,"Mage, Assassin","Marksman, Support","Support, Fighter",0,1,1
4012,"Mage, Fighter",Support,"Assassin, Fighter",Mage,0,1,1
4014,"Fighter, Assassin","Tank, Fighter",Marksman,"Tank, Fighter",0,1,1
4700,Marksman,"Tank, Support","Marksman, Assassin",Tank,0,1,1
4699,"Marksman, Assassin","Tank, Support",Marksman,Tank,1,0,1
4697,"Marksman, Mage","Support, Mage","Marksman, Support","Fighter, Tank",1,0,1
4018,"Tank, Fighter","Support, Tank","Mage, Fighter","Tank, Mage",0,1,1
4021,"Fighter, Assassin","Support, Tank","Fighter, Mage","Mage, Support",0,1,1
4023,"Fighter, Mage","Support, Fighter","Mage, Fighter","Tank, Fighter",0,1,1
4025,"Mage, Fighter",Support,"Assassin, Fighter","Support, Mage",1,0,1
4026,"Fighter, Tank","Support, Fighter","Fighter, Mage",Support,0,1,1
4027,"Assassin, Fighter","Support, Fighter","Fighter, Mage","Mage, Support",1,0,1
4028,"Assassin, Fighter","Mage, Assassin","Fighter, Assassin","Support, Fighter",1,0,1
4030,Marksman,Support,"Fighter, Assassin","Support, Fighter",0,1,1
4684,Marksman,"Fighter, Tank","Marksman, Mage","Mage, Support",0,1,1
4031,"Tank, Fighter","Support, Mage","Support, Mage","Support, Tank",0,1,1
4682,"Marksman, Mage",Mage,Marksman,"Tank, Support",0,1,1
4032,"Support, Mage","Support, Fighter","Fighter, Assassin","Support, Tank",1,0,1
4033,"Fighter, Mage","Tank, Mage","Tank, Fighter","Support, Tank",0,1,1
4679,"Marksman, Mage","Mage, Support","Marksman, Mage","Tank, Fighter",1,0,1
4760,Mage,"Support, Fighter","Marksman, Assassin","Support, Mage",1,0,1
4761,"Marksman, Mage","Fighter, Tank","Marksman, Support","Support, Tank",0,1,1
4762,"Marksman, Assassin",Support,"Marksman, Mage","Support, Fighter",0,1,1
3962,Fighter,"Support, Mage","Mage, Fighter",Tank,0,1,1
4840,"Marksman, Support","Support, Mage","Marksman, Assassin","Support, Fighter",0,1,1
3960,"Assassin, Fighter","Tank, Fighter","Support, Mage","Support, Fighter",1,0,1
4837,Marksman,"Mage, Marksman","Marksman, Support","Support, Fighter",0,1,1
4836,Marksman,"Support, Mage",Marksman,"Mage, Marksman",0,1,1
3961,"Fighter, Assassin","Fighter, Tank",Marksman,"Tank, Support",1,0,1
4834,Marksman,"Mage, Marksman","Marksman, Assassin","Support, Mage",0,1,1
4833,"Marksman, Mage","Fighter, Tank","Marksman, Assassin","Tank, Fighter",0,1,1
4832,"Marksman, Support","Tank, Mage",Marksman,"Tank, Support",0,1,1
4831,"Marksman, Assassin","Support, Fighter","Marksman, Assassin","Mage, Support",0,1,1
4830,Marksman,"Marksman, Support","Marksman, Mage","Support, Tank",1,0,1
4828,"Mage, Marksman","Mage, Support","Marksman, Mage","Support, Tank",1,0,1
4763,"Marksman, Mage","Support, Fighter","Marksman, Mage","Mage, Support",0,1,1
4827,"Marksman, Assassin","Mage, Support",Marksman,"Tank, Fighter",1,0,1
4826,Marksman,"Fighter, Tank","Marksman, Mage","Tank, Fighter",1,0,1
4825,"Marksman, Assassin","Fighter, Tank","Marksman, Mage","Support, Mage",0,1,1
4824,"Marksman, Mage","Mage, Support","Marksman, Mage","Fighter, Tank",1,0,1
4823,Marksman,"Mage, Support","Marksman, Mage","Tank, Fighter",0,1,1
4822,"Marksman, Support","Mage, Support",Marksman,"Mage, Assassin",0,1,1
4821,Mage,"Support, Tank","Marksman, Assassin","Support, Mage",1,0,1
3963,Fighter,"Mage, Marksman","Mage, Fighter","Tank, Support",1,0,1
3964,Fighter,"Support, Fighter","Assassin, Mage","Support, Tank",0,1,1
4818,"Marksman, Support","Tank, Support","Marksman, Mage","Mage, Support",1,0,1
4841,"Marksman, Mage","Support, Fighter","Marksman, Mage","Mage, Assassin",1,0,1
3958,Marksman,"Support, Tank","Tank, Fighter","Support, Fighter",0,1,1
4843,"Marksman, Assassin",Marksman,"Marksman, Support","Support, Mage",0,1,1
3957,Fighter,"Support, Mage","Assassin, Fighter","Fighter, Tank",0,1,1
4865,Marksman,Support,Marksman,"Fighter, Mage",1,0,1
4864,"Marksman, Mage",Support,Marksman,"Tank, Mage",1,0,1
4863,"Marksman, Assassin",Mage,"Marksman, Mage","Support, Tank",0,1,1
3954,"Mage, Fighter",Mage,Marksman,"Tank, Support",0,1,1
4861,Marksman,Support,Marksman,"Tank, Mage",0,1,1
3955,Fighter,"Fighter, Tank","Mage, Fighter","Support, Fighter",0,1,1
4859,Marksman,"Mage, Support","Marksman, Mage","Fighter, Tank",1,0,1
4858,"Marksman, Support","Support, Mage","Mage, Marksman","Support, Tank",1,0,1
4857,"Marksman, Mage","Tank, Fighter",Marksman,Support,1,0,1
4856,Marksman,"Support, Fighter","Marksman, Mage","Tank, Mage",0,1,1
4855,Marksman,"Mage, Support","Marksman, Assassin","Tank, Fighter",0,1,1
4854,"Marksman, Mage","Fighter, Tank","Marksman, Mage","Support, Tank",0,1,1
4853,"Marksman, Mage","Support, Fighter",Marksman,"Fighter, Tank",0,1,1
4852,Marksman,Support,"Marksman, Assassin","Fighter, Tank",0,1,1
4851,Marksman,"Support, Tank",Mage,"Mage, Support",1,0,1
4850,Marksman,"Support, Tank","Marksman, Support",Tank,1,0,1
4849,"Marksman, Support","Fighter, Mage","Marksman, Mage","Tank, Fighter",0,1,1
4848,"Marksman, Mage","Mage, Support","Marksman, Mage","Tank, Support",1,0,1
4847,"Marksman, Assassin","Support, Tank","Marksman, Mage","Fighter, Mage",0,1,1
4846,Marksman,"Tank, Mage",Marksman,"Support, Mage",0,1,1
4845,"Marksman, Mage","Tank, Mage","Marksman, Support",Support,0,1,1
4817,"Marksman, Assassin",Marksman,Marksman,"Mage, Support",1,0,1
4816,"Marksman, Mage","Mage, Support",Marksman,"Fighter, Mage",0,1,1
4815,"Marksman, Mage","Mage, Support","Marksman, Mage",Mage,0,1,1
4787,"Marksman, Mage","Tank, Fighter","Marksman, Mage",Tank,1,0,1
4785,"Marksman, Mage","Support, Tank","Marksman, Mage","Tank, Fighter",1,0,1
4784,"Marksman, Mage",Tank,Marksman,"Tank, Support",0,1,1
4783,"Marksman, Mage",Tank,Marksman,"Support, Tank",0,1,1
4782,"Marksman, Mage","Support, Tank","Marksman, Assassin","Tank, Fighter",0,1,1
4781,"Marksman, Assassin","Support, Tank","Marksman, Mage",Tank,1,0,1
3977,"Assassin, Fighter","Support, Tank","Fighter, Assassin","Tank, Fighter",1,0,1
3978,Marksman,"Support, Fighter",Fighter,"Tank, Support",0,1,1
3980,"Fighter, Tank","Support, Fighter","Assassin, Fighter","Mage, Support",0,1,1
3981,Marksman,"Support, Fighter","Mage, Fighter","Fighter, Tank",1,0,1
4775,"Marksman, Assassin","Mage, Assassin","Marksman, Support","Support, Mage",1,0,1
4774,"Marksman, Support","Tank, Fighter","Marksman, Mage","Support, Tank",1,0,1
3986,"Fighter, Assassin",Support,"Assassin, Fighter","Support, Tank",0,1,1
4772,"Marksman, Assassin","Tank, Support","Marksman, Support",Support,0,1,1
4771,"Marksman, Support","Mage, Support","Marksman, Mage","Tank, Support",1,0,1
4770,"Marksman, Support",Support,"Marksman, Mage","Mage, Support",0,1,1
4769,"Mage, Marksman","Mage, Support","Marksman, Mage","Support, Mage",0,1,1
4768,"Marksman, Mage","Support, Mage","Mage, Marksman","Support, Mage",1,0,1
4767,Marksman,"Support, Tank","Marksman, Assassin","Tank, Fighter",0,1,1
3987,"Assassin, Fighter","Tank, Fighter",Marksman,"Mage, Support",1,0,1
4765,Marksman,"Mage, Support","Marksman, Support","Fighter, Tank",0,1,1
4764,"Marksman, Assassin","Support, Mage","Marksman, Mage",Support,1,0,1
4786,Marksman,"Fighter, Mage","Marksman, Assassin","Tank, Support",1,0,1
4788,Marksman,"Mage, Marksman","Marksman, Mage","Support, Tank",1,0,1
3965,"Mage, Fighter","Tank, Fighter","Fighter, Tank","Support, Tank",1,0,1
4789,"Marksman, Mage",Tank,"Marksman, Mage","Tank, Support",1,0,1
4813,"Marksman, Mage","Support, Fighter","Mage, Marksman","Tank, Fighter",1,0,1
3966,"Fighter, Mage","Mage, Marksman","Mage, Fighter","Tank, Support",0,1,1
3967,Fighter,"Tank, Support","Assassin, Mage","Support, Tank",1,0,1
4810,Marksman,"Mage, Support","Mage, Marksman","Support, Mage",1,0,1
4809,Marksman,"Mage, Support",Fighter,"Tank, Fighter",1,0,1
4808,Fighter,"Support, Fighter",Marksman,Mage,1,0,1
4807,"Support, Mage","Fighter, Tank",Marksman,"Support, Mage",0,1,1
4806,Marksman,"Mage, Marksman",Marksman,"Mage, Support",1,0,1
3968,"Mage, Fighter","Tank, Support","Mage, Fighter","Mage, Marksman",0,1,1
4804,"Marksman, Assassin","Tank, Fighter",Marksman,"Mage, Support",0,1,1
3970,"Assassin, Fighter","Support, Tank","Fighter, Tank","Tank, Mage",1,0,1
4801,"Marksman, Mage","Support, Tank","Marksman, Assassin",Tank,1,0,1
3971,"Fighter, Assassin","Support, Tank","Fighter, Tank",Support,1,0,1
4799,"Marksman, Assassin",Tank,Marksman,"Support, Tank",1,0,1
4798,"Marksman, Mage","Support, Fighter","Marksman, Assassin",Tank,0,1,1
3973,"Fighter, Mage","Support, Fighter","Fighter, Tank","Tank, Fighter",0,1,1
3974,"Mage, Fighter","Support, Fighter",Fighter,"Fighter, Tank",0,1,1
3975,"Fighter, Assassin","Tank, Fighter","Fighter, Mage",Support,1,0,1
4793,"Marksman, Mage","Mage, Support","Marksman, Mage",Tank,0,1,1
4791,"Marksman, Mage","Support, Fighter",Marksman,"Support, Fighter",0,1,1
4790,"Marksman, Mage",Tank,"Marksman, Assassin","Support, Fighter",1,0,1
5961,Tank,"Fighter, Tank","Tank, Mage","Tank, Fighter",1,0,1
5965,"Support, Mage",Fighter,"Tank, Fighter","Tank, Fighter",0,1,1
7737,Tank,Marksman,"Mage, Tank","Assassin, Fighter",1,0,1
7157,"Mage, Tank","Assassin, Fighter","Support, Mage","Fighter, Tank",0,1,1
7169,"Tank, Fighter",Marksman,"Mage, Fighter",Fighter,0,1,1
7168,"Support, Tank",Marksman,"Fighter, Tank",Fighter,1,0,1
7167,"Support, Mage","Fighter, Tank",Tank,Marksman,0,1,1
7166,"Support, Mage","Fighter, Assassin","Fighter, Assassin",Marksman,0,1,1
7165,"Marksman, Fighter",Fighter,Marksman,"Mage, Fighter",1,0,1
7164,"Mage, Marksman",Fighter,"Fighter, Assassin","Mage, Fighter",1,0,1
7163,"Mage, Support","Fighter, Assassin","Fighter, Tank","Fighter, Mage",1,0,1
7161,"Fighter, Mage",Fighter,"Assassin, Fighter","Assassin, Fighter",0,1,1
7160,"Fighter, Tank","Fighter, Mage","Assassin, Fighter","Fighter, Tank",0,1,1
7158,"Fighter, Tank","Fighter, Mage","Assassin, Fighter","Assassin, Mage",1,0,1
3137,Fighter,"Tank, Support","Mage, Fighter",Support,1,0,1
7144,"Tank, Mage","Fighter, Assassin","Fighter, Assassin","Fighter, Tank",1,0,1
3138,"Fighter, Mage","Mage, Assassin","Tank, Fighter","Mage, Fighter",1,0,1
3139,Fighter,"Tank, Mage","Mage, Fighter","Support, Tank",1,0,1
7153,"Support, Mage",Fighter,"Fighter, Tank","Assassin, Fighter",1,0,1
7152,"Mage, Fighter","Fighter, Tank","Fighter, Mage",Fighter,1,0,1
7151,"Assassin, Fighter","Fighter, Mage","Fighter, Tank","Fighter, Assassin",1,0,1
7150,"Support, Mage","Assassin, Fighter","Assassin, Fighter","Fighter, Mage",0,1,1
7149,"Assassin, Fighter","Fighter, Mage","Tank, Mage","Fighter, Assassin",1,0,1
7148,"Fighter, Mage","Fighter, Assassin","Assassin, Fighter","Assassin, Mage",1,0,1
7147,"Fighter, Tank","Tank, Fighter","Fighter, Mage","Assassin, Mage",0,1,1
7146,"Fighter, Tank","Assassin, Mage","Tank, Mage","Tank, Fighter",0,1,1
7170,"Support, Tank","Mage, Fighter",Tank,Marksman,1,0,1
7171,Marksman,"Fighter, Assassin",Tank,"Mage, Fighter",1,0,1
7172,"Support, Tank","Mage, Fighter",Marksman,"Fighter, Assassin",0,1,1
7173,"Support, Tank",Fighter,Tank,"Fighter, Assassin",1,0,1
7195,"Mage, Marksman","Mage, Fighter","Tank, Fighter",Fighter,0,1,1
7194,Mage,"Mage, Fighter","Fighter, Assassin","Fighter, Assassin",0,1,1
7193,Tank,"Assassin, Fighter","Mage, Fighter","Mage, Fighter",1,0,1
7192,"Marksman, Fighter",Marksman,"Tank, Fighter","Mage, Fighter",0,1,1
7191,Fighter,"Assassin, Fighter",Marksman,"Mage, Fighter",0,1,1
3131,"Tank, Fighter","Tank, Mage","Assassin, Mage",Mage,1,0,1
7189,"Tank, Mage","Fighter, Assassin",Fighter,Marksman,0,1,1
7188,"Support, Tank","Mage, Fighter","Tank, Fighter",Marksman,1,0,1
3133,"Tank, Fighter","Support, Mage","Tank, Fighter","Mage, Fighter",0,1,1
7185,Fighter,"Assassin, Fighter","Marksman, Fighter",Fighter,1,0,1
7184,"Marksman, Fighter",Fighter,"Tank, Fighter",Marksman,0,1,1
7183,"Marksman, Fighter","Fighter, Assassin","Tank, Fighter","Assassin, Fighter",0,1,1
7182,Marksman,"Assassin, Fighter","Tank, Fighter","Mage, Fighter",1,0,1
3134,"Tank, Mage","Tank, Support","Tank, Mage","Support, Fighter",1,0,1
7180,Tank,Marksman,"Mage, Fighter","Mage, Fighter",0,1,1
7179,"Mage, Marksman",Marksman,Mage,"Fighter, Assassin",1,0,1
7178,Fighter,Marksman,"Fighter, Tank",Fighter,1,0,1
7177,"Fighter, Assassin","Mage, Fighter","Fighter, Tank","Tank, Fighter",1,0,1
7176,Mage,"Fighter, Assassin","Mage, Fighter","Mage, Fighter",1,0,1
7175,"Support, Tank","Fighter, Assassin","Fighter, Tank",Marksman,1,0,1
7174,Mage,"Fighter, Assassin",Tank,"Mage, Fighter",0,1,1
7145,"Tank, Mage","Assassin, Mage","Fighter, Tank","Fighter, Assassin",1,0,1
7143,"Mage, Fighter","Assassin, Mage","Tank, Mage","Fighter, Mage",1,0,1
7197,"Support, Mage",Fighter,Tank,"Fighter, Mage",1,0,1
7106,"Tank, Fighter",Marksman,"Fighter, Marksman","Mage, Fighter",1,0,1
7116,"Support, Mage","Fighter, Mage",Tank,"Fighter, Assassin",0,1,1
3143,"Tank, Mage","Support, Tank","Tank, Fighter","Support, Mage",1,0,1
7114,"Mage, Fighter",Fighter,"Fighter, Mage","Fighter, Mage",1,0,1
7113,Tank,"Mage, Fighter","Tank, Fighter","Assassin, Mage",1,0,1
7112,"Support, Mage","Tank, Fighter","Mage, Fighter","Fighter, Mage",1,0,1
7111,"Mage, Fighter",Fighter,Tank,"Fighter, Mage",0,1,1
7110,Tank,"Fighter, Assassin","Fighter, Mage",Fighter,0,1,1
7109,"Fighter, Mage","Fighter, Mage","Fighter, Assassin",Fighter,0,1,1
3144,"Tank, Mage","Tank, Mage","Fighter, Mage","Support, Mage",0,1,1
7107,Tank,"Fighter, Mage","Fighter, Mage","Tank, Fighter",1,0,1
7105,"Tank, Fighter",Marksman,"Fighter, Mage","Fighter, Tank",1,0,1
7142,"Fighter, Mage",Fighter,"Fighter, Mage","Fighter, Tank",1,0,1
7104,"Fighter, Assassin",Marksman,"Mage, Marksman","Mage, Fighter",1,0,1
7103,"Fighter, Tank",Fighter,"Assassin, Fighter","Tank, Fighter",0,1,1
7102,"Fighter, Mage","Mage, Fighter","Mage, Marksman","Fighter, Assassin",0,1,1
3145,"Tank, Fighter","Fighter, Tank","Tank, Mage","Support, Fighter",0,1,1
7100,"Fighter, Mage","Fighter, Tank","Assassin, Fighter",Fighter,1,0,1
7099,"Assassin, Fighter","Tank, Support","Tank, Fighter","Mage, Fighter",1,0,1
7098,"Mage, Marksman","Fighter, Tank","Fighter, Marksman","Fighter, Assassin",0,1,1
7097,"Fighter, Marksman","Fighter, Tank","Tank, Fighter","Assassin, Fighter",1,0,1
7096,"Tank, Mage","Fighter, Tank","Fighter, Mage",Fighter,0,1,1
7095,"Fighter, Tank","Fighter, Assassin","Fighter, Assassin",Marksman,1,0,1
7117,"Fighter, Mage",Fighter,Tank,"Fighter, Assassin",1,0,1
7118,Tank,Fighter,"Mage, Fighter","Fighter, Mage",0,1,1
7119,Tank,Fighter,"Fighter, Mage","Mage, Fighter",0,1,1
7120,"Fighter, Mage","Fighter, Mage","Fighter, Tank","Fighter, Assassin",1,0,1
7141,"Mage, Fighter","Fighter, Mage","Tank, Mage","Assassin, Mage",1,0,1
7140,"Fighter, Assassin","Assassin, Mage","Fighter, Mage","Tank, Fighter",1,0,1
3140,"Tank, Fighter","Mage, Tank","Tank, Fighter","Mage, Fighter",0,1,1
7138,"Assassin, Fighter","Fighter, Mage","Mage, Fighter",Fighter,1,0,1
7137,"Fighter, Mage","Fighter, Assassin","Fighter, Assassin","Assassin, Mage",0,1,1
3141,"Mage, Fighter","Support, Mage","Fighter, Mage",Support,0,1,1
7135,Tank,"Fighter, Mage","Support, Mage",Fighter,0,1,1
7134,"Mage, Fighter",Fighter,"Assassin, Fighter","Fighter, Assassin",1,0,1
3142,"Assassin, Fighter","Mage, Support","Tank, Fighter","Mage, Fighter",0,1,1
7132,"Assassin, Fighter","Fighter, Mage","Support, Mage",Fighter,0,1,1
7131,Tank,"Mage, Fighter","Mage, Fighter","Fighter, Mage",0,1,1
7130,"Assassin, Fighter",Fighter,"Fighter, Mage","Fighter, Mage",0,1,1
7129,"Support, Tank","Fighter, Mage","Fighter, Mage",Fighter,1,0,1
7128,"Mage, Fighter","Fighter, Mage","Tank, Fighter","Assassin, Fighter",1,0,1
7127,"Tank, Mage","Tank, Fighter","Support, Mage","Fighter, Mage",1,0,1
7126,"Tank, Mage",Assassin,"Fighter, Tank","Assassin, Fighter",1,0,1
7125,"Fighter, Assassin","Fighter, Tank",Tank,"Fighter, Mage",0,1,1
7124,"Tank, Fighter","Fighter, Mage","Mage, Tank",Fighter,0,1,1
7123,"Mage, Tank",Fighter,"Fighter, Mage","Fighter, Mage",1,0,1
7122,"Tank, Mage","Tank, Fighter",Fighter,Fighter,1,0,1
7121,Tank,"Assassin, Fighter","Tank, Fighter","Fighter, Mage",0,1,1
7196,"Fighter, Tank","Fighter, Assassin","Tank, Fighter","Fighter, Tank",1,0,1
3130,"Fighter, Tank","Mage, Marksman","Tank, Fighter","Mage, Assassin",0,1,1
7093,"Tank, Fighter","Fighter, Tank","Fighter, Mage","Fighter, Tank",1,0,1
7265,"Tank, Mage","Fighter, Assassin","Mage, Support","Tank, Fighter",1,0,1
7277,"Fighter, Assassin",Fighter,"Mage, Marksman","Fighter, Assassin",1,0,1
7276,Mage,"Fighter, Assassin","Fighter, Tank","Tank, Fighter",0,1,1
7275,"Fighter, Tank","Assassin, Fighter",Mage,"Tank, Fighter",1,0,1
3107,"Assassin, Fighter","Support, Fighter",Marksman,"Tank, Fighter",1,0,1
7273,"Fighter, Assassin","Tank, Fighter",Mage,"Assassin, Fighter",0,1,1
7272,Tank,"Mage, Fighter","Tank, Fighter","Tank, Fighter",0,1,1
7271,"Fighter, Marksman","Fighter, Mage","Tank, Mage",Fighter,0,1,1
7270,Tank,"Tank, Fighter","Tank, Mage","Tank, Fighter",0,1,1
7269,Tank,"Tank, Mage","Tank, Mage",Fighter,0,1,1
7267,"Tank, Mage","Tank, Fighter","Support, Mage",Fighter,1,0,1
7264,"Mage, Marksman","Fighter, Assassin","Fighter, Tank","Tank, Fighter",1,0,1
7251,"Mage, Marksman","Tank, Fighter","Fighter, Assassin",Fighter,1,0,1
7263,"Mage, Marksman","Fighter, Tank","Tank, Mage","Fighter, Tank",0,1,1
3111,Fighter,"Support, Fighter","Tank, Mage","Support, Tank",0,1,1
7261,"Fighter, Tank","Tank, Fighter",Mage,"Tank, Fighter",1,0,1
7260,"Mage, Support",Fighter,"Mage, Marksman","Assassin, Fighter",1,0,1
7258,"Tank, Mage","Tank, Fighter","Mage, Support","Assassin, Fighter",0,1,1
7257,"Tank, Mage",Fighter,"Support, Mage","Tank, Fighter",1,0,1
7256,"Assassin, Fighter","Assassin, Fighter","Tank, Mage","Fighter, Assassin",0,1,1
7255,"Fighter, Mage","Assassin, Fighter","Mage, Marksman","Tank, Fighter",0,1,1
3113,"Fighter, Tank","Tank, Mage","Tank, Fighter","Mage, Tank",1,0,1
7253,"Tank, Mage","Tank, Fighter","Mage, Marksman","Assassin, Mage",1,0,1
3105,"Fighter, Assassin","Support, Mage","Fighter, Assassin","Mage, Support",1,0,1
7279,"Fighter, Mage","Tank, Fighter","Fighter, Tank","Assassin, Fighter",0,1,1
7280,Mage,"Mage, Fighter","Fighter, Tank","Assassin, Fighter",0,1,1
7281,"Fighter, Assassin","Tank, Fighter","Fighter, Mage","Fighter, Tank",0,1,1
3098,"Tank, Fighter","Mage, Support","Support, Mage",Support,1,0,1
3099,"Fighter, Assassin","Mage, Support",Fighter,"Tank, Support",1,0,1
7300,"Fighter, Mage","Fighter, Assassin",Tank,"Support, Mage",0,1,1
7299,"Fighter, Mage","Mage, Fighter","Tank, Fighter","Support, Mage",1,0,1
7298,"Fighter, Tank",Marksman,"Fighter, Tank","Assassin, Fighter",0,1,1
3100,"Fighter, Assassin",Support,"Assassin, Fighter","Support, Mage",1,0,1
7296,"Fighter, Tank","Fighter, Assassin","Fighter, Tank",Marksman,1,0,1
3101,Fighter,"Support, Fighter","Tank, Fighter","Mage, Support",0,1,1
3102,"Fighter, Mage","Tank, Mage","Fighter, Assassin",Support,0,1,1
7293,"Fighter, Marksman","Fighter, Assassin","Fighter, Mage",Marksman,0,1,1
7292,"Fighter, Mage","Mage, Fighter","Fighter, Tank","Support, Mage",0,1,1
7291,"Mage, Marksman",Marksman,"Fighter, Tank","Assassin, Fighter",0,1,1
3103,"Tank, Fighter","Support, Fighter",Marksman,"Support, Tank",1,0,1
3104,"Tank, Fighter","Tank, Fighter","Fighter, Assassin","Mage, Support",1,0,1
7288,"Support, Mage","Fighter, Assassin","Tank, Fighter","Fighter, Mage",1,0,1
7287,"Tank, Fighter","Mage, Fighter",Marksman,"Assassin, Fighter",1,0,1
7286,"Fighter, Tank","Fighter, Assassin",Mage,"Tank, Fighter",0,1,1
7285,"Mage, Marksman","Fighter, Assassin","Fighter, Assassin","Tank, Fighter",1,0,1
7284,"Fighter, Mage","Fighter, Tank","Fighter, Assassin","Assassin, Fighter",1,0,1
7283,Mage,"Assassin, Fighter","Fighter, Tank","Mage, Fighter",1,0,1
7282,"Support, Mage",Fighter,Mage,"Tank, Fighter",1,0,1
7252,"Mage, Marksman","Assassin, Fighter",Mage,"Assassin, Fighter",0,1,1
7250,"Mage, Support","Assassin, Fighter","Fighter, Mage","Tank, Fighter",1,0,1
7199,"Fighter, Mage","Mage, Fighter","Tank, Mage",Fighter,1,0,1
7211,"Fighter, Mage","Fighter, Tank",Fighter,"Fighter, Mage",1,0,1
7222,Tank,"Tank, Fighter","Tank, Mage","Tank, Mage",0,1,1
7221,"Fighter, Assassin","Fighter, Mage","Tank, Mage","Tank, Fighter",0,1,1
3119,"Fighter, Mage","Support, Fighter","Mage, Fighter",Support,0,1,1
7219,Tank,Fighter,"Tank, Fighter","Tank, Mage",1,0,1
7218,"Fighter, Tank","Tank, Mage","Fighter, Mage","Fighter, Assassin",1,0,1
7217,Tank,"Tank, Mage","Fighter, Tank","Fighter, Mage",0,1,1
3121,"Tank, Mage",Support,"Fighter, Mage","Support, Mage",1,0,1
7215,"Tank, Mage",Fighter,"Fighter, Assassin","Fighter, Assassin",1,0,1
3124,"Tank, Fighter","Mage, Marksman","Tank, Fighter","Tank, Mage",1,0,1
7213,"Fighter, Tank","Fighter, Mage",Fighter,"Mage, Fighter",0,1,1
3127,"Assassin, Fighter","Mage, Marksman","Assassin, Fighter","Mage, Tank",1,0,1
7249,Mage,"Assassin, Fighter","Tank, Mage","Tank, Fighter",0,1,1
3128,"Fighter, Assassin","Mage, Fighter","Tank, Fighter","Mage, Support",1,0,1
7208,"Tank, Mage","Fighter, Mage","Fighter, Mage","Mage, Fighter",0,1,1
7207,Fighter,"Fighter, Assassin","Assassin, Fighter","Mage, Fighter",0,1,1
7206,"Fighter, Assassin","Mage, Fighter","Support, Tank",Marksman,0,1,1
7205,Tank,Marksman,"Mage, Marksman",Fighter,1,0,1
7204,"Mage, Fighter",Fighter,"Support, Tank","Mage, Fighter",0,1,1
7203,"Tank, Fighter","Fighter, Mage","Fighter, Mage",Fighter,0,1,1
7202,"Assassin, Fighter","Fighter, Assassin",Tank,"Fighter, Mage",1,0,1
3129,"Mage, Fighter","Tank, Fighter","Tank, Fighter","Support, Mage",1,0,1
7200,"Tank, Fighter",Fighter,"Fighter, Mage","Mage, Fighter",1,0,1
7223,"Tank, Mage","Tank, Fighter","Tank, Mage","Fighter, Tank",1,0,1
7224,Tank,"Tank, Fighter","Fighter, Mage","Fighter, Mage",0,1,1
7225,"Tank, Mage","Fighter, Assassin","Tank, Mage","Fighter, Mage",1,0,1
7226,"Tank, Mage","Tank, Mage",Tank,"Fighter, Assassin",1,0,1
7248,"Tank, Mage","Fighter, Tank","Mage, Marksman",Fighter,0,1,1
7247,"Mage, Marksman",Fighter,"Fighter, Tank","Fighter, Assassin",0,1,1
7246,"Fighter, Tank","Assassin, Fighter",Mage,Fighter,1,0,1
7245,"Tank, Mage","Fighter, Assassin","Assassin, Fighter","Tank, Fighter",1,0,1
7244,"Tank, Mage","Tank, Fighter","Mage, Marksman",Fighter,1,0,1
7243,"Mage, Support","Assassin, Fighter","Tank, Mage","Fighter, Assassin",1,0,1
7242,"Mage, Support","Tank, Fighter","Mage, Marksman","Fighter, Assassin",1,0,1
3114,"Fighter, Tank","Mage, Assassin","Assassin, Fighter","Fighter, Assassin",1,0,1
7240,"Fighter, Tank","Tank, Fighter",Tank,"Mage, Fighter",1,0,1
7239,"Tank, Mage","Tank, Fighter","Tank, Mage","Fighter, Assassin",1,0,1
7238,Tank,"Tank, Fighter","Tank, Mage",Marksman,1,0,1
7237,Tank,"Tank, Fighter","Tank, Fighter","Mage, Fighter",0,1,1
7236,"Fighter, Mage","Assassin, Fighter","Tank, Fighter","Tank, Mage",0,1,1
7235,"Mage, Marksman","Tank, Mage","Fighter, Tank",Fighter,0,1,1
7234,"Tank, Fighter","Tank, Fighter","Tank, Mage",Marksman,0,1,1
7233,"Fighter, Tank","Fighter, Mage","Fighter, Marksman","Tank, Mage",1,0,1
7232,"Fighter, Tank","Mage, Fighter",Tank,"Fighter, Mage",0,1,1
3117,"Tank, Fighter","Support, Mage","Tank, Fighter",Support,0,1,1
7229,"Tank, Fighter","Mage, Fighter",Tank,"Tank, Fighter",1,0,1
7228,"Fighter, Mage","Fighter, Tank","Tank, Mage",Fighter,0,1,1
7227,"Tank, Mage","Fighter, Assassin","Tank, Mage","Assassin, Fighter",1,0,1
7094,"Mage, Marksman","Fighter, Tank","Fighter, Mage",Fighter,1,0,1
7092,"Tank, Fighter","Assassin, Mage","Fighter, Tank","Fighter, Mage",0,1,1
5966,Tank,Marksman,Mage,Fighter,1,0,1
3185,"Fighter, Mage","Fighter, Tank","Tank, Mage","Tank, Fighter",1,0,1
6954,"Fighter, Assassin",Fighter,"Fighter, Assassin","Assassin, Fighter",0,1,1
3179,"Assassin, Fighter","Support, Tank","Fighter, Assassin","Mage, Assassin",1,0,1
3181,"Fighter, Assassin","Tank, Fighter",Marksman,"Support, Mage",0,1,1
6951,"Fighter, Assassin","Fighter, Tank","Tank, Fighter","Assassin, Fighter",1,0,1
6950,"Tank, Fighter","Assassin, Fighter","Fighter, Assassin",Fighter,0,1,1
6949,"Fighter, Mage",Fighter,Mage,"Fighter, Tank",0,1,1
6948,"Assassin, Mage",Fighter,Mage,"Mage, Fighter",0,1,1
6947,"Mage, Fighter",Fighter,"Tank, Fighter","Mage, Fighter",1,0,1
6945,"Fighter, Mage","Assassin, Fighter","Mage, Marksman","Support, Mage",0,1,1
6943,"Fighter, Mage","Fighter, Mage",Tank,"Tank, Fighter",1,0,1
6941,"Fighter, Mage","Tank, Fighter","Tank, Mage","Tank, Fighter",1,0,1
6929,"Fighter, Marksman","Tank, Fighter","Fighter, Tank",Fighter,1,0,1
3186,Marksman,"Mage, Marksman",Marksman,Marksman,0,1,1
6939,"Fighter, Marksman","Tank, Fighter","Fighter, Mage","Tank, Fighter",1,0,1
6938,"Tank, Mage","Assassin, Fighter","Tank, Mage",Fighter,1,0,1
6937,"Fighter, Marksman","Fighter, Mage","Tank, Fighter","Support, Mage",0,1,1
3187,Fighter,"Mage, Marksman",Marksman,Marksman,1,0,1
6935,"Tank, Mage","Marksman, Mage","Fighter, Marksman","Tank, Fighter",0,1,1
6934,"Tank, Fighter","Assassin, Fighter","Tank, Mage","Marksman, Mage",1,0,1
6933,"Tank, Mage","Mage, Fighter","Tank, Mage","Assassin, Fighter",0,1,1
6932,"Fighter, Marksman","Fighter, Mage","Tank, Mage","Fighter, Assassin",1,0,1
6931,"Tank, Fighter","Fighter, Mage",Fighter,"Tank, Mage",1,0,1
3178,"Assassin, Fighter","Mage, Support","Fighter, Tank","Fighter, Mage",0,1,1
3177,"Mage, Fighter","Assassin, Fighter","Fighter, Mage","Mage, Fighter",1,0,1
6957,"Fighter, Assassin","Fighter, Assassin","Mage, Tank","Mage, Fighter",0,1,1
6958,"Fighter, Assassin","Fighter, Mage",Fighter,Marksman,0,1,1
6981,Tank,Marksman,"Assassin, Fighter","Fighter, Tank",0,1,1
6980,"Fighter, Mage",Marksman,"Tank, Mage","Support, Mage",1,0,1
6979,"Fighter, Mage","Support, Mage","Fighter, Mage","Fighter, Tank",0,1,1
6978,Tank,"Fighter, Assassin","Tank, Mage",Marksman,1,0,1
6977,"Tank, Mage","Fighter, Assassin","Fighter, Mage","Support, Mage",1,0,1
6976,"Fighter, Mage","Fighter, Assassin","Fighter, Mage","Mage, Fighter",0,1,1
3170,Marksman,Fighter,"Fighter, Mage","Assassin, Fighter",1,0,1
6973,Mage,Fighter,"Tank, Fighter","Assassin, Fighter",0,1,1
6972,"Fighter, Assassin","Fighter, Tank","Support, Mage",Fighter,1,0,1
6971,"Mage, Tank",Marksman,"Marksman, Fighter","Assassin, Fighter",0,1,1
6969,"Marksman, Fighter","Mage, Fighter","Fighter, Assassin","Assassin, Fighter",1,0,1
3174,Fighter,"Mage, Support","Support, Mage","Mage, Support",0,1,1
6967,"Tank, Fighter","Fighter, Mage","Mage, Tank","Fighter, Tank",0,1,1
6966,"Tank, Fighter","Fighter, Assassin","Mage, Tank","Fighter, Mage",1,0,1
3175,"Assassin, Fighter","Mage, Assassin","Assassin, Fighter",Marksman,0,1,1
6964,"Fighter, Assassin",Fighter,Mage,"Fighter, Tank",0,1,1
6963,Fighter,"Fighter, Assassin","Fighter, Assassin","Fighter, Mage",0,1,1
3176,Assassin,"Mage, Support","Fighter, Mage","Support, Mage",1,0,1
6961,"Mage, Fighter","Fighter, Mage","Fighter, Assassin","Mage, Fighter",0,1,1
6960,"Fighter, Assassin",Fighter,"Fighter, Assassin","Fighter, Assassin",0,1,1
6959,"Assassin, Fighter","Fighter, Mage","Mage, Fighter","Fighter, Assassin",1,0,1
6930,Tank,"Fighter, Mage","Fighter, Marksman","Fighter, Assassin",0,1,1
6928,"Tank, Fighter",Fighter,"Tank, Mage","Marksman, Mage",1,0,1
6983,"Assassin, Fighter","Fighter, Assassin",Tank,Marksman,1,0,1
6889,"Tank, Mage","Tank, Fighter",Tank,"Tank, Mage",0,1,1
6899,"Tank, Mage",Fighter,Mage,"Fighter, Mage",1,0,1
3197,"Tank, Mage","Support, Tank","Tank, Fighter","Fighter, Tank",1,0,1
6897,"Fighter, Assassin","Assassin, Fighter","Mage, Fighter","Mage, Fighter",1,0,1
3198,"Fighter, Assassin","Fighter, Mage",Fighter,"Mage, Support",1,0,1
6895,Tank,"Fighter, Tank","Tank, Mage","Tank, Mage",0,1,1
6894,"Tank, Fighter","Assassin, Fighter",Tank,"Tank, Fighter",0,1,1
3199,"Tank, Mage","Support, Tank","Mage, Fighter","Support, Fighter",1,0,1
3200,"Fighter, Assassin","Fighter, Tank","Tank, Mage","Tank, Support",1,0,1
3201,"Mage, Fighter","Fighter, Mage","Fighter, Assassin","Mage, Support",1,0,1
6890,"Tank, Mage","Assassin, Fighter","Tank, Mage","Mage, Fighter",1,0,1
6888,"Tank, Mage","Fighter, Assassin",Tank,"Tank, Fighter",0,1,1
3189,"Fighter, Mage",Support,"Tank, Mage","Support, Tank",1,0,1
6887,"Fighter, Tank","Fighter, Assassin",Tank,Fighter,1,0,1
6886,Fighter,"Fighter, Assassin","Tank, Fighter","Tank, Fighter",0,1,1
6885,"Tank, Mage","Fighter, Tank","Tank, Mage","Fighter, Mage",1,0,1
6884,Tank,Marksman,"Support, Mage",Fighter,0,1,1
6883,"Fighter, Assassin",Fighter,"Fighter, Tank","Tank, Mage",0,1,1
6882,"Tank, Mage","Fighter, Mage","Tank, Mage","Assassin, Fighter",1,0,1
3202,"Mage, Fighter","Fighter, Mage",Fighter,"Fighter, Marksman",1,0,1
6880,"Fighter, Tank","Mage, Fighter",Tank,"Support, Mage",0,1,1
6879,"Fighter, Tank","Fighter, Assassin","Mage, Marksman","Support, Mage",1,0,1
6878,Tank,"Assassin, Fighter","Fighter, Tank","Tank, Fighter",0,1,1
6900,"Fighter, Tank",Fighter,Mage,"Fighter, Mage",1,0,1
6901,"Mage, Tank",Fighter,"Tank, Mage","Tank, Fighter",0,1,1
6902,Mage,"Fighter, Mage","Fighter, Tank",Fighter,1,0,1
6904,"Fighter, Tank","Fighter, Assassin","Mage, Marksman","Tank, Fighter",1,0,1
3190,"Tank, Mage","Fighter, Tank","Tank, Mage","Support, Tank",1,0,1
6925,"Tank, Mage",Fighter,"Fighter, Tank","Marksman, Mage",1,0,1
6924,"Tank, Mage",Fighter,"Tank, Mage","Assassin, Fighter",1,0,1
6923,Tank,"Support, Mage","Tank, Mage","Fighter, Mage",0,1,1
6922,"Tank, Mage","Tank, Fighter","Fighter, Tank","Marksman, Mage",0,1,1
6921,"Mage, Marksman",Marksman,"Fighter, Marksman","Tank, Fighter",0,1,1
3193,"Fighter, Mage","Mage, Support","Tank, Mage","Fighter, Tank",0,1,1
6918,"Assassin, Fighter",Marksman,"Assassin, Fighter","Fighter, Assassin",0,1,1
6917,"Tank, Mage","Fighter, Assassin","Assassin, Fighter",Marksman,1,0,1
6916,"Assassin, Fighter","Fighter, Assassin","Tank, Fighter",Marksman,1,0,1
3194,"Assassin, Fighter","Fighter, Mage","Fighter, Assassin",Mage,0,1,1
6914,"Mage, Fighter",Marksman,"Tank, Fighter","Mage, Fighter",0,1,1
6913,"Fighter, Tank","Fighter, Assassin","Tank, Mage",Marksman,0,1,1
6912,"Fighter, Mage","Fighter, Assassin","Fighter, Marksman",Marksman,1,0,1
6911,Tank,"Tank, Fighter","Fighter, Tank",Marksman,0,1,1
6910,"Fighter, Marksman","Tank, Fighter",Tank,"Tank, Fighter",1,0,1
3195,"Tank, Fighter","Support, Tank","Tank, Mage","Support, Mage",1,0,1
6908,"Tank, Mage","Tank, Mage","Tank, Fighter","Tank, Fighter",0,1,1
6907,Tank,"Tank, Fighter",Fighter,"Tank, Fighter",1,0,1
6906,Tank,"Fighter, Assassin","Fighter, Tank","Tank, Fighter",0,1,1
6905,Tank,"Fighter, Mage","Mage, Marksman","Tank, Fighter",1,0,1
6982,Tank,"Support, Mage","Tank, Fighter",Marksman,1,0,1
6984,"Tank, Mage",Marksman,Tank,"Mage, Fighter",0,1,1
7091,"Mage, Marksman","Mage, Fighter","Fighter, Tank",Fighter,0,1,1
7052,"Tank, Fighter","Fighter, Tank","Fighter, Marksman","Tank, Fighter",1,0,1
7062,"Fighter, Marksman","Mage, Fighter","Fighter, Mage","Fighter, Tank",0,1,1
7061,"Fighter, Mage","Fighter, Tank","Assassin, Fighter","Fighter, Assassin",1,0,1
3158,"Support, Mage","Support, Mage","Assassin, Fighter","Support, Mage",0,1,1
7059,"Mage, Marksman","Fighter, Assassin","Fighter, Tank","Fighter, Tank",1,0,1
7058,"Mage, Marksman",Fighter,"Fighter, Mage","Fighter, Tank",0,1,1
7057,"Fighter, Marksman","Assassin, Fighter","Mage, Marksman","Fighter, Tank",0,1,1
3159,"Fighter, Assassin","Assassin, Mage",Marksman,Marksman,0,1,1
7055,"Assassin, Fighter","Mage, Fighter","Mage, Marksman",Fighter,0,1,1
7054,"Tank, Fighter","Mage, Fighter","Fighter, Marksman",Fighter,1,0,1
7053,"Fighter, Marksman",Fighter,"Mage, Marksman","Fighter, Tank",0,1,1
7051,"Tank, Fighter","Fighter, Assassin","Fighter, Marksman",Fighter,0,1,1
7038,"Fighter, Mage","Fighter, Assassin","Mage, Fighter","Assassin, Mage",0,1,1
7050,"Tank, Fighter","Fighter, Tank","Mage, Marksman","Tank, Fighter",0,1,1
7049,"Mage, Marksman","Fighter, Assassin","Fighter, Assassin","Mage, Fighter",0,1,1
7048,Tank,Marksman,"Tank, Mage","Tank, Fighter",1,0,1
7047,"Tank, Fighter","Mage, Fighter","Mage, Marksman","Fighter, Mage",0,1,1
7045,"Assassin, Mage","Fighter, Assassin","Assassin, Fighter","Mage, Fighter",1,0,1
7044,"Fighter, Tank","Assassin, Fighter","Mage, Fighter","Tank, Fighter",0,1,1
7043,"Fighter, Tank","Assassin, Fighter","Fighter, Support","Fighter, Assassin",0,1,1
7042,"Assassin, Fighter","Mage, Fighter","Mage, Fighter","Assassin, Fighter",0,1,1
7041,"Tank, Mage","Mage, Fighter","Fighter, Mage","Assassin, Fighter",0,1,1
7040,"Mage, Fighter","Assassin, Fighter","Fighter, Support","Fighter, Assassin",1,0,1
7063,"Mage, Marksman",Fighter,"Tank, Fighter","Mage, Fighter",1,0,1
7064,"Fighter, Mage",Fighter,"Fighter, Marksman","Mage, Fighter",0,1,1
7065,"Fighter, Tank","Fighter, Tank","Fighter, Mage","Fighter, Assassin",1,0,1
7066,"Mage, Marksman","Fighter, Tank","Tank, Mage","Fighter, Assassin",0,1,1
7090,"Support, Mage",Fighter,"Tank, Fighter","Mage, Fighter",1,0,1
7089,"Support, Mage","Mage, Fighter","Fighter, Assassin",Fighter,1,0,1
7088,"Fighter, Assassin","Tank, Fighter","Mage, Marksman","Assassin, Mage",1,0,1
7087,"Fighter, Assassin","Tank, Fighter","Fighter, Assassin","Fighter, Tank",1,0,1
3146,"Assassin, Fighter","Mage, Assassin","Assassin, Fighter","Mage, Fighter",0,1,1
7084,"Mage, Marksman","Assassin, Fighter","Fighter, Tank","Fighter, Tank",1,0,1
7083,"Fighter, Marksman","Assassin, Fighter","Mage, Marksman","Fighter, Assassin",1,0,1
7082,"Fighter, Mage",Fighter,"Fighter, Marksman","Fighter, Tank",1,0,1
7081,"Fighter, Mage","Fighter, Assassin","Mage, Marksman","Fighter, Tank",0,1,1
7080,"Fighter, Tank","Mage, Fighter","Fighter, Marksman","Fighter, Assassin",0,1,1
7078,"Assassin, Fighter","Fighter, Tank","Fighter, Mage","Fighter, Assassin",0,1,1
7077,"Fighter, Mage","Fighter, Assassin","Assassin, Fighter","Fighter, Tank",1,0,1
7075,"Assassin, Fighter","Assassin, Fighter","Mage, Marksman","Fighter, Tank",1,0,1
7074,"Fighter, Mage","Fighter, Assassin","Fighter, Marksman","Fighter, Tank",0,1,1
7073,"Tank, Fighter","Fighter, Tank","Fighter, Tank","Mage, Fighter",1,0,1
7072,"Fighter, Tank","Fighter, Assassin","Mage, Marksman",Marksman,1,0,1
3152,"Support, Mage","Support, Tank","Assassin, Fighter","Support, Mage",1,0,1
3156,Marksman,"Assassin, Mage","Fighter, Marksman",Mage,0,1,1
3157,"Tank, Fighter","Support, Mage","Support, Mage","Mage, Support",0,1,1
7068,"Tank, Mage","Tank, Fighter","Tank, Fighter","Marksman, Mage",0,1,1
7067,"Fighter, Assassin","Fighter, Assassin","Fighter, Mage","Fighter, Tank",0,1,1
7039,"Mage, Fighter","Assassin, Fighter","Fighter, Mage","Fighter, Assassin",0,1,1
7037,"Mage, Fighter","Assassin, Fighter","Fighter, Assassin","Fighter, Assassin",1,0,1
6985,"Fighter, Mage","Support, Mage","Fighter, Mage","Tank, Fighter",0,1,1
6997,"Tank, Fighter","Fighter, Assassin","Support, Mage","Assassin, Fighter",0,1,1
3162,"Fighter, Assassin","Support, Fighter","Assassin, Fighter",Support,1,0,1
7009,Fighter,"Fighter, Assassin","Fighter, Tank","Assassin, Fighter",1,0,1
3166,Marksman,"Mage, Assassin",Marksman,Fighter,0,1,1
7006,"Assassin, Mage","Assassin, Fighter","Mage, Fighter","Fighter, Assassin",1,0,1
7005,"Support, Mage","Fighter, Assassin","Fighter, Tank",Fighter,1,0,1
7003,"Tank, Fighter",Fighter,"Assassin, Fighter","Fighter, Assassin",1,0,1
7002,"Fighter, Tank",Fighter,"Support, Mage","Fighter, Assassin",0,1,1
7001,Fighter,"Mage, Fighter","Fighter, Assassin","Fighter, Assassin",1,0,1
7000,"Fighter, Mage","Fighter, Assassin","Support, Mage","Assassin, Fighter",1,0,1
3169,Marksman,"Assassin, Mage","Mage, Fighter","Marksman, Mage",0,1,1
6996,"Tank, Fighter","Tank, Fighter","Mage, Marksman","Fighter, Assassin",0,1,1
7036,"Mage, Fighter","Tank, Fighter","Fighter, Mage","Assassin, Fighter",1,0,1
6995,"Fighter, Tank",Fighter,"Mage, Support","Assassin, Fighter",1,0,1
6994,"Tank, Fighter","Tank, Fighter","Fighter, Tank","Fighter, Assassin",1,0,1
6993,"Fighter, Assassin","Assassin, Fighter",Mage,"Fighter, Assassin",0,1,1
6992,"Tank, Fighter","Assassin, Fighter","Support, Mage","Fighter, Assassin",0,1,1
6991,"Fighter, Mage","Fighter, Assassin","Tank, Mage","Fighter, Tank",1,0,1
6990,Fighter,"Fighter, Assassin","Tank, Mage","Support, Mage",1,0,1
6989,"Fighter, Assassin","Fighter, Assassin","Tank, Fighter",Marksman,1,0,1
6988,"Assassin, Fighter","Fighter, Assassin","Fighter, Mage",Marksman,1,0,1
6987,"Mage, Marksman","Support, Mage","Tank, Mage",Marksman,0,1,1
6986,"Assassin, Fighter","Support, Mage","Tank, Mage",Marksman,1,0,1
7011,"Tank, Fighter","Fighter, Assassin","Mage, Tank","Mage, Fighter",0,1,1
7012,"Support, Mage","Fighter, Mage","Fighter, Tank","Fighter, Assassin",0,1,1
7013,"Fighter, Tank","Fighter, Tank","Tank, Mage",Fighter,1,0,1
7014,"Assassin, Fighter","Mage, Fighter","Mage, Marksman","Fighter, Mage",1,0,1
7035,"Assassin, Mage","Assassin, Fighter","Fighter, Assassin","Fighter, Assassin",0,1,1
3161,"Mage, Fighter","Support, Tank","Fighter, Tank",Support,1,0,1
7033,"Tank, Mage","Fighter, Assassin","Mage, Fighter","Assassin, Fighter",0,1,1
7032,"Fighter, Support","Fighter, Assassin",Assassin,"Assassin, Fighter",0,1,1
7031,"Tank, Mage","Assassin, Fighter","Tank, Mage","Assassin, Fighter",1,0,1
7030,"Mage, Fighter","Assassin, Fighter","Assassin, Mage","Fighter, Assassin",0,1,1
7029,"Fighter, Assassin","Tank, Fighter","Mage, Fighter","Tank, Fighter",1,0,1
7028,"Tank, Mage","Assassin, Fighter","Assassin, Fighter","Assassin, Fighter",1,0,1
7027,"Mage, Fighter","Fighter, Assassin","Fighter, Support","Assassin, Fighter",0,1,1
7026,"Mage, Fighter","Fighter, Assassin","Fighter, Assassin","Assassin, Fighter",0,1,1
7025,"Fighter, Mage","Fighter, Assassin","Mage, Fighter","Assassin, Fighter",1,0,1
7024,"Fighter, Assassin","Fighter, Assassin","Assassin, Fighter","Fighter, Assassin",1,0,1
7023,"Fighter, Support","Fighter, Assassin","Support, Mage","Assassin, Fighter",1,0,1
7022,"Mage, Fighter","Assassin, Fighter","Tank, Mage","Fighter, Assassin",1,0,1
7021,"Mage, Fighter","Assassin, Fighter","Fighter, Support","Mage, Fighter",1,0,1
7020,"Fighter, Mage","Fighter, Assassin","Fighter, Support","Assassin, Fighter",1,0,1
7019,"Mage, Fighter","Fighter, Assassin","Support, Mage","Tank, Fighter",1,0,1
7018,"Fighter, Assassin","Fighter, Assassin","Fighter, Assassin","Assassin, Fighter",1,0,1
7017,"Fighter, Assassin","Assassin, Mage","Support, Mage","Assassin, Fighter",1,0,1
7016,"Fighter, Mage","Mage, Fighter","Mage, Fighter","Assassin, Fighter",0,1,1
7015,"Fighter, Assassin","Fighter, Assassin","Fighter, Support","Assassin, Fighter",0,1,1
7303,"Tank, Fighter","Fighter, Assassin","Mage, Marksman","Mage, Fighter",0,1,1
7304,"Assassin, Fighter","Fighter, Mage","Fighter, Mage","Fighter, Assassin",1,0,1
7307,"Fighter, Mage","Fighter, Assassin","Tank, Mage",Marksman,0,1,1
7584,"Tank, Mage","Fighter, Assassin","Mage, Fighter","Tank, Fighter",1,0,1
7596,"Mage, Tank","Mage, Fighter",Tank,"Fighter, Assassin",0,1,1
7595,"Tank, Mage","Assassin, Fighter",Tank,"Assassin, Mage",0,1,1
7594,"Assassin, Fighter","Tank, Fighter","Tank, Mage","Tank, Fighter",1,0,1
7593,"Fighter, Mage","Fighter, Mage","Assassin, Mage","Mage, Fighter",0,1,1
7592,"Fighter, Tank","Tank, Fighter","Support, Mage","Tank, Fighter",0,1,1
7590,"Fighter, Mage","Fighter, Assassin","Tank, Mage","Tank, Fighter",1,0,1
7589,Mage,"Fighter, Assassin","Fighter, Assassin","Fighter, Assassin",1,0,1
7588,"Tank, Fighter","Fighter, Assassin","Tank, Mage","Fighter, Assassin",1,0,1
3025,"Fighter, Assassin","Mage, Fighter","Tank, Fighter",Mage,0,1,1
7585,Mage,Fighter,"Tank, Mage","Fighter, Assassin",1,0,1
7583,"Fighter, Tank","Fighter, Assassin","Tank, Mage","Fighter, Assassin",1,0,1
7571,"Tank, Fighter","Assassin, Fighter",Mage,"Tank, Fighter",0,1,1
7582,"Tank, Mage","Fighter, Assassin","Assassin, Mage",Fighter,1,0,1
7581,Mage,Fighter,"Tank, Fighter","Tank, Fighter",1,0,1
7580,Fighter,"Fighter, Assassin","Tank, Mage","Fighter, Assassin",0,1,1
7579,"Support, Mage",Fighter,"Fighter, Mage","Fighter, Assassin",0,1,1
7578,"Assassin, Mage","Assassin, Fighter","Fighter, Tank","Tank, Fighter",0,1,1
3026,"Tank, Fighter","Mage, Support","Tank, Mage","Support, Tank",1,0,1
7576,"Tank, Fighter",Fighter,"Assassin, Mage","Fighter, Assassin",0,1,1
7575,"Fighter, Tank","Tank, Fighter","Support, Mage","Fighter, Assassin",1,0,1
7574,"Support, Mage","Fighter, Assassin","Tank, Fighter","Tank, Fighter",0,1,1
7573,"Tank, Mage","Tank, Fighter","Support, Mage","Assassin, Fighter",1,0,1
7597,"Tank, Mage","Assassin, Fighter","Mage, Marksman","Fighter, Mage",0,1,1
7599,"Fighter, Mage","Fighter, Tank","Tank, Mage","Assassin, Mage",1,0,1
7600,"Assassin, Fighter","Tank, Fighter","Tank, Mage","Assassin, Mage",1,0,1
7601,"Mage, Fighter","Fighter, Assassin","Tank, Fighter","Fighter, Mage",1,0,1
7622,Tank,"Tank, Fighter","Fighter, Mage","Fighter, Assassin",1,0,1
7621,"Fighter, Mage","Fighter, Mage","Fighter, Assassin","Assassin, Mage",1,0,1
7620,"Mage, Fighter","Tank, Fighter","Tank, Mage",Fighter,0,1,1
7619,"Mage, Fighter","Tank, Fighter","Fighter, Assassin","Fighter, Mage",1,0,1
7618,"Tank, Mage",Fighter,"Mage, Fighter","Tank, Fighter",0,1,1
7617,"Fighter, Mage","Tank, Fighter","Fighter, Assassin","Fighter, Mage",0,1,1
7616,"Fighter, Tank","Tank, Fighter","Assassin, Fighter","Fighter, Mage",0,1,1
7615,"Fighter, Mage",Fighter,"Mage, Tank","Fighter, Mage",1,0,1
7614,"Fighter, Tank","Fighter, Assassin","Assassin, Fighter",Fighter,1,0,1
7613,"Mage, Tank","Fighter, Mage","Fighter, Tank","Fighter, Assassin",0,1,1
7612,"Tank, Fighter",Fighter,"Assassin, Fighter","Fighter, Mage",0,1,1
7611,"Mage, Tank","Fighter, Assassin","Fighter, Mage","Tank, Fighter",0,1,1
7610,"Support, Mage","Tank, Fighter","Mage, Tank","Tank, Fighter",1,0,1
7609,"Tank, Mage",Fighter,"Mage, Tank","Fighter, Assassin",0,1,1
3017,"Tank, Mage","Mage, Support","Fighter, Mage","Support, Mage",0,1,1
4219,"Fighter, Mage",Mage,"Assassin, Mage","Support, Mage",1,0,1
7606,"Fighter, Mage","Tank, Fighter","Mage, Support",Fighter,1,0,1
7605,Tank,"Fighter, Mage","Tank, Mage","Fighter, Tank",0,1,1
7604,"Tank, Mage","Fighter, Mage","Fighter, Tank","Fighter, Assassin",1,0,1
7603,Tank,"Fighter, Mage","Fighter, Tank","Fighter, Tank",0,1,1
7602,"Tank, Mage","Fighter, Mage","Tank, Fighter",Fighter,0,1,1
3029,"Assassin, Mage","Mage, Marksman","Tank, Fighter","Mage, Support",1,0,1
7570,"Tank, Mage","Fighter, Assassin","Fighter, Assassin","Tank, Fighter",1,0,1
7624,"Fighter, Mage","Fighter, Mage","Tank, Fighter","Assassin, Fighter",0,1,1
7531,"Assassin, Fighter","Fighter, Tank","Tank, Mage",Fighter,0,1,1
7542,"Support, Mage","Fighter, Mage","Tank, Mage","Tank, Fighter",0,1,1
7541,"Assassin, Fighter",Marksman,Mage,Marksman,0,1,1
7540,"Assassin, Fighter","Assassin, Fighter","Assassin, Fighter",Fighter,1,0,1
7539,"Tank, Mage",Fighter,"Mage, Tank","Mage, Fighter",1,0,1
7538,"Mage, Fighter",Marksman,"Fighter, Assassin",Fighter,0,1,1
7537,"Mage, Tank","Fighter, Mage","Assassin, Fighter","Fighter, Assassin",0,1,1
7536,"Tank, Mage","Fighter, Assassin","Mage, Fighter",Fighter,0,1,1
7534,"Tank, Mage","Fighter, Mage","Fighter, Assassin",Fighter,0,1,1
7533,"Fighter, Assassin",Marksman,"Tank, Fighter",Fighter,0,1,1
7532,"Fighter, Assassin",Fighter,"Mage, Fighter",Marksman,1,0,1
7530,"Mage, Tank",Marksman,"Tank, Mage",Fighter,1,0,1
3030,"Tank, Fighter","Mage, Marksman","Tank, Fighter","Fighter, Marksman",1,0,1
7529,"Fighter, Tank",Marksman,Marksman,"Fighter, Mage",1,0,1
7528,"Fighter, Tank","Fighter, Mage",Marksman,"Mage, Fighter",1,0,1
7527,"Tank, Fighter","Mage, Fighter","Support, Mage","Fighter, Assassin",1,0,1
7526,"Tank, Fighter","Fighter, Assassin","Support, Mage","Mage, Fighter",0,1,1
7525,Marksman,"Assassin, Fighter","Fighter, Tank",Marksman,1,0,1
7524,"Fighter, Assassin","Tank, Fighter",Marksman,"Fighter, Mage",1,0,1
3043,"Mage, Fighter","Support, Tank","Fighter, Assassin",Tank,1,0,1
7522,"Support, Mage","Fighter, Mage","Tank, Fighter","Fighter, Assassin",1,0,1
7521,"Tank, Fighter","Mage, Fighter","Assassin, Fighter","Fighter, Mage",0,1,1
3045,"Tank, Fighter",Marksman,"Tank, Fighter","Mage, Assassin",1,0,1
3038,"Tank, Fighter","Tank, Mage","Assassin, Fighter",Marksman,1,0,1
7544,"Fighter, Assassin","Fighter, Mage","Fighter, Mage","Assassin, Fighter",0,1,1
7545,"Mage, Marksman","Fighter, Assassin","Fighter, Assassin","Fighter, Assassin",1,0,1
7546,"Mage, Marksman","Tank, Fighter","Tank, Mage","Fighter, Assassin",0,1,1
7568,"Mage, Support",Fighter,"Fighter, Tank","Tank, Fighter",1,0,1
7567,"Fighter, Tank","Assassin, Fighter","Support, Mage","Tank, Fighter",1,0,1
7566,Mage,"Fighter, Mage","Support, Mage","Tank, Fighter",0,1,1
7564,"Tank, Fighter","Fighter, Assassin",Mage,"Fighter, Mage",1,0,1
7563,"Tank, Mage","Fighter, Assassin","Mage, Marksman",Fighter,1,0,1
7562,"Fighter, Mage","Tank, Fighter","Fighter, Mage",Fighter,1,0,1
7561,"Fighter, Assassin",Fighter,"Fighter, Mage","Fighter, Assassin",0,1,1
3036,"Fighter, Assassin","Mage, Marksman","Tank, Fighter","Mage, Tank",1,0,1
7559,"Mage, Tank","Tank, Fighter","Tank, Mage","Tank, Fighter",1,0,1
7558,"Assassin, Fighter",Fighter,"Tank, Mage","Tank, Fighter",1,0,1
7557,"Support, Mage","Tank, Fighter","Mage, Marksman",Fighter,1,0,1
7556,"Tank, Mage",Fighter,"Fighter, Mage","Assassin, Fighter",1,0,1
7555,"Mage, Support","Fighter, Assassin","Fighter, Assassin",Fighter,1,0,1
7554,"Fighter, Mage","Assassin, Fighter","Mage, Support",Fighter,0,1,1
7553,"Fighter, Mage",Fighter,"Tank, Mage","Mage, Support",1,0,1
7552,"Fighter, Mage","Fighter, Assassin","Mage, Marksman","Fighter, Assassin",1,0,1
3037,"Tank, Fighter","Mage, Marksman","Fighter, Tank","Mage, Fighter",1,0,1
7550,"Mage, Marksman","Tank, Fighter","Support, Mage",Fighter,0,1,1
7549,"Mage, Marksman","Fighter, Assassin","Support, Mage","Fighter, Assassin",1,0,1
7548,"Mage, Marksman","Tank, Fighter","Fighter, Mage","Fighter, Assassin",0,1,1
7547,Mage,"Tank, Fighter","Tank, Fighter",Fighter,1,0,1
7623,Tank,Fighter,"Fighter, Mage","Fighter, Mage",1,0,1
7625,"Support, Mage","Assassin, Mage","Tank, Fighter","Fighter, Mage",0,1,1
7308,Tank,"Mage, Fighter","Tank, Fighter","Assassin, Fighter",1,0,1
7698,"Fighter, Tank","Fighter, Mage","Support, Tank",Fighter,1,0,1
7709,"Fighter, Mage",Marksman,"Fighter, Assassin","Mage, Fighter",0,1,1
7708,"Assassin, Fighter","Mage, Fighter","Fighter, Mage",Marksman,1,0,1
7707,"Fighter, Mage","Fighter, Tank",Tank,"Fighter, Tank",1,0,1
7706,"Fighter, Tank",Marksman,"Tank, Mage","Fighter, Assassin",0,1,1
7705,"Tank, Fighter","Fighter, Mage","Assassin, Fighter","Mage, Fighter",1,0,1
7704,"Tank, Fighter",Marksman,"Assassin, Fighter","Mage, Fighter",0,1,1
7703,"Tank, Fighter","Assassin, Fighter",Fighter,"Fighter, Mage",1,0,1
7702,Marksman,Fighter,"Tank, Mage","Fighter, Assassin",0,1,1
7701,"Tank, Mage","Fighter, Mage","Tank, Fighter",Marksman,0,1,1
7699,"Tank, Fighter",Marksman,"Assassin, Fighter",Fighter,1,0,1
7697,"Fighter, Tank","Fighter, Tank","Fighter, Tank",Marksman,1,0,1
2998,Fighter,Marksman,"Mage, Fighter","Support, Mage",0,1,1
7696,"Fighter, Tank","Fighter, Mage","Support, Mage","Mage, Fighter",1,0,1
7695,"Fighter, Mage","Fighter, Mage",Fighter,"Mage, Fighter",1,0,1
7694,"Fighter, Tank","Fighter, Tank","Support, Tank","Fighter, Mage",1,0,1
7693,"Fighter, Tank","Fighter, Tank",Mage,"Fighter, Mage",0,1,1
7692,Mage,Fighter,"Fighter, Tank","Fighter, Tank",0,1,1
7691,"Fighter, Tank","Fighter, Tank",Mage,Fighter,1,0,1
7690,"Fighter, Tank","Fighter, Tank",Fighter,Fighter,1,0,1
7689,"Fighter, Tank","Fighter, Tank","Marksman, Assassin",Fighter,1,0,1
7688,Tank,"Fighter, Tank","Fighter, Tank","Assassin, Fighter",1,0,1
7687,"Tank, Fighter","Support, Mage","Fighter, Mage","Fighter, Assassin",1,0,1
7710,Tank,Fighter,"Fighter, Assassin",Marksman,0,1,1
7712,Tank,Marksman,"Fighter, Assassin",Fighter,1,0,1
7713,"Fighter, Tank","Mage, Fighter","Mage, Fighter","Fighter, Tank",1,0,1
2994,"Tank, Fighter","Mage, Assassin","Fighter, Tank","Mage, Fighter",1,0,1
7736,"Fighter, Assassin","Assassin, Fighter","Tank, Mage","Fighter, Assassin",1,0,1
2992,Marksman,Tank,Fighter,"Fighter, Tank",1,0,1
7734,"Tank, Mage",Assassin,"Tank, Fighter","Fighter, Assassin",0,1,1
7733,"Mage, Fighter",Fighter,"Tank, Mage","Mage, Fighter",0,1,1
7732,"Fighter, Mage","Assassin, Fighter","Fighter, Mage","Assassin, Fighter",1,0,1
7731,"Tank, Fighter","Assassin, Mage","Fighter, Tank",Marksman,0,1,1
7730,"Tank, Fighter","Assassin, Fighter","Tank, Mage","Support, Mage",0,1,1
7729,Tank,"Assassin, Fighter","Fighter, Marksman",Fighter,1,0,1
7728,"Tank, Mage","Assassin, Fighter","Mage, Fighter","Fighter, Assassin",1,0,1
7727,"Tank, Mage",Marksman,Tank,"Assassin, Mage",0,1,1
7726,Tank,"Assassin, Mage","Fighter, Mage","Fighter, Assassin",1,0,1
7725,"Fighter, Marksman","Support, Mage","Fighter, Mage",Marksman,1,0,1
7724,"Tank, Mage","Fighter, Tank","Fighter, Marksman",Marksman,1,0,1
7723,"Tank, Fighter","Assassin, Fighter",Tank,Marksman,1,0,1
7722,"Mage, Marksman","Assassin, Fighter",Tank,Marksman,0,1,1
7721,Mage,"Fighter, Assassin","Fighter, Tank","Fighter, Mage",0,1,1
7720,"Mage, Fighter","Fighter, Tank","Fighter, Tank",Fighter,0,1,1
7719,"Fighter, Tank","Fighter, Tank","Fighter, Assassin",Fighter,0,1,1
7717,"Fighter, Assassin",Fighter,Tank,Marksman,1,0,1
7716,"Mage, Fighter","Assassin, Fighter","Tank, Mage","Mage, Fighter",0,1,1
7715,"Fighter, Assassin",Fighter,"Support, Tank","Fighter, Assassin",1,0,1
7686,"Tank, Mage",Marksman,"Fighter, Tank","Fighter, Assassin",0,1,1
7684,"Mage, Marksman","Fighter, Mage","Fighter, Marksman","Mage, Fighter",1,0,1
7626,"Tank, Fighter","Assassin, Fighter",Tank,"Fighter, Mage",1,0,1
3012,"Tank, Fighter","Support, Tank","Mage, Fighter","Mage, Marksman",1,0,1
7654,"Fighter, Mage","Fighter, Mage","Fighter, Tank","Mage, Fighter",0,1,1
7653,"Tank, Fighter","Tank, Fighter",Tank,"Assassin, Fighter",1,0,1
7652,Tank,"Mage, Fighter","Fighter, Mage","Fighter, Mage",1,0,1
7651,"Fighter, Tank","Assassin, Mage","Tank, Fighter","Fighter, Mage",0,1,1
7650,"Fighter, Tank","Tank, Fighter","Fighter, Tank","Fighter, Tank",1,0,1
7648,Fighter,"Tank, Fighter",Tank,"Assassin, Fighter",1,0,1
7645,"Fighter, Tank","Mage, Fighter","Tank, Fighter",Assassin,1,0,1
7644,"Fighter, Tank","Mage, Fighter","Fighter, Mage","Support, Mage",0,1,1
7643,"Fighter, Tank",Marksman,"Fighter, Tank","Assassin, Mage",0,1,1
7642,"Fighter, Mage","Fighter, Mage","Tank, Fighter",Marksman,0,1,1
7640,"Tank, Fighter","Support, Mage","Fighter, Mage","Assassin, Fighter",1,0,1
7683,"Mage, Marksman","Fighter, Assassin","Fighter, Assassin","Fighter, Mage",0,1,1
7639,"Mage, Marksman","Fighter, Assassin","Fighter, Tank","Support, Mage",0,1,1
7638,"Tank, Fighter","Support, Mage",Tank,Marksman,0,1,1
7635,"Assassin, Fighter","Fighter, Mage","Tank, Fighter","Fighter, Assassin",0,1,1
7634,"Tank, Fighter","Fighter, Assassin","Tank, Mage","Mage, Fighter",1,0,1
3015,"Fighter, Tank","Mage, Assassin","Tank, Fighter","Tank, Mage",0,1,1
7631,Tank,"Assassin, Fighter",Fighter,"Fighter, Mage",0,1,1
7630,"Fighter, Mage","Tank, Fighter","Tank, Fighter",Fighter,0,1,1
7629,"Tank, Mage","Assassin, Fighter","Fighter, Mage","Assassin, Mage",0,1,1
7628,"Tank, Fighter","Assassin, Fighter","Fighter, Tank","Assassin, Mage",1,0,1
7627,"Fighter, Tank","Tank, Fighter",Tank,"Assassin, Fighter",1,0,1
7655,"Fighter, Mage","Fighter, Tank","Mage, Fighter","Assassin, Fighter",1,0,1
7656,Tank,"Assassin, Fighter","Tank, Fighter","Fighter, Tank",0,1,1
7657,Tank,"Mage, Fighter","Fighter, Assassin","Assassin, Fighter",1,0,1
7658,"Fighter, Assassin","Mage, Fighter","Tank, Mage","Support, Mage",0,1,1
7682,"Mage, Marksman","Assassin, Fighter","Fighter, Marksman","Fighter, Mage",1,0,1
7681,"Mage, Marksman","Fighter, Tank","Fighter, Tank","Assassin, Fighter",1,0,1
3001,"Fighter, Tank","Support, Fighter","Assassin, Fighter","Mage, Assassin",1,0,1
7678,Tank,"Support, Mage","Fighter, Mage","Tank, Fighter",1,0,1
7677,"Fighter, Marksman","Fighter, Assassin","Tank, Mage","Tank, Fighter",1,0,1
7676,"Fighter, Assassin","Fighter, Assassin",Tank,"Fighter, Mage",1,0,1
3004,"Assassin, Fighter","Mage, Marksman","Fighter, Assassin","Mage, Fighter",1,0,1
7673,"Fighter, Marksman","Fighter, Assassin","Mage, Marksman","Support, Mage",1,0,1
7672,"Mage, Marksman","Support, Mage","Tank, Mage","Assassin, Fighter",0,1,1
3006,Marksman,"Mage, Support","Support, Mage","Mage, Assassin",0,1,1
7670,"Mage, Marksman","Fighter, Mage","Tank, Fighter","Mage, Fighter",1,0,1
7669,"Fighter, Tank","Tank, Fighter","Fighter, Mage",Marksman,1,0,1
7668,"Fighter, Marksman","Mage, Fighter","Mage, Marksman","Fighter, Assassin",0,1,1
7666,"Mage, Marksman","Fighter, Mage","Tank, Fighter",Fighter,1,0,1
7665,"Mage, Marksman",Fighter,"Fighter, Mage","Assassin, Fighter",0,1,1
3008,"Assassin, Fighter","Support, Fighter",Marksman,Marksman,1,0,1
7663,Tank,"Fighter, Assassin","Fighter, Mage","Tank, Fighter",1,0,1
7662,"Tank, Fighter",Fighter,Tank,"Assassin, Fighter",1,0,1
7661,Tank,"Fighter, Tank","Fighter, Tank","Fighter, Assassin",1,0,1
7660,"Mage, Marksman","Assassin, Fighter","Fighter, Marksman",Fighter,1,0,1
7659,"Mage, Marksman","Tank, Fighter","Fighter, Tank","Fighter, Assassin",0,1,1
7519,"Fighter, Assassin",Fighter,"Assassin, Fighter","Mage, Fighter",0,1,1
7518,"Fighter, Mage",Fighter,"Assassin, Fighter","Fighter, Tank",0,1,1
7517,Marksman,"Mage, Fighter","Fighter, Tank","Fighter, Mage",0,1,1
7376,"Fighter, Mage","Mage, Fighter","Fighter, Assassin","Assassin, Fighter",1,0,1
7387,Marksman,"Fighter, Assassin","Tank, Fighter",Fighter,1,0,1
7386,Marksman,"Tank, Fighter","Tank, Fighter","Fighter, Mage",0,1,1
7384,Tank,Marksman,"Mage, Fighter",Fighter,0,1,1
7383,"Fighter, Assassin","Assassin, Fighter",Tank,"Mage, Fighter",1,0,1
7382,"Fighter, Tank",Marksman,"Mage, Marksman","Mage, Fighter",1,0,1
3073,"Tank, Fighter","Mage, Support","Mage, Fighter","Tank, Fighter",0,1,1
7380,"Fighter, Tank","Fighter, Tank","Mage, Fighter",Fighter,0,1,1
7379,Mage,"Fighter, Tank","Fighter, Mage",Fighter,0,1,1
7378,"Fighter, Mage","Assassin, Fighter","Fighter, Marksman","Fighter, Mage",1,0,1
3074,"Fighter, Assassin","Support, Mage","Tank, Fighter","Tank, Fighter",0,1,1
7375,"Assassin, Fighter",Fighter,"Fighter, Mage","Fighter, Tank",1,0,1
7363,"Tank, Fighter","Fighter, Assassin",Tank,"Support, Mage",0,1,1
3075,Fighter,Support,"Mage, Fighter","Support, Fighter",1,0,1
7373,"Fighter, Mage","Fighter, Tank","Fighter, Tank","Mage, Fighter",0,1,1
7372,"Fighter, Tank","Assassin, Fighter","Assassin, Fighter","Mage, Fighter",0,1,1
7371,"Fighter, Marksman","Fighter, Tank",Tank,"Fighter, Mage",0,1,1
7370,"Tank, Mage","Fighter, Assassin","Mage, Marksman","Assassin, Fighter",0,1,1
7369,"Fighter, Mage","Support, Mage","Fighter, Tank",Marksman,1,0,1
7368,Tank,"Support, Mage",Fighter,"Fighter, Mage",0,1,1
7367,Assassin,"Mage, Fighter","Fighter, Assassin",Marksman,0,1,1
7366,"Tank, Mage","Mage, Fighter","Mage, Marksman","Assassin, Fighter",1,0,1
7365,"Fighter, Mage",Marksman,"Tank, Mage","Tank, Fighter",0,1,1
7388,Marksman,"Assassin, Fighter","Tank, Fighter","Fighter, Assassin",0,1,1
7389,"Marksman, Fighter","Assassin, Fighter","Fighter, Assassin","Fighter, Mage",0,1,1
7390,Fighter,"Mage, Fighter","Marksman, Fighter","Fighter, Assassin",0,1,1
3070,"Mage, Fighter","Tank, Support","Tank, Fighter","Tank, Fighter",0,1,1
7413,Tank,"Fighter, Assassin",Fighter,Fighter,1,0,1
7412,"Fighter, Mage","Fighter, Assassin",Tank,Fighter,1,0,1
3065,"Assassin, Fighter","Mage, Marksman","Assassin, Fighter","Assassin, Mage",1,0,1
7410,Assassin,"Fighter, Tank","Fighter, Assassin",Fighter,0,1,1
7409,"Assassin, Fighter",Marksman,"Fighter, Tank",Marksman,1,0,1
7408,"Tank, Mage",Marksman,"Fighter, Tank",Marksman,1,0,1
7407,Tank,"Fighter, Mage",Fighter,"Fighter, Mage",0,1,1
7406,Tank,"Fighter, Tank","Fighter, Assassin",Marksman,0,1,1
7405,"Mage, Assassin","Fighter, Tank","Fighter, Tank",Fighter,1,0,1
7404,"Tank, Fighter",Marksman,"Assassin, Fighter","Fighter, Mage",1,0,1
3067,"Mage, Fighter",Support,"Assassin, Fighter","Mage, Support",1,0,1
7402,"Fighter, Tank",Marksman,"Assassin, Fighter","Fighter, Assassin",1,0,1
7401,"Tank, Fighter",Marksman,"Fighter, Tank",Marksman,0,1,1
7400,"Fighter, Tank","Support, Mage","Fighter, Mage","Assassin, Fighter",0,1,1
3068,"Tank, Fighter","Mage, Fighter","Fighter, Assassin",Mage,0,1,1
7398,"Fighter, Tank","Fighter, Tank",Tank,"Mage, Fighter",0,1,1
7396,"Fighter, Tank","Mage, Fighter","Assassin, Fighter","Fighter, Assassin",0,1,1
7395,"Assassin, Fighter","Fighter, Mage","Fighter, Marksman","Fighter, Assassin",1,0,1
7394,"Assassin, Fighter",Marksman,"Assassin, Fighter",Fighter,0,1,1
7393,"Assassin, Fighter","Mage, Fighter","Assassin, Fighter",Fighter,1,0,1
7392,"Fighter, Assassin",Marksman,"Assassin, Fighter","Fighter, Mage",0,1,1
3077,"Tank, Fighter",Mage,"Assassin, Fighter","Tank, Fighter",1,0,1
7362,"Fighter, Mage","Tank, Fighter","Tank, Fighter","Assassin, Fighter",1,0,1
7516,"Fighter, Assassin","Assassin, Mage","Fighter, Tank","Mage, Fighter",0,1,1
3089,"Tank, Fighter","Tank, Support","Mage, Fighter",Support,1,0,1
7332,"Tank, Mage",Marksman,Fighter,"Support, Mage",0,1,1
7329,"Fighter, Marksman","Fighter, Assassin","Tank, Fighter","Assassin, Fighter",1,0,1
7328,Fighter,"Fighter, Assassin",Tank,"Assassin, Fighter",1,0,1
7327,Tank,"Assassin, Fighter",Fighter,"Support, Mage",1,0,1
7326,"Fighter, Assassin","Support, Mage","Tank, Mage",Marksman,0,1,1
7325,"Fighter, Mage","Fighter, Tank","Tank, Mage","Support, Mage",1,0,1
3087,"Tank, Fighter","Tank, Mage","Fighter, Assassin",Mage,0,1,1
3088,"Assassin, Fighter","Mage, Fighter","Tank, Fighter","Mage, Support",1,0,1
7322,Fighter,"Support, Mage",Tank,"Fighter, Assassin",1,0,1
7321,Tank,"Support, Mage","Fighter, Tank","Fighter, Mage",1,0,1
7319,"Tank, Fighter","Assassin, Fighter","Tank, Fighter","Fighter, Tank",1,0,1
7361,"Fighter, Mage","Support, Mage","Fighter, Mage",Marksman,1,0,1
7318,"Tank, Mage",Fighter,Tank,Marksman,1,0,1
3091,"Fighter, Assassin","Support, Fighter","Fighter, Assassin","Mage, Support",0,1,1
7316,Tank,Fighter,"Fighter, Marksman","Assassin, Fighter",1,0,1
7315,"Fighter, Mage","Assassin, Fighter",Tank,"Fighter, Tank",1,0,1
7314,Tank,"Support, Mage","Tank, Mage","Fighter, Assassin",1,0,1
7313,Tank,"Mage, Fighter","Fighter, Marksman","Support, Mage",0,1,1
7312,"Tank, Mage","Support, Mage","Tank, Fighter","Mage, Fighter",1,0,1
7311,"Fighter, Tank","Support, Mage",Tank,"Assassin, Fighter",1,0,1
7310,"Fighter, Tank","Fighter, Tank",Tank,"Support, Mage",0,1,1
7309,Tank,Fighter,"Fighter, Assassin","Support, Mage",1,0,1
3083,"Assassin, Fighter","Mage, Marksman","Tank, Fighter",Mage,1,0,1
7334,"Fighter, Mage","Fighter, Tank","Tank, Fighter","Tank, Fighter",0,1,1
7336,"Tank, Fighter","Fighter, Mage",Tank,"Fighter, Tank",0,1,1
7337,"Fighter, Assassin","Fighter, Tank","Fighter, Mage","Assassin, Fighter",1,0,1
7360,"Mage, Marksman","Assassin, Fighter","Fighter, Mage",Marksman,1,0,1
7359,Tank,"Assassin, Fighter","Fighter, Mage",Fighter,1,0,1
7358,"Fighter, Tank",Assassin,"Fighter, Mage","Fighter, Tank",0,1,1
7357,"Fighter, Mage",Assassin,"Fighter, Tank","Fighter, Mage",0,1,1
3078,"Assassin, Fighter",Mage,"Tank, Fighter","Support, Fighter",0,1,1
7355,"Tank, Fighter",Marksman,"Assassin, Fighter","Fighter, Assassin",1,0,1
7354,"Marksman, Assassin","Mage, Fighter","Fighter, Mage","Fighter, Assassin",0,1,1
7353,"Mage, Marksman","Mage, Fighter",Tank,Marksman,0,1,1
7352,Tank,"Assassin, Fighter","Mage, Marksman","Mage, Fighter",0,1,1
7351,Tank,"Fighter, Assassin",Fighter,"Mage, Fighter",0,1,1
7350,"Fighter, Marksman","Tank, Fighter",Tank,"Assassin, Fighter",0,1,1
7349,"Mage, Marksman","Fighter, Assassin","Fighter, Mage","Assassin, Fighter",1,0,1
7348,Tank,"Fighter, Tank","Fighter, Mage","Fighter, Assassin",0,1,1
7347,"Fighter, Mage","Fighter, Tank","Fighter, Mage","Assassin, Fighter",0,1,1
7346,"Fighter, Tank","Fighter, Assassin",Fighter,Fighter,0,1,1
7345,"Fighter, Marksman",Fighter,"Fighter, Mage","Fighter, Tank",0,1,1
7344,"Fighter, Mage","Mage, Fighter","Fighter, Mage",Fighter,1,0,1
7343,"Tank, Mage","Mage, Fighter","Fighter, Mage","Fighter, Mage",1,0,1
3079,"Fighter, Mage","Tank, Mage",Fighter,"Support, Tank",1,0,1
7339,Tank,"Tank, Fighter",Fighter,"Fighter, Mage",1,0,1
7338,Tank,"Assassin, Fighter","Mage, Marksman","Support, Mage",1,0,1
7414,"Fighter, Mage","Assassin, Fighter","Mage, Marksman",Fighter,1,0,1
7415,"Fighter, Mage","Support, Mage",Tank,"Fighter, Assassin",1,0,1
7416,Tank,"Fighter, Mage",Fighter,"Assassin, Fighter",1,0,1
7480,"Tank, Mage","Fighter, Mage","Mage, Fighter","Fighter, Assassin",1,0,1
7490,"Fighter, Assassin","Mage, Fighter","Fighter, Assassin","Tank, Fighter",1,0,1
7489,Mage,"Fighter, Assassin",Tank,"Assassin, Fighter",1,0,1
7488,"Support, Mage","Tank, Mage","Fighter, Tank","Fighter, Mage",0,1,1
7487,"Tank, Fighter","Fighter, Assassin","Fighter, Assassin","Fighter, Tank",0,1,1
3054,"Tank, Fighter",Marksman,"Fighter, Assassin","Mage, Assassin",1,0,1
7485,"Mage, Tank","Tank, Fighter","Tank, Mage","Fighter, Assassin",0,1,1
7484,Tank,"Assassin, Mage","Fighter, Tank","Assassin, Fighter",0,1,1
7483,Tank,"Assassin, Mage","Fighter, Tank","Mage, Fighter",0,1,1
7482,"Fighter, Tank","Assassin, Fighter",Tank,"Assassin, Mage",1,0,1
7481,"Tank, Fighter","Fighter, Mage","Tank, Mage","Assassin, Mage",1,0,1
7479,Tank,"Assassin, Mage",Fighter,"Fighter, Mage",1,0,1
7417,"Mage, Marksman","Fighter, Mage","Fighter, Tank","Assassin, Fighter",0,1,1
7478,"Tank, Mage","Assassin, Mage","Tank, Fighter","Fighter, Mage",0,1,1
3055,"Tank, Fighter","Mage, Marksman","Tank, Fighter","Mage, Support",1,0,1
3056,Marksman,"Support, Fighter","Assassin, Fighter","Mage, Assassin",1,0,1
7475,"Tank, Mage","Assassin, Fighter",Mage,"Assassin, Fighter",0,1,1
3057,"Tank, Fighter","Mage, Assassin","Assassin, Fighter","Mage, Marksman",1,0,1
7473,"Marksman, Fighter","Assassin, Fighter","Tank, Fighter","Fighter, Assassin",1,0,1
7472,"Tank, Fighter","Assassin, Fighter",Marksman,Fighter,0,1,1
7471,"Tank, Fighter","Fighter, Mage","Assassin, Fighter","Fighter, Mage",0,1,1
7470,"Tank, Fighter","Assassin, Fighter",Fighter,"Assassin, Fighter",1,0,1
7469,Fighter,Fighter,"Fighter, Assassin","Fighter, Mage",0,1,1
7491,"Support, Mage","Mage, Fighter","Fighter, Tank","Tank, Fighter",1,0,1
7492,"Mage, Fighter","Fighter, Assassin","Tank, Mage",Fighter,0,1,1
7493,"Support, Mage","Assassin, Fighter","Tank, Mage","Mage, Fighter",0,1,1
7494,"Fighter, Mage","Fighter, Mage",Tank,"Mage, Fighter",1,0,1
3047,"Fighter, Mage","Support, Tank","Fighter, Assassin",Support,1,0,1
7514,"Fighter, Tank",Marksman,Mage,"Assassin, Fighter",1,0,1
7513,Mage,Fighter,"Mage, Fighter",Marksman,1,0,1
7512,"Fighter, Assassin","Fighter, Mage",Mage,Fighter,0,1,1
7511,"Mage, Fighter",Fighter,"Fighter, Tank","Assassin, Fighter",0,1,1
7510,Tank,Fighter,"Mage, Fighter",Marksman,1,0,1
7509,Mage,Marksman,"Fighter, Tank","Mage, Fighter",1,0,1
7508,Tank,Marksman,"Fighter, Assassin","Assassin, Mage",0,1,1
3048,"Tank, Fighter","Mage, Assassin","Assassin, Fighter","Tank, Mage",1,0,1
7506,"Mage, Fighter",Fighter,"Fighter, Assassin","Fighter, Tank",1,0,1
3052,"Assassin, Fighter","Mage, Fighter","Fighter, Assassin","Mage, Marksman",1,0,1
7504,Tank,Marksman,"Fighter, Assassin","Fighter, Tank",0,1,1
7503,"Fighter, Tank",Fighter,"Mage, Fighter","Fighter, Mage",0,1,1
7502,"Fighter, Tank","Fighter, Tank",Tank,"Fighter, Tank",1,0,1
7501,"Fighter, Assassin","Assassin, Fighter","Mage, Fighter",Fighter,1,0,1
3053,"Fighter, Assassin","Mage, Marksman","Tank, Fighter","Mage, Assassin",0,1,1
7499,"Mage, Tank","Assassin, Fighter","Mage, Fighter",Fighter,0,1,1
7498,"Fighter, Assassin",Marksman,"Fighter, Assassin",Fighter,1,0,1
7497,"Support, Mage","Fighter, Assassin","Fighter, Assassin","Fighter, Tank",0,1,1
7496,"Fighter, Tank","Fighter, Tank","Assassin, Fighter","Mage, Fighter",0,1,1
7495,Tank,"Assassin, Mage","Fighter, Mage","Fighter, Mage",0,1,1
7468,"Tank, Fighter",Marksman,"Marksman, Fighter","Fighter, Mage",1,0,1
7467,"Tank, Fighter",Marksman,"Support, Mage","Fighter, Assassin",0,1,1
7466,"Tank, Fighter","Mage, Fighter","Fighter, Support","Fighter, Mage",0,1,1
7441,Fighter,"Fighter, Mage","Fighter, Assassin","Mage, Fighter",1,0,1
7439,"Mage, Assassin","Fighter, Tank",Tank,"Fighter, Mage",1,0,1
7438,"Fighter, Assassin","Fighter, Tank",Fighter,"Assassin, Fighter",1,0,1
7437,"Fighter, Assassin","Fighter, Mage","Support, Tank","Fighter, Tank",1,0,1
7436,Tank,Fighter,"Support, Tank","Fighter, Mage",1,0,1
3060,"Fighter, Tank","Tank, Mage","Tank, Fighter","Mage, Support",1,0,1
3061,"Tank, Fighter","Mage, Fighter","Assassin, Fighter","Mage, Marksman",1,0,1
7433,Tank,"Fighter, Mage",Mage,Fighter,1,0,1
7432,"Fighter, Tank",Marksman,Fighter,Fighter,0,1,1
7431,"Fighter, Tank","Fighter, Mage","Mage, Support",Fighter,0,1,1
7430,"Mage, Fighter","Fighter, Tank","Fighter, Tank","Assassin, Fighter",0,1,1
3062,"Assassin, Fighter","Tank, Mage","Assassin, Fighter","Mage, Marksman",0,1,1
7428,Tank,Fighter,"Fighter, Mage","Fighter, Tank",0,1,1
7427,"Fighter, Assassin","Fighter, Tank","Fighter, Mage",Fighter,1,0,1
7426,"Fighter, Assassin","Assassin, Fighter","Support, Tank",Fighter,1,0,1
7425,"Fighter, Tank","Assassin, Fighter","Fighter, Assassin","Fighter, Tank",0,1,1
7424,Mage,"Fighter, Tank","Fighter, Tank",Fighter,0,1,1
7423,Tank,Fighter,Fighter,"Fighter, Tank",0,1,1
7422,"Mage, Support",Fighter,"Fighter, Tank",Marksman,1,0,1
7421,Tank,"Fighter, Mage","Fighter, Assassin","Assassin, Fighter",0,1,1
7419,"Fighter, Tank",Marksman,Fighter,"Assassin, Fighter",0,1,1
7418,Tank,"Fighter, Tank",Fighter,"Assassin, Fighter",1,0,1
7440,"Fighter, Assassin","Fighter, Mage",Fighter,"Fighter, Mage",1,0,1
7442,Tank,"Mage, Fighter",Fighter,"Fighter, Mage",0,1,1
7465,"Tank, Fighter","Fighter, Tank","Marksman, Fighter","Fighter, Mage",0,1,1
7443,Fighter,"Fighter, Tank","Fighter, Assassin","Fighter, Mage",0,1,1
7464,"Marksman, Fighter","Fighter, Mage","Fighter, Assassin","Fighter, Tank",0,1,1
7463,"Tank, Fighter","Assassin, Fighter","Support, Tank","Fighter, Mage",1,0,1
7462,Fighter,Fighter,"Marksman, Fighter","Mage, Fighter",1,0,1
7461,"Support, Tank","Mage, Fighter",Marksman,Fighter,1,0,1
7460,"Tank, Fighter",Marksman,"Fighter, Assassin",Marksman,0,1,1
7459,"Tank, Fighter","Mage, Fighter","Marksman, Fighter",Fighter,1,0,1
7458,Tank,"Mage, Fighter",Fighter,"Assassin, Fighter",0,1,1
7457,"Support, Tank","Assassin, Fighter",Mage,Fighter,0,1,1
7456,Marksman,"Tank, Fighter","Fighter, Tank","Assassin, Fighter",1,0,1
7455,"Support, Tank",Marksman,"Mage, Fighter","Mage, Fighter",1,0,1
7454,"Tank, Fighter",Fighter,Marksman,"Mage, Fighter",1,0,1
7453,"Tank, Fighter",Marksman,Mage,"Assassin, Fighter",0,1,1
7452,"Fighter, Assassin","Fighter, Assassin","Marksman, Fighter","Mage, Fighter",0,1,1
7451,Fighter,Fighter,"Mage, Marksman","Mage, Fighter",1,0,1
7450,"Fighter, Assassin","Assassin, Fighter","Marksman, Fighter",Fighter,1,0,1
3058,"Support, Mage","Mage, Support",Fighter,"Support, Fighter",1,0,1
7448,"Tank, Fighter","Tank, Fighter",Fighter,Fighter,1,0,1
3059,"Fighter, Assassin","Tank, Fighter",Marksman,"Mage, Support",1,0,1
7446,"Marksman, Fighter","Mage, Fighter","Mage, Fighter",Fighter,0,1,1
7445,"Tank, Fighter","Tank, Fighter","Marksman, Fighter",Fighter,1,0,1
7444,"Fighter, Assassin","Fighter, Tank",Fighter,Fighter,1,0,1
6877,"Fighter, Mage","Fighter, Tank","Fighter, Tank","Fighter, Assassin",0,1,1
6876,"Fighter, Tank","Tank, Fighter",Tank,"Fighter, Tank",1,0,1
6875,"Fighter, Mage","Tank, Fighter",Tank,"Fighter, Assassin",1,0,1
6264,"Fighter, Marksman","Fighter, Assassin","Fighter, Assassin","Mage, Fighter",1,0,1
6275,"Tank, Mage","Fighter, Tank","Fighter, Assassin","Assassin, Fighter",0,1,1
6274,"Fighter, Tank","Fighter, Tank","Fighter, Support",Fighter,1,0,1
3442,"Fighter, Tank","Mage, Support","Support, Mage","Mage, Assassin",0,1,1
6272,Tank,"Fighter, Tank","Tank, Fighter","Fighter, Assassin",1,0,1
3444,"Fighter, Assassin","Tank, Fighter",Fighter,"Support, Mage",0,1,1
6269,"Tank, Fighter","Support, Mage","Tank, Mage","Assassin, Fighter",0,1,1
6268,"Fighter, Marksman",Fighter,"Tank, Fighter","Assassin, Fighter",0,1,1
6267,"Tank, Fighter","Support, Mage","Tank, Mage","Mage, Fighter",0,1,1
3445,"Assassin, Fighter",Marksman,Fighter,"Support, Tank",1,0,1
6265,"Tank, Mage","Fighter, Assassin","Tank, Fighter","Support, Mage",1,0,1
6263,"Mage, Marksman","Support, Mage",Tank,"Assassin, Fighter",0,1,1
3448,"Support, Mage","Support, Tank","Fighter, Assassin",Mage,0,1,1
6262,Fighter,"Fighter, Assassin",Tank,Marksman,0,1,1
3446,"Assassin, Fighter","Support, Tank","Fighter, Assassin",Marksman,1,0,1
6260,"Fighter, Assassin","Assassin, Fighter","Tank, Fighter","Mage, Fighter",0,1,1
3447,"Support, Mage",Marksman,"Mage, Fighter","Support, Tank",1,0,1
6258,Marksman,"Tank, Fighter","Tank, Fighter",Marksman,0,1,1
6257,"Fighter, Assassin","Mage, Fighter",Marksman,"Fighter, Mage",0,1,1
6256,"Fighter, Tank","Fighter, Assassin",Marksman,"Fighter, Mage",0,1,1
6255,"Fighter, Tank","Mage, Fighter","Mage, Support",Fighter,0,1,1
6254,"Fighter, Assassin","Tank, Mage","Tank, Fighter",Fighter,1,0,1
6253,"Marksman, Fighter","Fighter, Mage","Fighter, Tank",Marksman,0,1,1
6276,Tank,"Fighter, Tank","Fighter, Assassin","Support, Mage",1,0,1
6277,"Fighter, Tank","Support, Mage","Tank, Mage",Fighter,1,0,1
6278,"Fighter, Mage",Marksman,Tank,"Support, Mage",1,0,1
6279,Tank,"Assassin, Mage",Fighter,Marksman,1,0,1
6303,"Fighter, Assassin","Fighter, Tank",Tank,Fighter,0,1,1
6302,"Mage, Marksman","Fighter, Tank","Fighter, Tank",Marksman,0,1,1
6301,"Fighter, Assassin",Fighter,"Fighter, Mage","Mage, Fighter",0,1,1
6300,Tank,"Mage, Fighter","Support, Tank","Fighter, Mage",1,0,1
3433,"Support, Mage","Support, Tank","Assassin, Fighter","Support, Tank",1,0,1
6298,"Fighter, Tank",Marksman,"Tank, Mage","Fighter, Mage",0,1,1
6297,"Fighter, Tank",Marksman,"Tank, Mage","Mage, Fighter",1,0,1
6296,"Fighter, Tank",Fighter,"Mage, Fighter",Marksman,1,0,1
3434,"Assassin, Fighter","Support, Fighter","Support, Mage","Support, Tank",0,1,1
3436,"Fighter, Assassin","Tank, Support","Tank, Fighter",Mage,1,0,1
6292,"Tank, Fighter","Fighter, Mage","Fighter, Assassin","Fighter, Tank",0,1,1
6291,"Fighter, Tank","Fighter, Tank","Fighter, Assassin","Support, Mage",1,0,1
3437,Fighter,Marksman,"Support, Mage","Mage, Support",0,1,1
6289,"Tank, Mage","Support, Mage",Fighter,Marksman,1,0,1
3438,Fighter,"Tank, Support","Fighter, Assassin","Tank, Support",0,1,1
6287,"Fighter, Tank","Support, Mage",Tank,"Fighter, Assassin",1,0,1
3439,"Tank, Fighter","Support, Fighter","Tank, Fighter",Mage,0,1,1
6284,Tank,"Assassin, Fighter","Fighter, Assassin","Fighter, Assassin",0,1,1
6283,"Tank, Mage",Marksman,"Tank, Fighter","Support, Mage",1,0,1
6282,"Tank, Mage","Mage, Fighter","Fighter, Mage",Marksman,0,1,1
6280,"Fighter, Marksman","Fighter, Mage","Fighter, Mage","Support, Mage",0,1,1
6252,Marksman,"Fighter, Mage","Fighter, Tank","Mage, Fighter",0,1,1
6250,"Fighter, Assassin","Fighter, Mage","Mage, Fighter",Marksman,1,0,1
3430,Marksman,"Support, Tank","Fighter, Assassin",Support,1,0,1
6206,Assassin,"Tank, Fighter","Tank, Mage","Assassin, Fighter",1,0,1
6217,"Assassin, Fighter","Fighter, Assassin",Tank,"Mage, Fighter",0,1,1
6216,"Fighter, Assassin",Fighter,"Support, Mage","Fighter, Mage",1,0,1
6215,"Fighter, Mage","Mage, Fighter","Tank, Mage","Support, Mage",1,0,1
6214,Tank,Marksman,"Tank, Mage","Support, Mage",0,1,1
3468,"Fighter, Assassin","Fighter, Tank","Fighter, Mage","Mage, Assassin",1,0,1
6212,"Tank, Fighter","Tank, Mage","Tank, Mage",Fighter,0,1,1
3471,"Support, Mage","Support, Mage","Fighter, Assassin","Fighter, Tank",1,0,1
6209,"Fighter, Mage","Tank, Fighter","Tank, Fighter","Tank, Mage",1,0,1
6208,"Fighter, Tank","Tank, Mage",Tank,"Tank, Fighter",0,1,1
3472,"Fighter, Assassin","Support, Mage",Fighter,"Tank, Fighter",1,0,1
6205,"Tank, Mage","Fighter, Mage","Tank, Fighter","Tank, Mage",0,1,1
6249,"Fighter, Assassin",Marksman,"Marksman, Fighter","Assassin, Fighter",1,0,1
3473,Fighter,"Mage, Support","Fighter, Assassin","Support, Tank",0,1,1
6203,"Mage, Marksman","Tank, Fighter",Marksman,Fighter,0,1,1
3477,"Fighter, Assassin",Mage,"Fighter, Assassin","Tank, Support",1,0,1
3479,"Fighter, Assassin","Tank, Support","Fighter, Assassin","Support, Tank",1,0,1
6199,Tank,Fighter,"Tank, Fighter","Tank, Fighter",0,1,1
3480,"Tank, Fighter","Mage, Support","Tank, Fighter","Tank, Fighter",0,1,1
6197,"Fighter, Mage",Fighter,"Tank, Fighter","Fighter, Tank",0,1,1
6196,"Fighter, Assassin","Tank, Fighter","Tank, Mage","Tank, Fighter",0,1,1
6195,"Mage, Support","Tank, Fighter",Mage,Fighter,0,1,1
3481,"Tank, Fighter","Support, Mage","Tank, Fighter","Mage, Support",0,1,1
3466,"Tank, Fighter","Mage, Support",Fighter,"Support, Tank",0,1,1
6221,"Mage, Fighter","Fighter, Tank","Tank, Mage",Fighter,1,0,1
6222,"Tank, Mage",Fighter,"Assassin, Fighter","Mage, Fighter",1,0,1
6224,"Tank, Fighter","Fighter, Mage","Fighter, Tank","Fighter, Tank",1,0,1
6246,Marksman,Fighter,"Support, Mage","Mage, Fighter",1,0,1
6245,"Mage, Fighter",Fighter,"Mage, Support",Marksman,1,0,1
6244,"Fighter, Assassin","Fighter, Mage",Mage,"Assassin, Fighter",1,0,1
6243,Marksman,Fighter,"Tank, Fighter","Fighter, Mage",0,1,1
3453,"Tank, Fighter","Support, Tank",Fighter,"Mage, Assassin",0,1,1
3454,"Fighter, Mage","Support, Fighter","Fighter, Assassin","Tank, Support",0,1,1
3455,"Mage, Fighter","Support, Fighter","Support, Mage",Marksman,1,0,1
3456,"Assassin, Fighter","Support, Mage",Fighter,"Mage, Assassin",0,1,1
3457,Marksman,"Support, Mage","Mage, Fighter","Fighter, Support",1,0,1
6237,"Fighter, Mage","Mage, Fighter","Fighter, Assassin",Fighter,0,1,1
6236,"Fighter, Assassin","Mage, Fighter","Tank, Mage",Marksman,1,0,1
6234,Tank,"Assassin, Fighter","Fighter, Assassin","Mage, Fighter",1,0,1
6233,"Fighter, Tank","Assassin, Fighter","Mage, Fighter",Marksman,0,1,1
6232,"Mage, Fighter",Marksman,Tank,Fighter,0,1,1
6231,"Fighter, Mage",Fighter,Tank,"Mage, Fighter",0,1,1
6230,"Fighter, Tank","Fighter, Mage","Fighter, Tank","Fighter, Tank",0,1,1
3459,Fighter,"Mage, Support","Mage, Support",Mage,1,0,1
3460,"Fighter, Assassin","Tank, Support",Fighter,Mage,1,0,1
6227,"Mage, Fighter","Mage, Fighter","Tank, Fighter","Fighter, Mage",1,0,1
6226,"Assassin, Fighter","Assassin, Fighter","Fighter, Assassin","Mage, Fighter",1,0,1
6225,"Assassin, Fighter",Marksman,"Tank, Fighter","Tank, Mage",1,0,1
3432,Marksman,"Mage, Assassin",Fighter,"Support, Mage",0,1,1
3429,"Fighter, Mage",Tank,"Mage, Fighter","Support, Fighter",0,1,1
6418,"Fighter, Mage","Mage, Fighter",Mage,"Assassin, Fighter",1,0,1
3390,"Mage, Fighter","Tank, Fighter","Assassin, Fighter","Support, Mage",1,0,1
3389,"Fighter, Mage","Support, Tank","Fighter, Assassin","Support, Mage",0,1,1
6387,"Tank, Fighter",Marksman,"Mage, Marksman","Mage, Fighter",1,0,1
6386,Fighter,"Tank, Fighter",Tank,"Mage, Fighter",1,0,1
6385,"Fighter, Tank","Assassin, Mage","Mage, Tank","Mage, Fighter",0,1,1
6384,"Fighter, Tank","Assassin, Mage","Fighter, Support","Mage, Fighter",0,1,1
6383,"Fighter, Marksman","Fighter, Mage","Mage, Fighter","Mage, Fighter",1,0,1
6382,"Mage, Fighter",Marksman,"Fighter, Mage","Tank, Fighter",1,0,1
6381,Tank,Marksman,"Assassin, Fighter",Marksman,1,0,1
6380,"Tank, Mage",Marksman,Marksman,"Fighter, Mage",1,0,1
6379,"Mage, Fighter","Mage, Fighter","Assassin, Fighter",Marksman,1,0,1
6377,"Tank, Mage","Assassin, Fighter","Fighter, Tank","Fighter, Tank",0,1,1
6364,"Tank, Mage","Assassin, Fighter","Assassin, Mage","Tank, Fighter",1,0,1
3391,"Fighter, Assassin","Support, Tank","Support, Mage","Mage, Assassin",1,0,1
6375,Fighter,Fighter,"Fighter, Tank","Assassin, Fighter",1,0,1
3393,"Support, Mage","Tank, Support",Marksman,"Mage, Support",0,1,1
6372,"Support, Mage","Assassin, Fighter","Mage, Fighter","Fighter, Assassin",1,0,1
6371,"Tank, Mage","Assassin, Fighter","Support, Mage","Mage, Fighter",0,1,1
6370,"Mage, Fighter","Assassin, Fighter","Support, Mage","Fighter, Assassin",1,0,1
3394,Fighter,"Mage, Support",Marksman,"Tank, Support",0,1,1
6368,"Assassin, Fighter","Assassin, Fighter","Fighter, Assassin","Fighter, Assassin",1,0,1
6367,"Tank, Support","Fighter, Assassin","Tank, Mage","Assassin, Fighter",0,1,1
3395,Marksman,"Support, Mage","Assassin, Mage","Support, Tank",1,0,1
6389,"Tank, Fighter","Mage, Fighter","Fighter, Mage",Fighter,0,1,1
6390,"Tank, Fighter","Tank, Fighter","Fighter, Mage",Fighter,0,1,1
3386,"Mage, Fighter","Support, Tank","Support, Mage","Mage, Support",1,0,1
3385,"Mage, Fighter","Tank, Support","Tank, Fighter","Marksman, Support",0,1,1
6416,"Fighter, Mage","Tank, Fighter","Fighter, Tank","Mage, Fighter",0,1,1
3380,"Tank, Fighter","Mage, Assassin","Fighter, Assassin","Tank, Support",1,0,1
6413,"Support, Mage","Fighter, Mage","Tank, Fighter","Assassin, Fighter",0,1,1
6412,Fighter,"Mage, Fighter","Tank, Mage","Assassin, Fighter",1,0,1
6411,"Mage, Marksman","Mage, Fighter","Mage, Fighter","Fighter, Assassin",0,1,1
6410,"Tank, Mage","Fighter, Assassin","Assassin, Mage","Assassin, Fighter",0,1,1
6409,Mage,"Tank, Fighter","Fighter, Assassin","Mage, Fighter",1,0,1
6408,"Tank, Fighter","Mage, Support","Fighter, Mage","Assassin, Fighter",0,1,1
6407,"Fighter, Mage","Tank, Fighter","Support, Mage","Tank, Fighter",1,0,1
6406,"Fighter, Assassin","Fighter, Assassin",Mage,"Assassin, Fighter",0,1,1
6405,"Tank, Mage","Tank, Fighter","Assassin, Mage","Fighter, Assassin",1,0,1
6404,"Fighter, Assassin","Assassin, Fighter","Tank, Fighter","Tank, Fighter",1,0,1
6403,"Fighter, Tank","Fighter, Assassin","Fighter, Assassin","Tank, Fighter",0,1,1
6401,"Fighter, Assassin","Tank, Fighter","Tank, Fighter","Tank, Mage",0,1,1
6400,"Tank, Mage","Assassin, Fighter","Fighter, Assassin","Assassin, Fighter",0,1,1
6399,"Tank, Mage","Tank, Fighter","Fighter, Assassin","Assassin, Fighter",0,1,1
3384,"Tank, Fighter","Support, Mage","Assassin, Fighter","Tank, Support",1,0,1
6397,"Fighter, Assassin","Fighter, Assassin","Fighter, Tank","Support, Mage",1,0,1
6396,"Fighter, Mage","Tank, Fighter","Fighter, Assassin","Assassin, Fighter",0,1,1
6395,"Assassin, Fighter",Fighter,"Tank, Fighter","Fighter, Assassin",1,0,1
6394,"Mage, Fighter","Assassin, Fighter","Tank, Fighter","Assassin, Fighter",0,1,1
6365,"Assassin, Mage","Tank, Fighter","Mage, Fighter","Assassin, Fighter",0,1,1
6362,"Assassin, Mage","Assassin, Fighter","Fighter, Mage","Fighter, Assassin",0,1,1
6307,"Fighter, Tank","Assassin, Fighter","Tank, Fighter","Fighter, Tank",1,0,1
3423,"Mage, Fighter","Fighter, Tank","Tank, Fighter","Support, Tank",1,0,1
6330,"Tank, Fighter",Fighter,"Tank, Fighter","Tank, Fighter",0,1,1
6329,Mage,"Fighter, Assassin","Fighter, Marksman","Mage, Fighter",1,0,1
6328,"Fighter, Tank","Tank, Fighter","Assassin, Fighter","Fighter, Assassin",1,0,1
6327,"Fighter, Assassin","Tank, Fighter",Mage,"Tank, Fighter",0,1,1
6326,Mage,"Tank, Fighter","Tank, Mage","Fighter, Assassin",0,1,1
6325,"Assassin, Mage","Tank, Fighter","Fighter, Mage","Tank, Fighter",1,0,1
6324,Mage,Mage,"Fighter, Mage","Tank, Fighter",1,0,1
6323,"Assassin, Mage","Tank, Fighter",Mage,"Fighter, Assassin",0,1,1
6322,"Tank, Mage",Mage,Mage,"Tank, Fighter",0,1,1
6321,"Fighter, Mage","Mage, Fighter","Tank, Mage","Tank, Fighter",0,1,1
6319,"Tank, Fighter","Tank, Fighter","Tank, Mage","Fighter, Tank",1,0,1
6360,"Fighter, Mage","Fighter, Assassin","Assassin, Mage","Tank, Fighter",0,1,1
6318,"Fighter, Mage","Fighter, Assassin",Mage,"Tank, Fighter",1,0,1
6317,"Tank, Fighter","Support, Mage",Mage,"Fighter, Assassin",0,1,1
3424,Fighter,"Mage, Support","Mage, Fighter","Fighter, Tank",0,1,1
3427,"Tank, Fighter","Mage, Support","Support, Mage","Support, Mage",1,0,1
6313,Tank,"Fighter, Tank","Fighter, Assassin","Fighter, Mage",0,1,1
6312,"Fighter, Assassin","Fighter, Assassin","Fighter, Assassin","Mage, Fighter",0,1,1
6311,Marksman,"Tank, Mage","Fighter, Tank","Tank, Fighter",1,0,1
6310,"Fighter, Assassin",Marksman,Tank,"Fighter, Mage",0,1,1
6309,Fighter,Fighter,"Assassin, Fighter",Marksman,0,1,1
6308,"Fighter, Assassin","Mage, Fighter",Tank,"Assassin, Fighter",1,0,1
3422,"Assassin, Fighter",Support,"Fighter, Assassin","Support, Mage",1,0,1
3421,"Fighter, Mage","Support, Fighter","Support, Mage","Support, Fighter",1,0,1
6334,"Mage, Fighter","Assassin, Fighter","Tank, Mage","Fighter, Mage",0,1,1
3418,"Fighter, Mage","Tank, Fighter","Mage, Fighter","Mage, Support",0,1,1
3399,Marksman,"Support, Mage","Mage, Fighter","Support, Fighter",1,0,1
6358,"Tank, Fighter","Assassin, Fighter","Fighter, Marksman","Tank, Fighter",0,1,1
3400,"Assassin, Fighter",Support,Marksman,"Support, Tank",1,0,1
3401,"Fighter, Mage","Tank, Fighter","Fighter, Assassin","Support, Fighter",1,0,1
3402,"Fighter, Assassin",Support,"Tank, Fighter","Mage, Support",0,1,1
3403,"Fighter, Assassin","Support, Fighter","Fighter, Mage","Support, Mage",1,0,1
3404,"Fighter, Tank","Support, Fighter","Tank, Fighter",Support,0,1,1
3406,"Fighter, Tank","Support, Mage","Fighter, Tank","Support, Fighter",1,0,1
6350,"Tank, Fighter","Tank, Fighter","Fighter, Tank","Fighter, Tank",1,0,1
6349,Tank,"Fighter, Tank","Tank, Fighter","Tank, Fighter",0,1,1
6348,"Tank, Fighter","Assassin, Mage",Fighter,"Tank, Fighter",1,0,1
3410,"Fighter, Tank","Mage, Support","Assassin, Fighter","Support, Fighter",0,1,1
3411,"Fighter, Assassin","Support, Tank",Fighter,"Support, Mage",0,1,1
6344,Fighter,"Tank, Fighter","Fighter, Tank","Assassin, Mage",0,1,1
6343,"Fighter, Tank","Tank, Fighter","Tank, Fighter","Assassin, Fighter",1,0,1
6342,"Fighter, Mage","Tank, Fighter","Fighter, Assassin","Mage, Fighter",1,0,1
3412,"Tank, Fighter",Support,"Fighter, Tank","Support, Tank",0,1,1
3413,"Assassin, Fighter","Tank, Support","Assassin, Fighter","Support, Mage",0,1,1
3415,"Fighter, Mage","Mage, Support","Fighter, Tank","Tank, Fighter",1,0,1
6337,"Mage, Fighter","Mage, Fighter","Fighter, Tank","Assassin, Fighter",0,1,1
3417,"Fighter, Assassin","Support, Tank","Assassin, Fighter","Fighter, Tank",1,0,1
6193,"Support, Tank","Mage, Fighter","Fighter, Assassin",Fighter,0,1,1
6192,"Fighter, Tank",Marksman,"Mage, Fighter","Mage, Fighter",1,0,1
3482,Fighter,"Support, Mage","Fighter, Assassin","Tank, Fighter",0,1,1
6039,"Fighter, Assassin",Fighter,Tank,"Mage, Fighter",0,1,1
6049,"Fighter, Assassin","Fighter, Tank",Mage,Fighter,0,1,1
6048,"Mage, Fighter","Mage, Fighter","Fighter, Assassin",Marksman,1,0,1
3538,Fighter,"Tank, Fighter","Tank, Fighter",Mage,1,0,1
6046,Marksman,"Mage, Fighter","Tank, Fighter","Assassin, Fighter",0,1,1
3539,Fighter,Mage,"Assassin, Fighter","Support, Fighter",1,0,1
6044,Marksman,"Tank, Fighter","Fighter, Assassin",Fighter,0,1,1
6043,Mage,"Mage, Fighter","Mage, Marksman","Assassin, Fighter",1,0,1
6042,Marksman,"Mage, Fighter","Marksman, Fighter","Assassin, Fighter",1,0,1
6041,"Fighter, Assassin",Marksman,"Tank, Fighter","Fighter, Mage",0,1,1
6040,"Fighter, Assassin",Marksman,"Fighter, Assassin","Mage, Fighter",0,1,1
6038,"Fighter, Assassin","Mage, Fighter",Tank,"Assassin, Mage",1,0,1
3553,"Fighter, Mage","Mage, Support","Assassin, Fighter","Fighter, Tank",1,0,1
3540,"Tank, Fighter","Support, Fighter","Assassin, Fighter",Mage,1,0,1
6036,Tank,Fighter,"Fighter, Assassin","Fighter, Tank",1,0,1
6034,"Mage, Fighter",Marksman,"Assassin, Fighter","Fighter, Mage",0,1,1
3544,"Fighter, Assassin","Support, Fighter","Assassin, Fighter","Fighter, Tank",1,0,1
6026,"Assassin, Fighter","Mage, Fighter","Tank, Mage","Mage, Assassin",0,1,1
6025,"Tank, Fighter","Assassin, Fighter","Assassin, Fighter","Fighter, Mage",1,0,1
6024,"Mage, Fighter",Fighter,"Tank, Mage","Fighter, Assassin",1,0,1
3550,"Fighter, Mage","Support, Fighter",Marksman,"Fighter, Tank",0,1,1
6022,"Tank, Mage","Fighter, Tank","Assassin, Fighter",Fighter,0,1,1
3551,"Assassin, Fighter","Fighter, Tank","Fighter, Tank","Support, Fighter",0,1,1
6050,"Support, Mage","Fighter, Mage","Assassin, Fighter","Fighter, Tank",0,1,1
6051,"Mage, Fighter","Fighter, Tank","Assassin, Mage",Fighter,1,0,1
6053,"Fighter, Assassin","Tank, Mage","Fighter, Tank","Tank, Fighter",0,1,1
6054,Mage,Marksman,"Marksman, Fighter","Mage, Fighter",0,1,1
6076,"Fighter, Tank","Assassin, Fighter","Fighter, Mage","Support, Mage",1,0,1
3527,"Fighter, Assassin","Tank, Support","Assassin, Fighter","Support, Mage",1,0,1
3529,"Assassin, Fighter","Tank, Fighter","Assassin, Mage","Support, Fighter",0,1,1
6073,"Tank, Fighter","Support, Mage","Tank, Mage","Fighter, Assassin",0,1,1
3530,"Assassin, Mage",Mage,Fighter,"Tank, Fighter",1,0,1
6071,"Fighter, Mage","Fighter, Assassin","Assassin, Fighter","Assassin, Fighter",0,1,1
6070,"Mage, Marksman","Tank, Fighter","Fighter, Tank","Assassin, Fighter",0,1,1
6069,"Assassin, Fighter","Fighter, Mage","Tank, Fighter","Mage, Fighter",1,0,1
3531,"Fighter, Mage","Tank, Support","Assassin, Fighter",Tank,0,1,1
3532,"Assassin, Mage","Tank, Support","Fighter, Mage","Support, Fighter",0,1,1
6066,"Tank, Fighter","Assassin, Fighter",Tank,"Fighter, Tank",1,0,1
3533,"Tank, Fighter","Tank, Support","Assassin, Mage","Support, Fighter",1,0,1
6064,"Fighter, Assassin",Fighter,"Tank, Fighter","Marksman, Fighter",0,1,1
6062,Fighter,"Assassin, Fighter","Marksman, Fighter","Mage, Fighter",0,1,1
3535,"Tank, Fighter","Support, Mage","Mage, Fighter","Support, Mage",1,0,1
6060,Mage,"Mage, Fighter","Support, Mage",Fighter,0,1,1
6059,"Marksman, Fighter","Mage, Fighter","Tank, Fighter",Fighter,0,1,1
6058,"Tank, Fighter","Fighter, Mage",Fighter,"Assassin, Fighter",1,0,1
6057,"Fighter, Assassin","Assassin, Fighter","Fighter, Tank",Fighter,1,0,1
6056,"Tank, Fighter","Fighter, Assassin",Tank,"Fighter, Mage",1,0,1
6055,Marksman,"Fighter, Mage","Tank, Fighter","Assassin, Fighter",1,0,1
3552,"Assassin, Fighter","Support, Mage","Mage, Fighter","Fighter, Tank",1,0,1
6018,"Fighter, Mage","Assassin, Mage","Fighter, Tank","Tank, Fighter",0,1,1
6190,"Fighter, Tank","Mage, Fighter","Support, Tank","Tank, Fighter",0,1,1
5980,"Fighter, Tank","Tank, Fighter",Mage,"Fighter, Tank",0,1,1
3563,Marksman,"Support, Fighter","Fighter, Tank","Tank, Support",0,1,1
5989,Mage,"Mage, Fighter",Tank,Marksman,0,1,1
5988,Fighter,Fighter,Mage,"Mage, Fighter",1,0,1
5987,"Mage, Fighter",Fighter,Mage,"Mage, Fighter",1,0,1
3564,"Fighter, Tank","Support, Fighter","Assassin, Fighter","Fighter, Tank",1,0,1
5985,"Fighter, Assassin","Mage, Fighter","Marksman, Fighter",Marksman,0,1,1
3565,"Fighter, Mage","Fighter, Tank","Fighter, Assassin","Tank, Support",1,0,1
3566,"Fighter, Tank","Mage, Assassin",Fighter,"Support, Fighter",1,0,1
5982,Tank,"Mage, Fighter","Support, Tank",Fighter,0,1,1
5981,"Fighter, Assassin",Marksman,"Support, Mage",Fighter,1,0,1
5979,"Fighter, Tank",Fighter,Mage,Marksman,0,1,1
3554,Fighter,"Fighter, Tank","Mage, Fighter","Mage, Support",0,1,1
5978,"Support, Tank","Fighter, Assassin",Tank,Fighter,0,1,1
3568,"Fighter, Tank","Mage, Assassin","Fighter, Assassin","Support, Mage",1,0,1
5975,"Assassin, Fighter","Tank, Fighter",Tank,"Fighter, Mage",0,1,1
5974,Tank,"Fighter, Mage","Fighter, Mage",Fighter,0,1,1
5973,"Tank, Mage",Fighter,Tank,"Fighter, Mage",1,0,1
5972,Tank,"Tank, Fighter","Fighter, Tank","Assassin, Mage",1,0,1
5971,"Mage, Fighter","Assassin, Fighter","Fighter, Mage","Tank, Fighter",1,0,1
3570,"Fighter, Tank","Support, Fighter","Fighter, Tank","Support, Tank",1,0,1
5968,"Tank, Mage","Fighter, Mage","Fighter, Tank","Assassin, Mage",0,1,1
5967,Tank,Marksman,"Mage, Fighter","Fighter, Assassin",1,0,1
3562,"Fighter, Tank","Support, Fighter","Mage, Fighter","Support, Tank",1,0,1
5992,Tank,Marksman,"Tank, Fighter",Marksman,1,0,1
5993,"Marksman, Fighter",Marksman,Fighter,Fighter,1,0,1
3561,"Mage, Fighter","Support, Mage","Fighter, Tank","Support, Fighter",0,1,1
6016,"Tank, Mage",Fighter,"Mage, Tank","Fighter, Mage",1,0,1
6015,"Fighter, Mage","Fighter, Mage","Mage, Fighter",Fighter,1,0,1
3555,"Fighter, Tank","Support, Tank","Fighter, Mage","Fighter, Tank",0,1,1
6013,"Fighter, Tank","Assassin, Mage",Tank,"Fighter, Mage",1,0,1
6012,Tank,"Tank, Mage","Assassin, Fighter",Fighter,0,1,1
6011,Tank,"Assassin, Mage","Fighter, Tank","Fighter, Mage",0,1,1
6010,"Fighter, Mage","Fighter, Tank","Fighter, Tank","Assassin, Mage",1,0,1
6009,Tank,"Tank, Fighter","Fighter, Tank",Fighter,1,0,1
6008,"Mage, Fighter","Assassin, Mage",Tank,"Assassin, Fighter",0,1,1
6007,"Tank, Mage","Fighter, Tank",Tank,"Fighter, Mage",0,1,1
6006,"Fighter, Tank","Fighter, Mage","Support, Mage",Fighter,1,0,1
3556,"Tank, Fighter","Support, Tank",Fighter,"Fighter, Tank",0,1,1
6003,"Mage, Support","Tank, Fighter","Fighter, Mage",Fighter,0,1,1
3558,"Mage, Fighter","Support, Fighter","Fighter, Tank","Tank, Support",0,1,1
6001,"Assassin, Fighter","Fighter, Mage","Tank, Mage","Tank, Fighter",1,0,1
6000,"Fighter, Tank","Tank, Fighter","Mage, Marksman","Fighter, Mage",1,0,1
5999,Mage,"Tank, Fighter","Fighter, Assassin","Tank, Mage",0,1,1
3559,Marksman,"Support, Mage",Fighter,"Fighter, Tank",1,0,1
3560,"Mage, Fighter","Support, Fighter","Fighter, Tank","Mage, Support",0,1,1
5996,"Fighter, Assassin","Tank, Fighter","Tank, Mage",Fighter,0,1,1
5995,"Fighter, Tank","Fighter, Mage",Mage,"Tank, Fighter",0,1,1
6077,"Tank, Mage","Fighter, Tank","Tank, Fighter","Mage, Fighter",0,1,1
6078,"Fighter, Mage","Tank, Fighter","Mage, Marksman","Assassin, Fighter",1,0,1
3526,"Mage, Fighter","Marksman, Support",Fighter,"Support, Tank",0,1,1
6151,Tank,"Mage, Fighter","Fighter, Mage",Marksman,1,0,1
3495,"Fighter, Assassin","Tank, Support","Fighter, Mage",Tank,1,0,1
6160,"Tank, Fighter",Marksman,"Fighter, Tank","Assassin, Mage",0,1,1
6159,"Fighter, Tank",Marksman,"Assassin, Fighter","Support, Mage",1,0,1
6158,"Tank, Fighter","Support, Mage",Tank,"Mage, Fighter",1,0,1
6157,Fighter,"Assassin, Fighter","Marksman, Support",Marksman,1,0,1
3496,"Fighter, Mage",Tank,Fighter,Mage,0,1,1
6155,"Fighter, Assassin","Assassin, Fighter","Mage, Support","Assassin, Fighter",1,0,1
6154,"Fighter, Mage","Fighter, Assassin","Fighter, Tank","Support, Mage",1,0,1
6153,"Fighter, Assassin","Support, Mage","Fighter, Tank",Marksman,0,1,1
3498,"Fighter, Assassin",Tank,"Tank, Fighter","Tank, Support",1,0,1
6150,"Fighter, Mage","Fighter, Assassin","Tank, Fighter",Marksman,0,1,1
6080,"Tank, Mage","Support, Mage","Fighter, Mage","Fighter, Assassin",0,1,1
6148,Tank,"Mage, Fighter","Fighter, Mage","Tank, Fighter",0,1,1
3500,"Assassin, Fighter",Tank,Fighter,"Support, Tank",1,0,1
3501,"Tank, Fighter","Tank, Support",Marksman,"Support, Tank",0,1,1
3502,"Tank, Fighter","Support, Mage",Marksman,"Fighter, Tank",0,1,1
6143,Tank,"Fighter, Mage","Fighter, Mage","Fighter, Assassin",1,0,1
6142,"Fighter, Assassin","Fighter, Tank","Fighter, Assassin","Fighter, Mage",1,0,1
6141,"Fighter, Marksman","Fighter, Assassin","Fighter, Assassin","Tank, Fighter",0,1,1
6140,Tank,"Fighter, Mage","Tank, Fighter","Fighter, Assassin",1,0,1
6139,Tank,"Fighter, Assassin","Tank, Mage","Fighter, Mage",1,0,1
6138,"Fighter, Assassin","Fighter, Tank","Tank, Fighter","Fighter, Mage",1,0,1
3493,"Fighter, Tank","Support, Tank","Assassin, Mage","Tank, Support",1,0,1
3492,Marksman,"Tank, Mage","Fighter, Mage","Support, Tank",1,0,1
3491,Marksman,"Tank, Mage","Fighter, Mage","Tank, Support",1,0,1
6166,"Mage, Marksman",Marksman,Tank,"Assassin, Fighter",1,0,1
3484,"Tank, Fighter","Support, Tank","Fighter, Assassin","Tank, Support",0,1,1
6187,Fighter,"Fighter, Assassin","Support, Mage",Fighter,0,1,1
6186,Fighter,"Mage, Fighter","Support, Mage",Marksman,1,0,1
6185,Fighter,"Mage, Fighter","Support, Mage",Fighter,0,1,1
6184,"Support, Tank",Marksman,Fighter,Fighter,0,1,1
3486,"Mage, Fighter","Support, Mage","Assassin, Mage","Support, Mage",1,0,1
3487,"Fighter, Assassin","Mage, Support","Fighter, Tank","Mage, Assassin",0,1,1
6181,"Support, Tank","Tank, Fighter","Fighter, Tank","Mage, Fighter",1,0,1
6180,"Fighter, Assassin","Tank, Mage",Tank,"Tank, Fighter",0,1,1
6179,Mage,"Mage, Fighter","Fighter, Tank",Marksman,0,1,1
6177,"Tank, Mage","Fighter, Mage",Assassin,"Assassin, Fighter",1,0,1
3489,"Assassin, Fighter","Fighter, Tank",Fighter,"Mage, Support",1,0,1
6175,"Fighter, Mage","Tank, Fighter","Mage, Marksman","Tank, Fighter",0,1,1
3490,"Fighter, Mage","Tank, Support","Mage, Fighter","Fighter, Tank",1,0,1
6173,"Support, Tank","Assassin, Fighter","Mage, Fighter","Mage, Fighter",0,1,1
6172,"Support, Mage","Tank, Fighter","Tank, Fighter","Mage, Fighter",1,0,1
6171,"Support, Mage",Fighter,Mage,"Fighter, Assassin",0,1,1
6170,"Fighter, Assassin","Fighter, Assassin","Support, Tank",Fighter,0,1,1
6169,"Tank, Fighter",Fighter,"Mage, Marksman","Assassin, Fighter",1,0,1
6168,Tank,"Assassin, Fighter","Assassin, Fighter","Mage, Support",1,0,1
6167,"Tank, Fighter","Fighter, Tank",Marksman,"Fighter, Assassin",0,1,1
6137,"Fighter, Assassin","Fighter, Tank","Fighter, Mage","Tank, Fighter",0,1,1
6136,"Tank, Fighter","Fighter, Tank",Tank,"Fighter, Tank",1,0,1
3504,"Assassin, Mage","Tank, Support",Fighter,"Support, Fighter",0,1,1
6109,Tank,"Fighter, Tank","Tank, Mage","Support, Mage",1,0,1
3512,"Assassin, Fighter","Support, Mage","Assassin, Mage","Tank, Support",0,1,1
6105,"Fighter, Tank","Fighter, Assassin","Tank, Mage","Mage, Fighter",1,0,1
6104,"Tank, Fighter","Mage, Fighter",Fighter,Fighter,1,0,1
6102,"Tank, Mage","Tank, Fighter","Fighter, Mage",Marksman,0,1,1
6101,"Mage, Fighter",Fighter,Tank,Marksman,0,1,1
6100,"Fighter, Assassin","Assassin, Fighter",Tank,Fighter,1,0,1
6099,"Fighter, Assassin","Fighter, Mage","Fighter, Mage",Fighter,1,0,1
3516,"Fighter, Assassin","Tank, Support","Assassin, Fighter","Support, Tank",0,1,1
6096,"Fighter, Assassin",Marksman,"Fighter, Tank","Fighter, Mage",0,1,1
3517,Tank,"Support, Mage","Fighter, Assassin","Support, Tank",1,0,1
3520,"Fighter, Mage",Mage,"Assassin, Fighter",Tank,0,1,1
6091,"Fighter, Tank","Support, Mage","Tank, Fighter","Fighter, Assassin",0,1,1
6090,"Tank, Fighter","Fighter, Tank","Tank, Mage",Marksman,1,0,1
6089,Tank,"Tank, Fighter",Fighter,"Fighter, Tank",0,1,1
6088,"Mage, Marksman",Marksman,"Fighter, Mage","Support, Mage",1,0,1
6087,"Mage, Marksman","Support, Mage","Fighter, Mage","Fighter, Mage",0,1,1
6086,"Fighter, Tank","Fighter, Assassin","Fighter, Mage","Fighter, Tank",0,1,1
3521,Marksman,"Support, Fighter",Fighter,"Mage, Support",0,1,1
3523,"Fighter, Tank","Tank, Support","Fighter, Mage","Support, Tank",0,1,1
3524,"Fighter, Assassin",Mage,"Tank, Fighter","Tank, Fighter",0,1,1
6081,"Tank, Fighter","Assassin, Fighter",Tank,Support,1,0,1
6107,"Mage, Marksman","Assassin, Fighter","Assassin, Fighter",Fighter,0,1,1
6110,"Tank, Fighter",Fighter,"Fighter, Marksman","Support, Mage",1,0,1
6134,"Fighter, Tank","Fighter, Tank","Tank, Mage","Fighter, Mage",1,0,1
3510,"Assassin, Fighter","Tank, Fighter",Fighter,"Support, Fighter",0,1,1
6133,Tank,Fighter,"Fighter, Tank","Fighter, Assassin",1,0,1
3505,Marksman,"Support, Mage","Fighter, Mage","Tank, Support",1,0,1
6131,"Tank, Mage","Support, Mage","Fighter, Tank",Marksman,1,0,1
6129,"Fighter, Assassin","Fighter, Tank","Fighter, Tank","Assassin, Fighter",0,1,1
6128,Tank,"Tank, Fighter","Fighter, Tank","Fighter, Tank",0,1,1
6127,"Mage, Marksman","Fighter, Tank","Fighter, Assassin","Mage, Fighter",0,1,1
6126,"Tank, Mage","Fighter, Mage",Tank,"Fighter, Tank",1,0,1
6125,"Mage, Marksman","Mage, Fighter","Tank, Fighter","Support, Mage",1,0,1
3507,"Assassin, Mage","Support, Tank","Fighter, Mage","Tank, Support",0,1,1
6123,Marksman,"Tank, Fighter","Mage, Marksman","Support, Mage",1,0,1
6122,Tank,"Fighter, Tank","Tank, Fighter","Fighter, Mage",0,1,1
6121,Marksman,"Fighter, Tank",Fighter,"Mage, Fighter",1,0,1
6120,Tank,Fighter,Marksman,Marksman,0,1,1
6119,"Fighter, Assassin","Fighter, Assassin","Tank, Mage","Assassin, Fighter",0,1,1
3508,"Support, Mage","Fighter, Tank","Fighter, Mage","Support, Tank",0,1,1
3509,"Assassin, Fighter","Support, Tank","Support, Mage","Fighter, Tank",0,1,1
6116,"Tank, Mage",Marksman,Tank,"Fighter, Tank",0,1,1
6115,"Tank, Mage","Support, Mage","Fighter, Marksman",Fighter,1,0,1
6114,"Tank, Mage",Fighter,"Fighter, Marksman","Mage, Fighter",0,1,1
6113,"Tank, Fighter","Support, Mage","Fighter, Tank",Fighter,0,1,1
6112,"Fighter, Marksman","Mage, Fighter","Tank, Mage","Fighter, Assassin",1,0,1
6417,"Fighter, Assassin","Mage, Fighter","Tank, Mage","Fighter, Assassin",0,1,1
6419,"Fighter, Tank","Fighter, Assassin","Fighter, Assassin","Mage, Fighter",0,1,1
6874,"Tank, Fighter","Fighter, Mage",Tank,"Fighter, Mage",0,1,1
6728,"Fighter, Assassin","Fighter, Mage","Tank, Mage","Fighter, Tank",1,0,1
6739,"Fighter, Tank","Support, Mage",Tank,"Fighter, Tank",0,1,1
6738,"Tank, Fighter",Fighter,"Fighter, Marksman","Assassin, Fighter",1,0,1
6737,"Fighter, Assassin","Tank, Fighter",Tank,"Assassin, Fighter",1,0,1
6736,"Fighter, Mage","Support, Mage",Tank,"Mage, Fighter",1,0,1
3241,"Fighter, Assassin","Support, Tank",Fighter,"Mage, Support",0,1,1
6734,"Tank, Mage","Tank, Fighter",Tank,"Assassin, Fighter",0,1,1
6733,Tank,"Support, Mage",Fighter,Marksman,0,1,1
6732,Tank,"Assassin, Fighter",Fighter,"Tank, Fighter",1,0,1
6730,"Fighter, Tank","Support, Mage",Tank,Fighter,1,0,1
3243,"Fighter, Assassin","Support, Tank",Fighter,"Tank, Fighter",1,0,1
3246,Fighter,"Support, Tank","Mage, Fighter","Fighter, Mage",0,1,1
6715,"Tank, Mage",Fighter,"Fighter, Assassin",Marksman,1,0,1
6726,Mage,"Fighter, Tank","Fighter, Tank","Fighter, Mage",1,0,1
3247,"Mage, Fighter","Support, Tank","Assassin, Fighter",Mage,1,0,1
6724,Fighter,"Tank, Fighter","Fighter, Assassin",Fighter,1,0,1
6723,"Assassin, Fighter","Mage, Fighter",Fighter,"Fighter, Tank",0,1,1
6722,Fighter,Fighter,"Fighter, Assassin","Assassin, Fighter",0,1,1
3248,"Fighter, Assassin","Support, Fighter",Marksman,"Support, Mage",0,1,1
3249,"Fighter, Mage","Tank, Fighter",Marksman,Support,1,0,1
3250,Marksman,"Support, Fighter","Fighter, Mage","Tank, Mage",0,1,1
6718,"Fighter, Marksman",Fighter,"Tank, Fighter","Support, Mage",1,0,1
6717,"Tank, Fighter","Fighter, Tank","Tank, Mage","Fighter, Tank",1,0,1
6740,Tank,"Fighter, Tank","Mage, Fighter","Fighter, Mage",1,0,1
6741,"Mage, Tank",Fighter,"Fighter, Assassin","Fighter, Tank",0,1,1
6742,"Fighter, Marksman",Fighter,"Fighter, Mage",Marksman,0,1,1
3239,"Fighter, Mage","Mage, Support","Tank, Fighter","Assassin, Mage",0,1,1
3230,"Tank, Fighter","Support, Fighter","Tank, Mage","Fighter, Tank",1,0,1
6764,Marksman,"Tank, Mage","Fighter, Marksman","Fighter, Mage",1,0,1
6763,"Tank, Mage","Fighter, Assassin",Tank,"Fighter, Tank",1,0,1
6762,"Fighter, Tank","Tank, Fighter","Fighter, Marksman","Tank, Mage",0,1,1
6761,"Assassin, Fighter",Fighter,"Tank, Fighter",Marksman,1,0,1
3231,"Tank, Fighter","Support, Fighter","Fighter, Mage","Fighter, Tank",0,1,1
6759,"Tank, Mage","Assassin, Fighter","Assassin, Fighter","Mage, Fighter",0,1,1
6758,"Assassin, Fighter","Tank, Fighter","Fighter, Assassin","Fighter, Mage",1,0,1
6757,Tank,"Fighter, Tank","Tank, Mage","Assassin, Fighter",1,0,1
6756,"Mage, Fighter",Marksman,"Tank, Mage","Fighter, Tank",1,0,1
6755,"Fighter, Assassin","Mage, Fighter","Mage, Fighter",Fighter,1,0,1
6754,"Mage, Fighter",Fighter,Tank,"Fighter, Tank",0,1,1
3232,"Tank, Mage",Support,"Fighter, Mage","Fighter, Tank",0,1,1
3233,"Fighter, Mage","Fighter, Tank","Tank, Mage","Support, Fighter",1,0,1
3234,Marksman,"Support, Tank","Fighter, Assassin","Support, Mage",1,0,1
6749,"Tank, Fighter","Fighter, Mage","Fighter, Tank",Tank,0,1,1
6748,"Fighter, Assassin","Fighter, Mage",Tank,Marksman,1,0,1
3238,"Mage, Fighter","Tank, Fighter","Tank, Fighter","Support, Fighter",0,1,1
6746,"Fighter, Tank","Support, Mage","Tank, Mage","Fighter, Mage",1,0,1
6745,"Fighter, Tank",Fighter,"Mage, Tank",Marksman,1,0,1
6744,"Tank, Mage",Fighter,"Fighter, Tank",Marksman,1,0,1
3251,"Fighter, Tank","Mage, Marksman","Tank, Fighter","Mage, Fighter",1,0,1
6714,"Tank, Fighter","Assassin, Fighter",Marksman,"Fighter, Assassin",1,0,1
6767,"Mage, Fighter","Fighter, Assassin",Tank,"Fighter, Tank",0,1,1
6674,"Fighter, Tank","Assassin, Fighter","Fighter, Assassin","Assassin, Fighter",0,1,1
6684,"Mage, Tank","Tank, Fighter","Fighter, Tank","Fighter, Tank",1,0,1
6683,"Tank, Mage","Fighter, Assassin","Tank, Fighter","Tank, Fighter",1,0,1
6682,"Fighter, Tank","Tank, Fighter",Fighter,"Fighter, Tank",1,0,1
6681,"Tank, Fighter","Fighter, Tank","Fighter, Tank","Assassin, Fighter",0,1,1
6680,"Mage, Tank","Tank, Fighter",Marksman,"Tank, Fighter",0,1,1
6679,"Mage, Tank","Fighter, Assassin","Tank, Mage","Tank, Fighter",0,1,1
6678,Fighter,"Tank, Fighter","Fighter, Tank","Fighter, Assassin",1,0,1
6677,"Mage, Tank","Assassin, Fighter","Fighter, Tank","Tank, Fighter",1,0,1
6676,Fighter,"Assassin, Fighter","Fighter, Tank","Assassin, Fighter",0,1,1
3260,"Tank, Fighter",Mage,"Fighter, Mage","Mage, Fighter",0,1,1
6673,"Mage, Tank","Fighter, Tank","Tank, Mage","Tank, Fighter",1,0,1
6712,Tank,"Fighter, Mage","Tank, Fighter","Tank, Fighter",1,0,1
6672,"Fighter, Tank","Fighter, Tank",Fighter,"Tank, Fighter",0,1,1
3261,"Fighter, Assassin","Fighter, Mage",Fighter,"Tank, Fighter",0,1,1
3262,"Fighter, Assassin","Mage, Marksman","Assassin, Fighter","Mage, Support",1,0,1
6669,"Tank, Fighter",Marksman,Assassin,"Fighter, Assassin",0,1,1
6668,"Assassin, Fighter",Fighter,"Fighter, Marksman",Marksman,0,1,1
6666,"Fighter, Mage",Fighter,"Fighter, Mage","Fighter, Assassin",1,0,1
6665,"Fighter, Tank","Fighter, Tank","Fighter, Tank","Fighter, Assassin",1,0,1
6664,"Fighter, Assassin","Tank, Fighter","Fighter, Marksman","Mage, Fighter",0,1,1
3264,"Fighter, Tank","Support, Fighter","Tank, Fighter","Mage, Support",1,0,1
3265,"Assassin, Fighter","Mage, Assassin","Mage, Fighter",Marksman,0,1,1
6685,Fighter,"Tank, Fighter","Mage, Tank","Assassin, Fighter",0,1,1
6686,"Fighter, Tank","Assassin, Fighter","Tank, Fighter","Tank, Fighter",1,0,1
6687,Fighter,"Fighter, Tank","Tank, Fighter","Assassin, Fighter",1,0,1
6688,"Mage, Tank","Tank, Fighter","Mage, Fighter","Fighter, Assassin",0,1,1
6711,"Fighter, Mage","Fighter, Assassin","Fighter, Mage","Tank, Fighter",0,1,1
3253,"Fighter, Assassin","Fighter, Tank",Fighter,"Support, Mage",1,0,1
6709,"Fighter, Tank","Fighter, Mage","Fighter, Marksman","Tank, Fighter",0,1,1
6707,Tank,"Tank, Fighter","Mage, Tank","Fighter, Mage",0,1,1
6706,"Fighter, Marksman","Assassin, Fighter","Fighter, Tank","Fighter, Assassin",1,0,1
6705,"Fighter, Tank","Tank, Fighter","Mage, Tank","Assassin, Fighter",1,0,1
6703,Tank,"Tank, Fighter","Fighter, Assassin","Tank, Fighter",1,0,1
3257,Marksman,"Support, Fighter","Assassin, Fighter","Support, Tank",1,0,1
3258,Fighter,"Mage, Support","Fighter, Assassin","Tank, Fighter",0,1,1
6700,"Assassin, Fighter","Mage, Fighter","Tank, Mage","Fighter, Mage",1,0,1
3259,"Assassin, Fighter","Support, Tank","Fighter, Mage",Tank,1,0,1
6698,"Assassin, Fighter","Assassin, Fighter","Support, Tank",Marksman,1,0,1
6697,"Assassin, Fighter",Marksman,"Tank, Mage","Fighter, Mage",0,1,1
6696,"Assassin, Fighter","Fighter, Mage","Tank, Fighter",Fighter,1,0,1
6695,"Tank, Fighter","Fighter, Assassin","Assassin, Fighter",Marksman,1,0,1
6694,"Tank, Fighter",Marksman,"Fighter, Mage",Fighter,1,0,1
6693,"Fighter, Tank",Marksman,"Tank, Fighter","Fighter, Assassin",1,0,1
6692,"Fighter, Tank","Tank, Mage","Fighter, Marksman","Fighter, Mage",0,1,1
6691,"Tank, Fighter","Tank, Fighter","Tank, Mage","Assassin, Fighter",1,0,1
6690,Fighter,"Assassin, Mage","Fighter, Tank","Tank, Fighter",1,0,1
6689,Fighter,"Fighter, Tank","Mage, Tank","Tank, Fighter",0,1,1
6766,"Fighter, Mage","Fighter, Tank","Tank, Fighter","Mage, Fighter",0,1,1
6768,"Fighter, Marksman","Mage, Fighter","Fighter, Tank","Assassin, Fighter",1,0,1
3379,"Tank, Fighter","Fighter, Tank",Fighter,"Tank, Fighter",1,0,1
6836,"Fighter, Tank","Fighter, Assassin","Support, Tank","Assassin, Fighter",0,1,1
6847,Marksman,"Fighter, Mage",Fighter,"Mage, Fighter",0,1,1
6846,"Support, Mage","Mage, Fighter","Tank, Fighter","Fighter, Mage",1,0,1
6845,Mage,Marksman,"Fighter, Tank","Fighter, Assassin",0,1,1
6844,"Tank, Fighter","Mage, Fighter","Mage, Support",Fighter,1,0,1
6843,"Tank, Fighter","Assassin, Mage","Tank, Fighter","Assassin, Fighter",0,1,1
6841,"Fighter, Marksman","Assassin, Fighter",Tank,"Fighter, Assassin",1,0,1
3208,Fighter,"Mage, Marksman",Marksman,"Mage, Assassin",0,1,1
6839,"Tank, Fighter","Support, Mage","Tank, Mage",Marksman,1,0,1
6838,Tank,"Fighter, Tank","Fighter, Tank","Support, Mage",0,1,1
6837,Tank,"Fighter, Assassin","Tank, Mage","Fighter, Tank",0,1,1
6835,"Support, Tank","Assassin, Fighter","Tank, Mage","Fighter, Assassin",1,0,1
6823,"Fighter, Assassin","Fighter, Tank","Fighter, Mage",Marksman,0,1,1
6834,"Support, Tank",Fighter,"Fighter, Tank","Fighter, Tank",0,1,1
6833,"Fighter, Tank",Marksman,"Fighter, Assassin","Fighter, Assassin",0,1,1
3209,Fighter,"Mage, Assassin","Mage, Fighter","Mage, Marksman",1,0,1
6831,"Fighter, Marksman","Assassin, Fighter","Fighter, Tank","Assassin, Fighter",1,0,1
6830,"Tank, Mage","Assassin, Fighter","Support, Tank",Fighter,1,0,1
3211,"Mage, Fighter","Support, Fighter","Assassin, Fighter","Tank, Fighter",1,0,1
6828,Fighter,"Assassin, Fighter","Tank, Fighter","Fighter, Tank",1,0,1
6827,"Tank, Fighter","Assassin, Fighter","Fighter, Marksman","Assassin, Fighter",1,0,1
3214,"Fighter, Mage","Mage, Support","Fighter, Assassin","Tank, Fighter",0,1,1
6825,"Fighter, Assassin",Marksman,"Tank, Mage","Assassin, Fighter",1,0,1
6848,"Fighter, Assassin","Mage, Fighter","Support, Mage","Fighter, Tank",0,1,1
6849,"Support, Mage",Marksman,"Tank, Mage","Mage, Fighter",1,0,1
6850,Tank,"Mage, Fighter",Marksman,"Fighter, Assassin",1,0,1
6851,"Tank, Fighter","Mage, Fighter","Support, Mage","Fighter, Tank",0,1,1
6872,Tank,Fighter,"Fighter, Mage","Tank, Fighter",1,0,1
6871,Tank,"Tank, Fighter","Fighter, Assassin","Assassin, Fighter",0,1,1
6870,"Tank, Fighter","Tank, Mage","Tank, Mage","Tank, Mage",0,1,1
6869,"Tank, Fighter",Marksman,"Tank, Fighter","Fighter, Assassin",0,1,1
6868,"Support, Tank","Tank, Fighter",Mage,"Fighter, Assassin",1,0,1
6867,Fighter,"Tank, Fighter",Marksman,"Fighter, Mage",0,1,1
6866,"Support, Mage","Fighter, Tank",Fighter,Fighter,1,0,1
6865,"Tank, Fighter","Fighter, Assassin",Mage,Marksman,1,0,1
6864,"Support, Tank","Mage, Fighter","Marksman, Fighter","Fighter, Tank",0,1,1
3204,"Fighter, Mage","Support, Mage","Tank, Fighter","Mage, Marksman",1,0,1
6862,"Tank, Fighter","Fighter, Mage",Fighter,"Tank, Fighter",0,1,1
6861,"Support, Mage","Tank, Fighter","Fighter, Assassin","Fighter, Mage",0,1,1
6860,"Tank, Fighter","Fighter, Mage","Tank, Fighter","Tank, Fighter",1,0,1
6859,"Marksman, Fighter","Fighter, Mage","Tank, Fighter","Mage, Fighter",1,0,1
6858,"Tank, Mage",Marksman,"Tank, Fighter","Marksman, Fighter",0,1,1
6857,Tank,"Tank, Fighter","Tank, Fighter",Fighter,1,0,1
6856,"Tank, Fighter",Marksman,"Mage, Fighter","Mage, Fighter",1,0,1
3205,"Tank, Fighter","Mage, Support","Mage, Fighter","Support, Tank",1,0,1
6854,"Mage, Fighter","Fighter, Assassin",Tank,Fighter,1,0,1
6853,"Fighter, Assassin","Tank, Fighter",Mage,Fighter,1,0,1
6852,"Fighter, Assassin","Tank, Fighter",Tank,"Mage, Fighter",1,0,1
6824,"Tank, Fighter","Support, Mage","Fighter, Marksman",Marksman,1,0,1
6822,"Fighter, Mage","Tank, Fighter","Mage, Marksman","Support, Mage",0,1,1
6769,"Fighter, Mage",Fighter,"Tank, Fighter","Fighter, Mage",0,1,1
3226,"Tank, Fighter","Support, Fighter","Assassin, Fighter","Support, Fighter",0,1,1
3224,Fighter,"Support, Tank","Fighter, Assassin","Support, Fighter",1,0,1
6791,"Fighter, Assassin","Tank, Fighter","Tank, Fighter","Mage, Fighter",1,0,1
6790,"Mage, Fighter","Mage, Fighter","Fighter, Mage","Assassin, Fighter",1,0,1
6789,"Fighter, Mage",Marksman,"Fighter, Tank","Tank, Fighter",1,0,1
6788,Tank,"Assassin, Fighter","Fighter, Tank","Fighter, Tank",1,0,1
3225,"Tank, Mage","Tank, Fighter","Tank, Mage","Support, Fighter",1,0,1
6786,Tank,"Assassin, Fighter","Fighter, Assassin","Fighter, Mage",1,0,1
6785,"Fighter, Mage","Fighter, Mage","Tank, Fighter","Mage, Fighter",0,1,1
6784,"Fighter, Mage","Assassin, Fighter","Fighter, Mage","Support, Mage",0,1,1
6783,Tank,Marksman,"Tank, Fighter","Fighter, Assassin",1,0,1
6781,"Fighter, Tank","Assassin, Fighter","Fighter, Tank","Support, Mage",0,1,1
6821,"Tank, Fighter","Fighter, Tank","Mage, Marksman","Mage, Fighter",1,0,1
6780,"Fighter, Marksman","Tank, Mage","Tank, Mage","Tank, Fighter",0,1,1
6779,"Tank, Mage","Tank, Fighter","Fighter, Marksman","Fighter, Mage",1,0,1
6778,"Fighter, Marksman","Tank, Fighter","Tank, Mage","Fighter, Mage",1,0,1
3228,"Tank, Mage","Support, Tank",Fighter,"Fighter, Mage",1,0,1
6775,"Tank, Support","Fighter, Assassin","Fighter, Tank","Assassin, Fighter",1,0,1
6774,"Fighter, Tank","Fighter, Assassin","Mage, Fighter","Assassin, Fighter",0,1,1
6773,"Fighter, Mage","Tank, Mage","Fighter, Tank",Fighter,1,0,1
6772,"Tank, Mage",Fighter,Tank,"Fighter, Tank",1,0,1
6771,"Fighter, Marksman","Mage, Fighter","Tank, Fighter","Tank, Fighter",1,0,1
6770,"Fighter, Support","Fighter, Tank","Fighter, Tank","Tank, Fighter",1,0,1
6793,Assassin,Fighter,"Fighter, Assassin","Fighter, Tank",0,1,1
6794,"Fighter, Assassin","Tank, Fighter","Mage, Marksman","Assassin, Fighter",1,0,1
6795,Fighter,"Assassin, Fighter","Fighter, Tank",Fighter,0,1,1
6796,"Mage, Marksman","Fighter, Mage","Fighter, Marksman","Assassin, Fighter",1,0,1
6820,"Fighter, Tank","Support, Mage","Tank, Fighter","Fighter, Tank",1,0,1
6819,"Mage, Marksman","Fighter, Tank","Fighter, Marksman","Mage, Fighter",0,1,1
6818,"Fighter, Tank","Support, Mage","Fighter, Tank","Fighter, Assassin",1,0,1
3218,Fighter,"Tank, Fighter","Fighter, Assassin","Mage, Support",1,0,1
6815,"Mage, Marksman","Assassin, Fighter","Fighter, Assassin","Fighter, Assassin",0,1,1
6814,"Tank, Fighter","Tank, Fighter","Tank, Fighter","Fighter, Assassin",0,1,1
6813,Tank,"Fighter, Assassin","Fighter, Assassin","Assassin, Fighter",0,1,1
6811,"Mage, Marksman","Fighter, Mage","Fighter, Tank","Fighter, Tank",0,1,1
6810,"Tank, Fighter","Fighter, Assassin","Fighter, Mage","Mage, Fighter",1,0,1
6809,"Fighter, Mage","Mage, Fighter","Fighter, Mage","Assassin, Fighter",1,0,1
6808,"Tank, Fighter",Marksman,Tank,"Support, Mage",0,1,1
3221,"Fighter, Assassin",Support,"Mage, Fighter","Mage, Support",0,1,1
6805,"Support, Tank","Mage, Fighter","Tank, Fighter","Fighter, Assassin",1,0,1
6804,"Support, Tank","Fighter, Assassin","Tank, Fighter","Mage, Fighter",1,0,1
3223,Fighter,"Mage, Assassin","Fighter, Tank","Mage, Fighter",1,0,1
6802,"Support, Tank","Fighter, Tank","Fighter, Tank","Mage, Fighter",0,1,1
6801,"Fighter, Tank","Assassin, Mage","Tank, Mage","Fighter, Assassin",0,1,1
6800,"Mage, Fighter","Assassin, Fighter","Fighter, Tank","Tank, Fighter",1,0,1
6799,"Fighter, Tank",Fighter,"Fighter, Mage","Fighter, Tank",0,1,1
6798,"Fighter, Marksman","Assassin, Fighter",Tank,Fighter,0,1,1
6797,"Fighter, Tank","Tank, Fighter","Mage, Fighter","Mage, Fighter",0,1,1
6661,Tank,"Assassin, Fighter",Fighter,"Fighter, Assassin",1,0,1
6660,"Tank, Fighter","Tank, Fighter",Fighter,"Fighter, Mage",1,0,1
6659,Fighter,"Tank, Fighter","Fighter, Assassin","Fighter, Mage",1,0,1
6491,"Fighter, Marksman",Fighter,"Fighter, Assassin","Fighter, Mage",0,1,1
6505,"Fighter, Tank",Fighter,"Mage, Marksman",Marksman,1,0,1
6503,"Fighter, Tank","Fighter, Tank","Fighter, Mage","Mage, Fighter",0,1,1
6502,"Mage, Marksman",Fighter,Marksman,"Tank, Fighter",1,0,1
6498,"Tank, Mage","Mage, Fighter",Tank,Marksman,0,1,1
6497,"Support, Mage","Tank, Fighter","Fighter, Assassin","Tank, Fighter",0,1,1
6496,Fighter,"Assassin, Fighter","Tank, Mage",Marksman,1,0,1
6495,"Fighter, Tank","Support, Mage","Fighter, Tank","Mage, Fighter",1,0,1
6494,"Fighter, Mage","Assassin, Fighter",Tank,Fighter,0,1,1
6493,"Fighter, Tank",Fighter,Tank,"Tank, Fighter",0,1,1
6492,"Fighter, Mage","Tank, Fighter","Assassin, Fighter",Fighter,1,0,1
6490,"Tank, Mage","Assassin, Fighter","Mage, Marksman",Fighter,0,1,1
6478,"Fighter, Tank","Fighter, Tank","Fighter, Tank","Tank, Fighter",0,1,1
6489,"Mage, Marksman","Mage, Fighter","Fighter, Mage",Fighter,0,1,1
6488,Marksman,"Mage, Fighter","Fighter, Mage",Fighter,1,0,1
6487,"Mage, Marksman","Fighter, Mage",Tank,Fighter,1,0,1
6486,"Fighter, Mage","Fighter, Assassin","Fighter, Assassin",Fighter,1,0,1
6485,Tank,"Fighter, Tank","Fighter, Mage","Tank, Fighter",1,0,1
6484,"Tank, Mage","Mage, Support","Assassin, Fighter","Assassin, Fighter",1,0,1
6483,"Tank, Fighter","Tank, Fighter",Fighter,"Assassin, Fighter",0,1,1
6482,Fighter,"Assassin, Fighter",Marksman,"Tank, Fighter",1,0,1
3355,"Tank, Fighter","Tank, Fighter",Fighter,"Fighter, Tank",0,1,1
6480,"Mage, Tank","Assassin, Fighter","Tank, Fighter","Tank, Fighter",0,1,1
3348,Marksman,"Tank, Fighter","Assassin, Fighter","Tank, Support",1,0,1
6507,"Fighter, Tank","Tank, Mage",Tank,Fighter,1,0,1
6508,"Tank, Fighter","Fighter, Assassin",Fighter,"Fighter, Tank",1,0,1
3344,Fighter,"Fighter, Tank",Marksman,"Support, Mage",0,1,1
6538,"Assassin, Fighter","Assassin, Fighter","Fighter, Assassin","Assassin, Mage",1,0,1
6537,"Fighter, Assassin","Mage, Assassin",Fighter,"Assassin, Fighter",1,0,1
3330,"Tank, Fighter","Mage, Support","Assassin, Fighter","Support, Tank",1,0,1
6535,Fighter,"Support, Mage","Tank, Fighter","Assassin, Fighter",1,0,1
3335,"Fighter, Mage",Mage,"Fighter, Assassin","Support, Mage",1,0,1
6531,Fighter,"Assassin, Mage","Assassin, Fighter","Marksman, Mage",1,0,1
6530,"Assassin, Fighter","Assassin, Fighter","Tank, Fighter","Assassin, Mage",1,0,1
6528,"Assassin, Fighter","Marksman, Mage",Fighter,"Assassin, Fighter",0,1,1
6527,Fighter,"Assassin, Fighter","Mage, Support","Mage, Assassin",1,0,1
3337,Marksman,Tank,"Mage, Fighter","Fighter, Tank",1,0,1
6524,"Fighter, Assassin","Assassin, Fighter","Tank, Fighter","Mage, Marksman",1,0,1
3339,"Fighter, Assassin","Support, Mage",Fighter,"Tank, Support",0,1,1
6522,"Tank, Fighter","Mage, Assassin","Tank, Fighter","Mage, Assassin",1,0,1
6521,"Assassin, Fighter","Mage, Assassin","Tank, Fighter",Marksman,0,1,1
6520,"Fighter, Assassin","Assassin, Mage","Tank, Fighter",Marksman,1,0,1
6519,"Fighter, Assassin","Mage, Marksman","Fighter, Assassin","Mage, Assassin",0,1,1
3340,"Mage, Fighter","Tank, Support",Marksman,"Mage, Support",1,0,1
6515,"Fighter, Assassin","Marksman, Mage","Fighter, Assassin","Mage, Marksman",1,0,1
6514,"Fighter, Assassin","Marksman, Mage","Tank, Fighter","Mage, Assassin",0,1,1
6513,"Fighter, Assassin","Mage, Assassin","Fighter, Assassin","Fighter, Assassin",1,0,1
6511,"Fighter, Assassin","Assassin, Mage",Fighter,"Marksman, Mage",1,0,1
3356,"Tank, Fighter","Tank, Fighter","Tank, Fighter","Support, Mage",1,0,1
6477,"Mage, Support","Assassin, Fighter","Tank, Mage","Tank, Fighter",1,0,1
6657,Tank,"Fighter, Tank","Fighter, Mage",Fighter,1,0,1
6435,"Tank, Fighter",Fighter,"Tank, Fighter","Fighter, Tank",0,1,1
6447,"Tank, Fighter","Mage, Fighter","Assassin, Fighter","Fighter, Assassin",0,1,1
6446,"Fighter, Marksman","Fighter, Assassin","Mage, Marksman","Fighter, Tank",1,0,1
6445,"Tank, Fighter","Fighter, Tank",Fighter,"Fighter, Assassin",1,0,1
6444,"Mage, Marksman","Fighter, Tank","Tank, Fighter","Assassin, Fighter",0,1,1
6442,"Tank, Fighter",Fighter,"Mage, Marksman","Fighter, Tank",1,0,1
6440,"Tank, Fighter",Fighter,"Mage, Marksman","Fighter, Assassin",1,0,1
3369,"Tank, Fighter","Fighter, Tank","Mage, Fighter","Tank, Support",1,0,1
6438,"Tank, Fighter","Fighter, Tank","Tank, Fighter",Fighter,0,1,1
6437,"Tank, Fighter","Fighter, Tank","Tank, Mage","Fighter, Assassin",1,0,1
3370,Marksman,"Fighter, Tank","Mage, Fighter","Support, Mage",1,0,1
6434,"Mage, Fighter","Fighter, Assassin","Mage, Marksman",Fighter,0,1,1
3357,Fighter,"Support, Fighter","Fighter, Tank","Fighter, Tank",1,0,1
6432,"Tank, Fighter","Fighter, Assassin","Mage, Marksman","Assassin, Fighter",1,0,1
6431,"Fighter, Assassin","Fighter, Tank","Fighter, Tank",Fighter,0,1,1
3374,"Assassin, Fighter","Support, Mage","Mage, Support",Marksman,1,0,1
3376,Marksman,"Mage, Assassin","Assassin, Fighter","Support, Tank",1,0,1
6426,"Tank, Fighter","Support, Mage","Fighter, Assassin",Fighter,0,1,1
3377,Marksman,"Support, Tank","Fighter, Assassin","Mage, Assassin",1,0,1
6424,"Tank, Fighter",Fighter,"Fighter, Assassin","Fighter, Assassin",1,0,1
6423,"Tank, Fighter","Tank, Fighter",Tank,Fighter,1,0,1
6422,"Mage, Fighter",Fighter,"Fighter, Tank","Fighter, Tank",0,1,1
6421,Tank,"Fighter, Mage","Mage, Marksman","Mage, Fighter",0,1,1
6449,Tank,Marksman,Fighter,"Assassin, Fighter",0,1,1
6450,"Tank, Fighter",Marksman,Fighter,"Support, Mage",1,0,1
6451,Fighter,"Assassin, Fighter","Tank, Mage","Assassin, Fighter",0,1,1
6452,"Fighter, Tank","Support, Mage","Fighter, Assassin","Mage, Fighter",0,1,1
6475,"Tank, Mage","Assassin, Fighter","Mage, Tank","Fighter, Tank",0,1,1
6474,Fighter,"Fighter, Tank","Fighter, Tank","Tank, Fighter",1,0,1
6473,Fighter,"Tank, Fighter","Tank, Fighter","Assassin, Fighter",0,1,1
3358,"Tank, Mage","Mage, Marksman","Tank, Fighter","Support, Mage",0,1,1
6471,"Fighter, Tank","Tank, Fighter","Fighter, Marksman","Tank, Fighter",1,0,1
6470,"Tank, Mage","Fighter, Assassin","Mage, Marksman","Fighter, Tank",1,0,1
3360,"Fighter, Mage","Fighter, Support","Tank, Fighter","Support, Mage",0,1,1
6468,Fighter,"Fighter, Tank","Fighter, Tank","Assassin, Fighter",1,0,1
6466,Fighter,"Assassin, Mage","Mage, Tank","Assassin, Fighter",1,0,1
6465,Marksman,"Tank, Fighter",Fighter,"Tank, Fighter",1,0,1
6464,"Tank, Mage","Tank, Fighter","Mage, Tank","Fighter, Assassin",1,0,1
6463,"Fighter, Tank","Assassin, Fighter","Fighter, Marksman","Tank, Fighter",0,1,1
6462,"Fighter, Tank","Assassin, Mage","Tank, Fighter","Tank, Fighter",0,1,1
6461,"Fighter, Tank","Assassin, Mage","Tank, Fighter","Assassin, Fighter",0,1,1
6459,Fighter,"Tank, Fighter","Tank, Mage","Assassin, Fighter",1,0,1
6458,Fighter,"Assassin, Fighter","Mage, Tank","Fighter, Assassin",1,0,1
3363,"Assassin, Fighter","Support, Mage","Tank, Fighter","Tank, Fighter",0,1,1
6456,Fighter,"Fighter, Assassin",Marksman,"Assassin, Fighter",1,0,1
3364,Fighter,"Tank, Support","Fighter, Tank","Support, Fighter",1,0,1
3365,"Fighter, Mage","Tank, Fighter","Tank, Fighter","Tank, Support",1,0,1
6453,"Tank, Fighter","Assassin, Fighter","Mage, Marksman",Fighter,1,0,1
3329,"Assassin, Mage","Support, Mage","Fighter, Mage","Support, Tank",1,0,1
3328,"Fighter, Mage","Support, Tank","Fighter, Assassin","Fighter, Tank",1,0,1
6541,Fighter,"Fighter, Mage","Fighter, Tank","Tank, Fighter",1,0,1
6611,"Tank, Fighter","Assassin, Fighter","Fighter, Assassin","Assassin, Mage",0,1,1
6626,"Tank, Fighter","Tank, Fighter","Fighter, Assassin",Mage,1,0,1
6625,"Fighter, Assassin","Marksman, Mage","Tank, Fighter","Mage, Marksman",1,0,1
6624,Fighter,Mage,"Assassin, Mage","Assassin, Fighter",0,1,1
6621,"Tank, Fighter","Mage, Tank",Fighter,"Marksman, Mage",1,0,1
6620,"Tank, Fighter",Mage,"Assassin, Mage","Assassin, Mage",1,0,1
6619,"Fighter, Mage",Mage,"Fighter, Assassin","Tank, Fighter",0,1,1
6615,"Fighter, Assassin","Tank, Mage","Fighter, Mage","Fighter, Marksman",1,0,1
3294,"Mage, Fighter","Mage, Assassin","Tank, Fighter","Mage, Support",1,0,1
3295,"Tank, Fighter","Support, Tank",Fighter,"Mage, Support",0,1,1
6612,"Assassin, Fighter","Marksman, Mage",Fighter,"Mage, Tank",1,0,1
3296,"Fighter, Assassin","Support, Mage","Mage, Fighter","Mage, Assassin",1,0,1
3324,"Mage, Fighter","Support, Mage","Tank, Fighter",Support,1,0,1
6609,"Fighter, Assassin","Assassin, Fighter","Fighter, Assassin","Mage, Assassin",1,0,1
6608,"Fighter, Mage","Tank, Mage","Assassin, Fighter","Fighter, Assassin",0,1,1
6607,Fighter,"Assassin, Fighter","Tank, Fighter","Fighter, Marksman",0,1,1
3297,"Fighter, Assassin",Mage,"Fighter, Assassin","Mage, Support",1,0,1
6605,"Tank, Fighter",Mage,"Fighter, Assassin","Mage, Support",0,1,1
3298,"Fighter, Mage","Mage, Support","Support, Mage","Support, Mage",1,0,1
6603,"Tank, Fighter","Support, Mage","Tank, Fighter",Marksman,1,0,1
6602,"Fighter, Mage","Fighter, Assassin","Tank, Fighter","Mage, Assassin",0,1,1
3299,"Assassin, Mage","Support, Mage","Mage, Fighter","Tank, Support",0,1,1
6600,"Fighter, Assassin",Mage,"Fighter, Assassin","Assassin, Fighter",1,0,1
3283,"Support, Mage","Support, Mage","Fighter, Tank","Support, Fighter",0,1,1
3282,"Tank, Fighter","Mage, Assassin",Fighter,Marksman,1,0,1
6630,"Fighter, Assassin",Mage,Fighter,"Tank, Mage",1,0,1
6631,Marksman,"Tank, Fighter","Mage, Tank","Tank, Fighter",0,1,1
3268,Marksman,"Mage, Support","Support, Mage","Support, Fighter",0,1,1
6655,Fighter,"Fighter, Tank","Fighter, Tank",Marksman,1,0,1
6654,"Fighter, Tank","Fighter, Tank","Assassin, Fighter","Fighter, Mage",0,1,1
6653,"Assassin, Fighter","Fighter, Assassin","Fighter, Tank","Fighter, Tank",0,1,1
3269,"Support, Mage","Mage, Support","Fighter, Assassin","Mage, Assassin",0,1,1
3272,"Fighter, Mage","Mage, Support",Fighter,Fighter,0,1,1
6649,"Mage, Fighter",Fighter,"Assassin, Fighter","Fighter, Mage",0,1,1
6648,"Tank, Mage",Marksman,"Mage, Fighter",Marksman,1,0,1
6647,"Tank, Mage",Fighter,"Support, Tank","Mage, Fighter",1,0,1
6646,"Tank, Fighter",Fighter,"Mage, Tank","Fighter, Tank",1,0,1
6643,Tank,Marksman,"Fighter, Mage","Fighter, Marksman",0,1,1
3275,Fighter,"Mage, Support","Fighter, Tank","Mage, Fighter",0,1,1
3276,Marksman,"Support, Mage","Fighter, Mage",Fighter,0,1,1
6640,"Fighter, Assassin","Assassin, Fighter",Tank,"Fighter, Assassin",0,1,1
3278,Marksman,Mage,"Fighter, Assassin","Mage, Tank",1,0,1
6637,"Fighter, Marksman","Tank, Fighter","Tank, Mage","Tank, Mage",0,1,1
3281,"Fighter, Assassin",Mage,"Tank, Fighter",Marksman,0,1,1
6635,"Fighter, Mage",Fighter,"Assassin, Fighter","Fighter, Mage",1,0,1
6634,"Fighter, Mage","Fighter, Mage","Tank, Fighter","Tank, Fighter",1,0,1
6633,"Support, Mage","Fighter, Assassin",Tank,Fighter,1,0,1
6632,"Fighter, Tank","Fighter, Assassin",Fighter,"Assassin, Fighter",0,1,1
6599,"Fighter, Mage","Mage, Marksman","Tank, Fighter","Assassin, Mage",0,1,1
6598,"Fighter, Assassin","Mage, Marksman",Fighter,"Assassin, Mage",0,1,1
6597,"Assassin, Fighter","Assassin, Mage","Assassin, Mage","Fighter, Tank",0,1,1
6569,"Fighter, Mage","Marksman, Mage","Assassin, Mage","Mage, Marksman",1,0,1
6567,"Fighter, Tank","Fighter, Tank","Fighter, Assassin","Tank, Fighter",1,0,1
3315,"Tank, Fighter","Mage, Marksman","Fighter, Mage","Support, Tank",1,0,1
6564,"Mage, Tank","Tank, Fighter","Tank, Fighter","Tank, Fighter",1,0,1
6562,"Fighter, Tank","Assassin, Fighter","Tank, Mage","Support, Mage",0,1,1
6561,"Fighter, Tank","Tank, Fighter",Fighter,"Assassin, Mage",0,1,1
3318,"Fighter, Mage","Support, Tank","Assassin, Mage","Tank, Support",1,0,1
6559,Fighter,"Mage, Assassin","Mage, Fighter","Assassin, Fighter",1,0,1
6557,"Assassin, Fighter","Assassin, Fighter","Fighter, Assassin","Mage, Marksman",1,0,1
6556,"Tank, Fighter","Assassin, Mage","Tank, Fighter","Support, Mage",0,1,1
6555,"Assassin, Fighter","Assassin, Mage","Tank, Fighter","Support, Mage",0,1,1
3320,"Tank, Mage","Mage, Support","Fighter, Mage","Tank, Support",0,1,1
3321,"Tank, Mage","Mage, Support","Fighter, Mage","Support, Tank",0,1,1
6552,"Tank, Fighter","Mage, Marksman","Fighter, Assassin","Mage, Assassin",1,0,1
3322,"Mage, Fighter","Fighter, Mage","Tank, Fighter","Mage, Support",0,1,1
3323,"Assassin, Fighter",Support,"Fighter, Tank","Mage, Support",0,1,1
6549,"Fighter, Tank","Fighter, Mage",Fighter,"Tank, Fighter",0,1,1
6548,"Tank, Fighter","Tank, Fighter","Tank, Mage","Assassin, Mage",1,0,1
6547,"Fighter, Marksman","Fighter, Tank","Tank, Fighter","Tank, Fighter",0,1,1
6546,Fighter,"Fighter, Assassin","Fighter, Tank","Tank, Fighter",1,0,1
6545,"Fighter, Tank","Assassin, Fighter","Assassin, Fighter","Assassin, Fighter",1,0,1
6544,Fighter,"Fighter, Tank","Mage, Tank","Assassin, Fighter",1,0,1
3313,"Fighter, Mage","Support, Fighter","Assassin, Fighter","Support, Fighter",1,0,1
6570,"Tank, Fighter","Fighter, Marksman","Assassin, Fighter","Mage, Marksman",1,0,1
6595,Fighter,"Mage, Marksman","Tank, Fighter","Fighter, Marksman",1,0,1
6571,Fighter,"Fighter, Marksman","Fighter, Mage",Mage,1,0,1
3302,"Tank, Fighter","Support, Fighter","Fighter, Tank","Support, Tank",1,0,1
6593,Fighter,"Mage, Tank","Fighter, Tank","Marksman, Mage",1,0,1
6592,"Assassin, Fighter","Mage, Assassin","Fighter, Mage","Marksman, Mage",1,0,1
6591,"Assassin, Mage",Mage,"Fighter, Mage","Marksman, Mage",0,1,1
6590,"Assassin, Mage","Fighter, Mage",Fighter,"Assassin, Mage",1,0,1
6589,"Fighter, Mage","Support, Mage","Assassin, Fighter","Marksman, Mage",0,1,1
6588,"Fighter, Mage","Marksman, Mage","Assassin, Fighter","Tank, Fighter",0,1,1
6587,"Assassin, Mage","Marksman, Mage",Fighter,Mage,0,1,1
6586,"Tank, Fighter","Marksman, Mage","Fighter, Assassin","Assassin, Fighter",1,0,1
6585,"Tank, Fighter","Fighter, Marksman",Fighter,"Support, Mage",0,1,1
6584,Fighter,Mage,"Tank, Fighter","Fighter, Marksman",0,1,1
6583,"Fighter, Assassin","Fighter, Marksman",Fighter,"Mage, Marksman",0,1,1
3304,"Assassin, Fighter","Support, Tank","Assassin, Mage","Tank, Support",1,0,1
6581,Fighter,"Assassin, Fighter","Tank, Fighter","Mage, Marksman",0,1,1
6578,"Fighter, Mage","Marksman, Mage","Tank, Fighter","Mage, Marksman",1,0,1
3308,"Fighter, Mage","Support, Mage","Tank, Fighter","Support, Tank",0,1,1
6576,"Fighter, Assassin","Assassin, Mage","Tank, Fighter","Assassin, Mage",0,1,1
6575,Fighter,"Mage, Marksman","Fighter, Mage","Tank, Fighter",0,1,1
3309,"Assassin, Mage","Support, Fighter","Assassin, Fighter","Support, Tank",0,1,1
3310,"Tank, Mage","Tank, Support","Tank, Mage","Mage, Support",1,0,1
3312,"Tank, Fighter","Tank, Fighter","Fighter, Assassin","Mage, Marksman",0,1,1
10995,"Mage, Fighter","Mage, Marksman","Fighter, Mage","Support, Mage",0,1,1
